playerName,total_goals,matches,latest_match,home_goals,away_goals,own_goals,penalty_goals
José Piendibene,4,3,1921-10-09,1,3,0,0
Isabelino Gradín,5,4,1919-05-26,0,5,0,0
Alberto Ohaco,4,2,1917-10-03,4,0,0,2
Telésforo Báez,1,1,1916-07-06,0,1,0,0
Juan Domingo Brown,2,1,1916-07-06,2,0,0,2
Alberto Marcovecchio,2,1,1916-07-06,2,0,0,0
Demóstenes Correia de Syllos,1,1,1916-07-08,1,0,0,0
Hernando Salazar,1,1,1916-07-08,0,1,0,0
José Durand Laguna,1,1,1916-07-10,1,0,0,0
Manoel Alencar Monte,1,1,1916-07-10,0,1,0,0
Arthur Friedenreich,7,5,1925-12-25,6,1,0,0
Jose Tognola,1,1,1916-07-12,0,1,0,0
Carlos Scarone,6,5,1919-05-26,3,3,0,1
Ángel Romano,15,11,1926-10-28,8,7,0,0
Neco,8,6,1922-10-22,7,1,0,0
Pedro Calomino,1,1,1917-10-03,1,0,0,0
Silvio Lagreca,1,1,1917-10-03,0,1,0,1
Antonio Blanco,1,1,1917-10-03,1,0,0,0
Luis García,5,3,2006-09-02,5,0,1,0
Héctor Scarone,22,16,1930-07-21,9,13,0,1
Caetano Izzo,1,1,1917-10-12,1,0,0,0
Haroldo Domingues,3,2,1919-05-11,3,0,0,0
Amílcar Barbuy,4,4,1922-10-15,4,0,0,1
Carlos Izaguirre,3,3,1919-05-22,2,1,0,0
Manuel Varela,1,1,1919-05-13,1,0,1,0
José Pérez,4,3,1920-10-03,0,4,0,0
Heitor,1,1,1919-05-18,1,0,0,0
Adolpho Millón Junior,1,1,1919-05-18,1,0,0,0
Edwin Clarcke,3,1,1919-05-22,3,0,0,0
Alfredo France,1,1,1919-05-22,0,1,0,0
Ismael Alvariza,1,1,1920-09-11,0,1,0,0
Raúl Echeverría,3,3,1921-10-16,2,1,0,0
Antonio Urdinarán,2,2,1922-09-23,0,2,0,2
Antonio Campolo,2,2,1928-06-07,1,1,0,0
Miguel Dellavalle,1,1,1920-09-20,0,1,0,0
Hernando Bolados,1,1,1920-09-20,1,0,0,0
Julio Libonatti,4,4,1921-10-30,4,0,0,0
Aurelio Domínguez,1,1,1920-10-03,1,0,0,0
Gerardo Rivas,6,5,1925-12-06,1,5,0,0
Ildefonso López,7,5,1926-10-23,1,6,0,0
Ernesto Duarte Machado da Silva,2,1,1921-10-12,2,0,0,0
Aníbal Médicis Candiota,1,1,1921-10-12,1,0,0,0
Blas Saruppo,3,3,1923-11-18,3,0,0,0
José Carlos Guimarães,1,1,1921-10-23,1,0,0,0
Altino Marcondes,1,1,1922-09-17,1,0,0,0
Manuel Bravo Paredes,2,2,1928-06-08,0,2,0,0
Juan Carlos Heguy,1,1,1922-09-23,0,1,0,0
Angel Chiessa,1,1,1922-09-28,1,0,0,0
Julio Francia,4,2,1922-10-18,4,0,0,1
José Gaslini,1,1,1922-09-28,1,0,0,0
Julio Ramírez,1,1,1922-10-05,0,1,0,0
Luis Fretes,3,3,1925-12-17,0,3,0,0
Felipe Buffoni,1,1,1922-10-08,0,1,0,0
Carlos Elizeche,1,1,1922-10-12,1,0,0,0
Xavier Camargo,2,1,1922-10-22,2,0,0,0
Agustín Zelada,1,1,1923-10-29,0,1,0,0
Vicente Aguirre,3,1,1923-10-29,3,0,0,0
Pedro Petrone,21,12,1928-06-10,16,5,0,0
Cesáreo Onzari,1,1,1923-11-18,1,0,0,0
Nilo Braga,6,6,1925-12-25,2,4,0,0
José Cea,2,2,1924-10-26,2,0,0,0
Pascual Somma,1,1,1923-12-02,1,0,0,0
Rudolf Sloup,2,2,1924-05-28,1,1,0,1
Josef Sedláček,2,1,1924-05-25,2,0,0,0
Bekir Refet,3,2,1928-05-28,0,3,0,0
Jan Novák,1,1,1924-05-25,1,0,0,0
Josef Čapek,1,1,1924-05-25,1,0,0,0
Pedro Vallana,1,1,1924-05-25,1,0,1,0
Paul Sturzenegger,5,2,1924-06-02,5,0,0,0
Walter Dietrich,2,2,1924-05-28,2,0,0,0
Max Abegglen,6,3,1924-06-05,6,0,0,0
Rudolf Ramseyer,1,1,1924-05-25,1,0,0,1
Andy Straden,1,1,1924-05-25,1,0,0,1
József Eisenhoffer,1,1,1924-05-26,1,0,0,0
Ferenc Hirzer,2,1,1924-05-26,2,0,0,0
Zoltán Opata,2,1,1924-05-26,2,0,0,0
José Vidal,1,1,1924-05-26,1,0,0,0
Pedro Cea,10,7,1930-07-30,10,0,0,0
Édouard Crut,3,1,1924-05-27,3,0,0,0
Paul Nicolas,3,2,1924-06-01,3,0,0,0
Jean Boyer,2,1,1924-05-27,2,0,0,0
Albert Hurgronje,1,1,1924-05-27,1,0,0,0
Kees Pijl,4,1,1924-05-27,4,0,0,0
Johannes de Natris,1,1,1924-05-27,1,0,0,1
Paddy Duncan,1,1,1924-05-28,1,0,0,0
Ibrahim Yakan,2,1,1924-05-29,2,0,0,0
Hussein Hegazi,1,1,1924-05-29,1,0,0,0
Adolfo Baloncieri,7,6,1928-06-09,6,1,0,0
Giuseppe Della Valle,2,2,1924-06-02,1,1,0,0
Rudolf Kock,4,2,1924-06-05,3,1,0,0
Sven Rydell,6,3,1924-06-09,6,0,0,0
Charles Brommesson,3,2,1924-06-01,3,0,0,0
Tore Keller,2,2,1938-06-12,1,1,0,0
Henri Larnoe,1,1,1924-05-29,0,1,0,0
Robert Pache,1,1,1924-05-30,1,0,0,0
Per Kaufeldt,3,2,1924-06-08,3,0,0,0
Ok Formenoy,3,2,1924-06-09,2,1,0,1
Frank Ghent,1,1,1924-06-02,0,1,0,0
Cornelis Pijl,1,1,1924-06-06,0,1,0,0
André le Fèvre,1,1,1924-06-08,0,1,0,0
Evert Lundqvist,1,1,1924-06-09,1,0,0,0
Pedro Zingone,1,1,1924-10-19,1,0,0,0
Gabino Sosa,6,3,1926-10-20,6,0,0,0
Juan Loyarte,1,1,1924-10-25,1,0,0,0
Paisano Urbita Sosa,1,1,1924-10-26,0,1,0,0
David Arellano,8,3,1926-11-03,8,0,0,0
Manuel Seoane,8,5,1927-10-30,8,0,0,0
Martin Sánchez,1,1,1925-11-29,1,0,0,0
Anfilogino Marques,1,1,1925-12-06,1,0,0,0
Severino Da Silva,4,2,1925-12-17,4,0,0,0
Alfredo Garasini,1,1,1925-12-13,1,0,0,0
Manuel Fleitas Solich,2,2,1926-11-01,1,1,0,1
Domingo Tarasconi,13,5,1928-06-06,12,1,0,0
Juan Carlos Irurieta,1,1,1925-12-20,1,0,0,0
Antonio Cerroti,1,1,1925-12-25,1,0,0,0
Manuel Ramírez,3,2,1926-11-03,3,0,0,0
Guillermo Subiabre,7,5,1930-07-22,6,1,0,1
Humberto Moreno,1,1,1926-10-12,1,0,0,0
Teófilo Aguilar,1,1,1926-10-12,0,1,0,0
Roberto Cherro,8,5,1929-11-10,8,0,0,0
Benjamín Delgado,3,2,1926-10-20,3,0,0,0
Antonio de Miguel,2,2,1926-10-20,2,0,0,0
René Borjas,2,2,1926-10-24,0,2,0,0
Héctor Castro,13,10,1935-01-27,3,10,0,0
Carlos Soto,1,1,1926-10-23,1,0,0,0
Ceferino Ramírez,3,1,1926-10-23,0,3,0,0
Pablo Ramírez,1,1,1926-10-23,0,1,0,0
Guillermo Saavedra,2,2,1928-05-27,1,1,0,0
Zoilo Saldombide,2,1,1926-11-01,0,2,0,1
Luis Vargas Peña,2,2,1930-07-20,0,2,0,0
Segundo Luna,3,2,1927-11-20,3,0,0,0
Alfredo Carricaberry,3,2,1927-11-27,2,1,0,0
Humberto Recanatini,2,2,1927-11-20,2,0,0,2
Mario Alborta,1,1,1927-10-30,0,1,0,0
Daniel Ulloa,1,1,1927-11-01,0,1,1,0
Antonio Sacco,2,1,1927-11-01,0,2,0,0
Roberto Figueroa,4,2,1928-06-13,1,3,0,0
Juan Arremón,1,1,1927-11-06,0,1,0,0
José Bustamante,2,1,1927-11-13,0,2,0,0
Demetrio Neyra,1,1,1927-11-13,1,0,0,0
Jorge Sarmiento,1,1,1927-11-13,1,0,0,0
Alberto Montellanos,2,2,1935-01-26,2,0,0,0
Adhemar Canavesi,1,1,1927-11-20,1,0,1,0
Manuel Ferreira,11,7,1929-11-17,8,3,0,0
Alejandro Villanueva,2,2,1936-12-27,1,1,0,0
Juan Maglio,2,1,1927-11-27,0,2,0,0
Raymond Braine,4,3,1938-03-13,2,2,0,0
Louis Versijp,1,1,1928-05-27,1,0,0,0
Jacques Moeschal,3,2,1928-06-02,2,1,0,0
Guillaume Schutz,1,1,1928-05-27,0,1,0,0
Jean-Pierre Weisgerber,1,1,1928-05-27,0,1,0,0
Robert Theissen,1,1,1928-05-27,0,1,0,0
Alejandro Carbonell,1,1,1928-05-27,0,1,0,0
Vítor Silva,4,4,1934-03-18,3,1,0,0
Pepe Soares,2,1,1928-05-27,2,0,0,0
Valdemar Mota,1,1,1928-05-27,1,0,0,0
Ali El-Hassany,1,1,1928-05-28,1,0,0,1
Ali Mohamed Riad,4,3,1928-06-09,2,2,0,0
Mahmoud Mokhtar El-Tetsh,9,4,1934-04-06,7,2,0,0
Ismail El-Sayed Hooda,1,1,1928-05-28,1,0,0,0
Gamil El-Zobeir,1,1,1928-05-28,1,0,0,0
Richard Hofmann,4,2,1928-06-03,3,1,0,0
Josef Hornauer,1,1,1928-05-28,1,0,0,0
Raimondo Orsi,3,2,1928-06-02,3,0,0,0
Rudolph Kuntner,1,1,1928-05-29,0,1,0,0
Henry Carroll,1,1,1928-05-29,0,1,0,0
Juste Brouzes,2,1,1928-05-29,0,2,0,0
Gino Rossetti,1,1,1928-05-29,1,0,0,0
Virgilio Levratto,4,3,1928-06-07,3,1,0,0
Elvio Banchero,4,2,1928-06-09,4,0,0,0
Robert Dauphin,1,1,1928-05-29,0,1,0,0
Mirko Bonačić,1,1,1928-05-29,0,1,0,0
Augusto Silva,1,1,1928-05-29,1,0,0,0
Santos Urdinarán,1,1,1928-05-30,0,1,0,0
Luis Regueiro,5,3,1934-05-31,4,1,0,0
José Maria Yermo,4,2,1928-06-04,3,1,0,0
Martín Marculeta,1,1,1928-05-30,1,0,0,0
Ángel Mariscal,1,1,1928-05-30,1,0,0,0
Juan Carreño,2,2,1930-07-13,0,2,0,0
Domingo Zaldua,1,1,1928-06-01,0,1,0,0
Florimond Vanhalme,1,1,1928-06-02,0,1,0,0
Mario Magnozzi,4,2,1928-06-09,4,0,0,0
Angelo Schiavo,4,2,1928-06-09,4,0,0,0
Fulvio Bernardini,1,1,1928-06-04,1,0,0,0
Enrico Rivolta,1,1,1928-06-04,1,0,0,0
Ernesto Sota,1,1,1928-06-05,0,1,0,0
Leonardus Ghering,2,2,1928-06-08,2,0,0,0
Felix Smeets,2,2,1928-06-08,2,0,0,0
Wim Tap,1,1,1928-06-05,1,0,0,0
Pierre Braine,1,1,1928-06-05,0,1,0,0
Óscar Alfaro,1,1,1928-06-08,0,1,0,0
Moussa Hassan El-Ezam,1,1,1928-06-09,0,1,0,0
Luis Monti,3,3,1930-07-26,2,1,0,0
Arkādijs Pavlovs,2,2,1929-08-15,2,0,0,0
Alberts Vaters,2,1,1928-07-25,2,0,0,0
Arnold Pihlak,4,2,1929-08-16,4,0,0,1
Helmuth Räästas,1,1,1928-07-26,1,0,0,0
Artur Maurer,2,1,1928-07-26,2,0,0,0
Arnolds Tauriņš,2,2,1932-08-28,1,1,0,0
Voldemārs Plade,3,1,1929-08-14,3,0,0,0
Stepas Chmelevskis,3,3,1930-08-17,1,2,0,1
Eugen Einman,4,3,1930-08-16,2,2,0,0
Aleksandrs Priede,1,1,1929-08-15,1,0,0,0
Eduard Ellman-Eelma,6,5,1935-08-22,5,1,0,0
Ricardas Rutkauskas,1,1,1929-08-16,0,1,0,0
Aurelio González,7,4,1937-01-09,6,1,0,0
Diógenes Domínguez,3,3,1929-11-16,2,1,0,0
Carlos Peucelle,4,3,1930-07-30,3,1,0,0
Adolfo Zumelzú,4,2,1930-07-19,4,0,0,0
Mario Evaristo,3,3,1930-07-22,3,0,0,0
Lorenzo Fernández,3,1,1929-11-11,0,3,0,0
José Leandro Andrade,1,1,1929-11-11,0,1,0,0
Agustín Lizarbe,1,1,1929-11-11,1,0,0,0
Lino Nessi,1,1,1929-11-16,1,0,0,0
Bart McGhee,1,1,1930-07-13,0,1,0,0
Tom Florie,1,1,1930-07-13,0,1,0,0
Bert Patenaude,4,2,1930-07-17,0,4,0,0
Lucien Laurent,1,1,1930-07-13,1,0,0,0
Marcel Langiller,1,1,1930-07-13,1,0,0,0
André Maschinot,2,1,1930-07-13,2,0,0,0
Aleksandar Tirnanić,1,1,1930-07-14,0,1,0,0
Ivan Bek,3,2,1930-07-17,0,3,0,0
Preguinho,3,2,1930-07-20,1,2,0,0
Adalbert Deşu,1,1,1930-07-14,0,1,0,0
Luis de Souza,1,1,1930-07-14,1,0,0,0
Constantin Stanciu,1,1,1930-07-14,0,1,0,0
Miklós Kovács,1,1,1930-07-14,0,1,0,0
Carlos Vidal,2,1,1930-07-16,2,0,0,0
Manuel Rosas,3,2,1930-07-19,1,2,1,1
Blagoje Marjanović,3,3,1938-04-03,2,1,0,0
Đorđe Vujadinović,2,2,1930-07-27,0,2,0,0
Guillermo Stábile,8,4,1930-07-30,7,1,0,0
Francisco Varallo,4,3,1937-01-23,4,0,0,0
Roberto Gayón,1,1,1930-07-19,0,1,0,0
Moderato Wisintainer,2,1,1930-07-20,0,2,0,0
Pablo Dorado,2,2,1930-07-30,2,0,0,0
Peregrino Anselmo,3,2,1930-07-27,3,0,0,0
Alejandro Scopelli,3,2,1937-01-09,3,0,0,0
Jim Brown,1,1,1930-07-26,0,1,0,0
Santos Iriarte,2,2,1930-07-30,2,0,0,0
Friedrich Karm,4,3,1931-09-01,2,2,0,0
Jaroslavas Citavičius,4,4,1933-09-02,3,1,0,0
Antanas Lingis,6,6,1935-08-21,4,2,0,0
Ēriks Pētersons,9,6,1935-08-22,3,6,0,0
Voldemārs Žins,1,1,1930-08-16,1,0,0,0
Fricis Dambrēvics,1,1,1930-08-16,1,0,0,0
Leonhard Kass,3,3,1938-09-05,2,1,0,0
Jānis Škincs,1,1,1931-09-01,0,1,0,0
Alberts Šeibelis,5,5,1936-08-31,4,1,0,0
Hermanis Jēnihs,1,1,1932-08-28,1,0,0,0
Roman Mõtlik,1,1,1932-08-29,1,0,0,0
Eduardas Čižauskas,1,1,1932-08-29,0,1,0,0
Knut Kroon,2,2,1934-05-27,1,1,0,0
Lennart Bunke,4,3,1937-06-20,4,0,0,0
Bertil Ericsson,2,1,1933-06-11,2,0,0,0
Torsten Bunke,1,1,1933-06-11,1,0,0,0
Richard Kuremaa,5,5,1937-09-04,1,4,0,0
Sven Andersson,1,1,1933-06-11,1,0,0,0
Knut Hansson,2,1,1933-06-29,0,2,0,0
Zigmas Sabaliauskas,1,1,1933-09-04,1,0,0,0
Vladimir Kragić,2,2,1934-04-29,1,1,0,0
Alessandro Frigerio,1,1,1933-09-24,0,1,0,0
Willy Jäggi,2,2,1934-05-31,0,2,0,0
Josef Silný,1,1,1933-10-15,0,1,0,0
Henryk Martyna,1,1,1933-10-15,1,0,0,0
František Pelcner,1,1,1933-10-15,0,1,0,0
Grațian Sepi,1,1,1933-10-29,0,1,0,0
Ștefan Dobay,5,5,1938-06-09,1,4,0,0
Ernst Hufschmid,1,1,1933-10-29,1,0,0,0
Erwin Hochsträsser,1,1,1933-10-29,1,0,0,1
Mario López,7,5,1934-03-18,0,7,0,1
Héctor Socorro,5,4,1938-06-09,3,2,0,0
Ángel Martínez,1,1,1934-01-28,0,1,0,0
Robert St. Fort,2,2,1934-02-01,2,0,0,2
Francisco Socorro,1,1,1934-02-04,0,1,0,0
Enrique Ferrer,1,1,1934-02-04,0,1,0,0
Salvador Soto,1,1,1934-02-04,0,1,0,0
Jean Capelle,1,1,1934-02-25,0,1,0,0
Paddy Moore,5,2,1934-04-08,4,1,0,0
Stan Vanden Eynde,1,1,1934-02-25,0,1,0,0
François Vanden Eynde,2,1,1934-02-25,0,2,0,0
Dionisio Mejía,7,3,1934-05-24,7,0,0,0
Josef Rasselnberg,4,1,1934-03-11,0,4,0,0
Willi Wigold,1,1,1934-03-11,0,1,0,0
Ernst Albrecht,1,1,1934-03-11,0,1,0,0
Ernest Mengel,1,1,1934-03-11,1,0,0,0
Karl Hohmann,5,2,1934-05-31,2,3,0,0
Jorge Sota,1,1,1934-03-11,1,0,0,0
Felipe Rosas,1,1,1934-03-11,1,0,0,0
Eduardo González Valiño,1,1,1934-03-11,1,0,0,0
Isidro Lángara,8,3,1934-05-27,5,3,0,1
Martí Ventolrà,1,1,1934-03-11,1,0,0,0
Mostafa Taha,2,1,1934-03-16,2,0,0,0
Mohamed Latif,3,2,1934-04-06,2,1,0,0
Avraham Nudelmann,1,1,1934-03-16,0,1,0,0
Manuel Alonso,3,2,1934-05-24,3,0,0,0
José Ruvalcaba,1,1,1934-03-18,1,0,0,0
Fernando Marcos,1,1,1934-03-18,1,0,0,0
Dimitar Baikushev,1,1,1934-03-25,1,0,0,0
György Sárosi,7,6,1938-06-19,5,2,0,1
Gábor P. Szabó,3,2,1934-04-29,2,1,0,1
Géza Toldi,4,3,1938-06-05,1,3,0,0
Imre Markos,1,1,1934-03-25,0,1,0,0
Anfilogino Guarisi,1,1,1934-03-25,1,0,0,0
Giuseppe Meazza,5,4,1938-06-16,4,1,0,1
Giovanni Ferrari,3,3,1934-05-31,3,0,0,0
Abdulrahman Fawzi,3,2,1934-05-27,2,1,0,0
Yohanan Sukenik,1,1,1934-04-06,1,0,0,0
Kick Smit,5,4,1937-11-28,4,1,0,0
Johnny Squires,1,1,1934-04-08,0,1,0,0
Bep Bakhuys,4,2,1934-04-29,2,2,0,0
Leen Vente,3,3,1934-05-27,2,1,0,0
Alfred Aston,1,1,1934-04-15,0,1,0,0
Jean Nicolas,7,3,1938-06-05,2,5,0,1
Théophile Speicher,1,1,1934-04-15,1,0,0,0
Ernest Liberati,1,1,1934-04-15,0,1,0,0
Johann Horvath,5,3,1934-06-07,5,0,0,0
Karl Zischek,2,2,1934-05-31,2,0,0,0
Rudolf Viertl,1,1,1934-04-25,1,0,0,0
Mihail Lozanov,1,1,1934-04-25,0,1,0,0
Matthias Sindelar,2,2,1934-05-27,2,0,0,0
Laurent Grimmonprez,1,1,1934-04-29,1,0,0,0
Bernard Voorhoof,4,3,1938-03-13,3,1,0,0
József Solti,2,1,1934-04-29,2,0,0,0
Vladimir Todorov,1,1,1934-04-29,0,1,0,0
Sándor Schwartz,1,1,1934-04-29,1,0,0,0
Aldo Donelli,5,2,1934-05-27,0,5,0,0
Ernesto Belis,1,1,1934-05-27,1,0,0,0
Sven Jonasson,4,3,1938-06-19,1,3,0,1
Alberto Galateo,1,1,1934-05-27,1,0,0,0
Anton Schall,1,1,1934-05-27,1,0,0,0
Josef Bican,1,1,1934-05-27,1,0,0,0
Georges Verriest,1,1,1934-05-27,0,1,0,1
Stanislaus Kobierski,1,1,1934-05-27,0,1,0,0
Otto Siffling,3,2,1937-11-21,2,1,0,0
Edmund Conen,4,2,1934-06-07,0,4,0,0
José Iraragorri,2,1,1934-05-27,0,2,0,1
Leônidas,1,1,1934-05-27,1,0,0,0
Antonín Puč,2,2,1934-06-10,1,1,0,0
Oldřich Nejedlý,9,6,1938-06-12,8,1,0,1
Pál Teleki,1,1,1934-05-27,0,1,0,0
Jenő Vincze,2,2,1938-03-25,1,1,0,0
Angelo Schiavio,4,2,1934-06-10,4,0,0,0
Raimundo Orsi,3,2,1934-06-10,3,0,0,0
Leopold Kielholz,3,2,1934-05-31,0,3,0,0
André Abegglen,4,3,1938-06-09,0,4,0,0
František Svoboda,1,1,1934-05-31,1,0,0,0
Jiří Sobotka,1,1,1934-05-31,1,0,0,0
Gösta Dunker,1,1,1934-05-31,0,1,0,0
Rudolf Noack,1,1,1934-06-03,0,1,0,0
Enrique Guaita,1,1,1934-06-03,1,0,0,0
Ernst Lehner,5,3,1937-08-29,2,3,0,0
Karl Sesta,1,1,1934-06-07,1,0,0,0
Arturo Carmona,2,2,1937-01-21,1,1,0,0
Miguel Angel Lauri,1,1,1935-01-06,1,0,0,0
Arturo Arrieta,1,1,1935-01-06,1,0,0,0
Diego García,2,2,1935-01-20,1,1,0,0
Herminio Masantonio,11,5,1942-01-22,8,3,0,0
Aníbal Ciocca,5,4,1942-01-28,2,3,0,0
Carlos Giudice,1,1,1935-01-18,1,0,0,0
Teodoro Fernández,15,9,1942-01-25,9,6,0,1
José Taboada,1,1,1935-01-27,0,1,0,0
Voldemaras Jaškevičius,3,3,1938-09-04,0,3,0,0
Nikolai Linberg,1,1,1935-08-20,1,0,0,0
Iļja Vestermans,8,7,1937-10-05,3,5,0,0
Romualdas Marcinkus,1,1,1935-08-21,1,0,0,0
Georg Siimenson,5,4,1937-09-05,1,4,0,0
Juozas Gudelis,2,2,1937-07-29,0,2,0,0
Jānis Lidmanis,1,1,1936-08-31,1,0,0,1
Julius Kaljo,1,1,1936-08-31,0,1,0,1
Roberto Emílio da Cunha,3,3,1938-06-14,3,0,0,0
Afonso Guimarães da Silva,1,1,1936-12-27,1,0,0,0
Niginho,2,2,1937-01-19,2,0,0,0
Raúl Toro Julio,9,6,1941-02-02,6,3,0,0
Amadeo Ortega,2,1,1937-01-02,2,0,0,0
Severino Varela,15,9,1942-01-28,5,10,0,1
Adolfo Erico,1,1,1937-01-02,1,0,0,1
Patesko,6,3,1942-01-14,6,0,0,0
Carvalho Leite,3,3,1937-01-19,3,0,0,0
José Avendaño,3,2,1939-02-05,2,1,0,0
Luíz Mesquita de Oliveira,4,2,1937-01-13,4,0,0,0
Guillermo Riveros,1,1,1937-01-03,0,1,0,0
Adelaido Camaití,2,2,1939-01-29,0,2,0,0
Adolfo Magallanes,2,2,1942-01-18,1,1,0,0
Juan Píriz,3,3,1937-01-23,0,3,0,0
Enrique García,5,5,1942-01-22,4,1,0,0
Alberto Zozaya,5,3,1937-01-23,5,0,0,0
Manuel Arancibia,2,2,1941-02-02,2,0,0,0
Juan Amarilla,1,1,1937-01-17,0,1,0,0
Martín Flor,1,1,1937-01-17,0,1,0,0
Raúl Núñez Velloso,1,1,1937-01-17,0,1,0,0
Segundo Villadóniga,1,1,1937-01-19,0,1,0,0
Antônio Almeida,1,1,1937-01-19,1,0,0,0
Jorge Alcalde,7,5,1939-02-12,5,2,0,0
Guillermo Torres,1,1,1937-01-21,1,0,0,0
Eduardo Ithurbide,1,1,1937-01-23,0,1,0,0
José María Lavalle,1,1,1937-01-24,0,1,0,0
Vicente de la Mata,5,4,1946-01-12,5,0,0,0
Erik Persson,1,1,1937-06-16,1,0,0,0
Kurt Svanström,1,1,1937-06-16,1,0,0,0
Heinrich Uukkivi,3,3,1938-09-03,1,2,0,0
Gustav Josefsson,2,1,1937-06-20,2,0,0,0
Gustav Wetterström,6,2,1938-06-12,3,3,0,0
Adolf Urban,1,1,1937-06-29,0,1,0,0
Fricis Kaņeps,5,2,1937-09-03,3,2,0,1
Jonas Paulionis,2,2,1937-09-03,1,1,0,0
Josef Gauchel,3,2,1938-06-04,3,0,0,0
Vaclavs Borduško,2,1,1937-09-03,0,2,0,0
Aavo Sillandi,1,1,1937-09-05,0,1,0,0
Jānis Rozītis,1,1,1937-09-07,0,1,0,0
Camillo Jerusalem,1,1,1937-10-05,1,0,0,0
Franz Binder,1,1,1937-10-05,1,0,0,0
Reidar Kvammen,4,2,1937-11-07,2,2,0,0
Matty Geoghegan,1,1,1937-10-10,0,1,0,0
Jimmy Dunne,2,2,1937-11-07,1,1,0,0
Alf Martinsen,2,2,1937-11-07,1,1,0,0
Leonard Piątek,2,1,1937-10-10,2,0,0,0
Jerzy Wostal,1,1,1937-10-10,1,0,0,0
Ernst Wilimowski,5,2,1938-06-05,1,4,0,0
Jan Ríha,1,1,1937-11-07,0,1,0,0
Georgi Panchediev,1,1,1937-11-07,1,0,0,1
Kevin O'Flanagan,1,1,1937-11-07,1,0,0,0
Harry Duggan,1,1,1937-11-07,1,0,0,0
Fritz Szepan,1,1,1937-11-21,1,0,0,0
Helmut Schön,2,1,1937-11-21,2,0,0,0
Piet de Boer,3,1,1937-11-28,3,0,0,0
Kleanthis Vikelidis,3,2,1938-02-20,1,2,0,1
Peri Neufeld,1,1,1938-01-22,1,0,0,0
Antonis Migiakis,1,1,1938-01-22,0,1,0,0
Camille Libar,1,1,1938-03-13,1,0,0,0
Gustave Kemp,1,1,1938-03-13,1,0,0,0
François de Vries,1,1,1938-03-13,0,1,0,0
Gyula Zsengellér,10,4,1938-06-16,10,0,0,1
Pál Titkos,4,3,1938-06-19,4,0,0,0
József Nemes,3,1,1938-03-25,3,0,0,0
Lefteris Makris,1,1,1938-03-25,0,1,0,0
Henk van Spaandonck,1,1,1938-04-03,0,1,0,0
Hendrik Isemborghs,2,2,1938-06-05,1,1,0,0
Ladislav Šimůnek,3,1,1938-04-24,3,0,0,0
Josef Ludl,1,1,1938-04-24,1,0,0,0
Georges Aeby,1,1,1938-05-01,1,0,0,0
Lauro Amado,1,1,1938-05-01,1,0,0,0
Fernando Peyroteo,1,1,1938-05-01,0,1,0,1
Leônidas da Silva,7,4,1938-06-19,7,0,0,0
Friedrich Scherfke,1,1,1938-06-05,0,1,0,1
Romeu Pellicciari,3,3,1938-06-19,3,0,0,0
José Perácio,3,2,1938-06-19,3,0,0,0
Silviu Bindea,1,1,1938-06-05,0,1,0,0
José Magriñá,1,1,1938-06-05,1,0,0,0
Iuliu Barátky,1,1,1938-06-05,0,1,0,0
Josef Košťálek,1,1,1938-06-05,1,0,0,0
Josef Zeman,1,1,1938-06-05,1,0,0,0
Émile Veinante,1,1,1938-06-05,1,0,0,0
Vilmos Kohut,1,1,1938-06-05,1,0,0,0
Pietro Ferraris,1,1,1938-06-05,1,0,0,0
Arne Brustad,1,1,1938-06-05,0,1,0,0
Silvio Piola,5,3,1938-06-19,1,4,0,0
Tomás Fernández,1,1,1938-06-09,1,0,0,0
Wilhelm Hahnemann,1,1,1938-06-09,1,0,0,0
Ernst Lörtscher,1,1,1938-06-09,1,0,1,0
Eugen Walaschek,1,1,1938-06-09,0,1,0,0
Alfred Bickel,1,1,1938-06-09,0,1,0,0
Harry Andersson,3,1,1938-06-12,0,3,0,0
Arne Nyberg,3,3,1938-06-19,0,3,0,0
Gino Colaussi,4,3,1938-06-19,0,4,0,0
Oscar Heisserer,1,1,1938-06-12,1,0,0,0
Vlastimil Kopecký,1,1,1938-06-14,0,1,0,0
Sven Jacobsson,1,1,1938-06-16,1,0,1,0
Ralf Veidemann,2,1,1938-09-03,2,0,0,0
Kazys Šurkus,1,1,1938-09-03,0,1,0,0
Francis Krupšs,1,1,1938-09-04,1,0,0,0
Ēriks Raisters,1,1,1938-09-05,0,1,0,0
Enrique Sorrel,4,3,1941-02-02,4,0,0,1
Tiberio Godoy,3,2,1939-02-12,0,3,0,0
Marcial Barrios,8,7,1949-04-13,3,5,0,1
Ricardo Aquino,1,1,1939-01-15,0,1,0,0
Marino Alcívar,3,2,1942-02-05,0,3,0,0
Roberto Porta,12,11,1945-02-15,5,7,0,0
Pedro Lago,3,2,1939-02-05,0,3,0,0
Alfonso Domínguez,4,4,1989-09-03,2,2,1,0
Raúl Muñoz,1,1,1939-01-29,1,0,0,0
Roberto Luco,1,1,1939-01-29,1,0,0,0
Oscar Chirimini,3,3,1942-02-01,1,2,0,0
Manuel Arenas,2,2,1939-02-12,1,1,0,0
Eduardo Mingo,2,2,1942-01-25,0,2,0,0
Eustaquio Barreiro,1,1,1939-02-12,0,1,0,0
Víctor Bielich,1,1,1939-02-12,1,0,0,0
Armando Contreras,2,2,1942-01-10,1,1,0,0
Raúl Pérez,1,1,1941-02-09,1,0,0,0
Ismael Rivero,3,1,1941-02-09,0,3,0,0
Schubert Gambetta,3,3,1947-12-06,1,2,0,0
Jorge Laurido,1,1,1941-02-09,0,1,1,0
José Manuel Moreno,13,7,1947-12-25,12,1,0,0
César Socarraz,1,1,1941-02-12,0,1,0,0
Juan Marvezzi,5,1,1941-02-16,5,0,0,0
César Augusto Freire,1,1,1941-02-16,0,1,0,0
Ubaldo Cruche,1,1,1941-02-16,0,1,0,0
Antonio Sastre,1,1,1941-02-23,1,0,0,0
Manuel Vallejas,1,1,1941-02-23,0,1,0,0
Juan Pedro Riephoff,2,2,1946-02-02,0,2,0,0
Obdulio Varela,5,5,1954-06-26,1,4,0,0
Luis Ernesto Castro,3,2,1942-02-01,3,0,0,0
Bibiano Zapirain,3,3,1942-02-07,3,0,0,0
Raimundo Sandoval,1,1,1942-01-11,1,0,0,0
Vicente Sánchez,5,5,2007-10-13,1,4,0,0
Rubén Aveiro,2,1,1942-01-11,0,2,0,0
Angel Perucca,2,2,1942-01-22,2,0,0,0
Sylvio Pirillo,6,2,1942-01-31,6,0,0,0
Cláudio Christovam de Pinho,5,4,1953-03-12,5,0,0,1
Servílio de Jesús,1,1,1942-01-17,0,1,0,0
Pedro Amorim,2,1,1942-01-21,2,0,0,0
Adolfo Pedernera,3,3,1946-02-02,3,0,0,0
Fabio Baudo Franco,3,3,1942-02-05,0,3,0,0
Juan Carlos Heredia,1,1,1942-01-25,1,0,0,0
José María Jiménez,5,4,1947-11-30,4,1,0,0
Gorgonio Ibarrola,1,1,1942-01-25,0,1,0,0
Leopoldo Quiñónez,1,1,1942-01-28,0,1,0,0
Luis Guzmán Gonzales,1,1,1942-01-28,0,1,0,0
Elba de Padua Lima,1,1,1942-01-31,1,0,0,0
Enrique Alvarez,1,1,1942-01-31,0,1,0,1
Zizinho,17,12,1957-03-24,16,1,0,1
Benito Armingol,1,1,1942-02-05,1,0,0,0
Juan Alcántara,6,3,1946-01-26,5,1,0,0
Erasmo Vera,1,1,1945-01-14,1,0,0,0
Enrique Raymondi Chávez,1,1,1945-01-14,0,1,0,0
Francisco Hormazábal,1,1,1945-01-14,1,0,0,0
Luis Mendoza,2,2,1967-02-01,1,1,0,0
Guillermo Clavero,4,2,1945-01-24,4,0,0,0
René Pontoni,8,5,1947-12-04,8,0,0,0
Rinaldo Martino,5,5,1946-01-12,5,0,0,0
Félix Loustau,7,7,1947-12-28,7,0,0,0
Jorge Ceciliano,1,1,1945-01-21,1,0,0,0
Heleno de Freitas,9,6,1946-01-23,6,3,0,0
Jaime de Almeida,1,1,1945-01-21,1,0,0,0
Atilio García,5,2,1945-01-28,0,5,0,0
Víctor Aguayo,4,4,1945-02-21,1,3,0,0
Ademir de Menezes,22,12,1953-03-12,20,2,0,0
Tesourinha,8,6,1949-05-11,7,1,0,1
Juan Riephoff,1,1,1945-01-28,0,1,0,0
José García,4,3,1947-12-16,0,4,0,0
José María Ortiz,1,1,1945-01-28,0,1,0,0
José Mendoza,1,1,1945-01-31,0,1,0,0
Manuel Pellegrina,1,1,1945-01-31,1,0,0,0
Desiderio Medina,3,3,1945-02-18,3,0,0,0
Manuel Piñeiro,1,1,1945-01-31,1,0,0,0
Norberto Doroteo Méndez,17,10,1947-12-28,15,2,0,0
Mario Boyé,5,4,1947-12-18,5,0,0,0
Arturo Mendoza,1,1,1945-02-07,0,1,0,0
José Luis Ferraro,2,1,1945-02-07,2,0,0,0
Rui Campos,1,1,1945-02-07,1,0,0,0
Nicolás Falero,9,6,1947-12-25,0,9,0,0
Luis González Rubio,2,2,1945-02-21,1,1,0,0
Roberto Gámez,2,2,1945-02-21,1,1,0,0
Fulgencio Berdugo,3,3,1949-04-20,1,2,0,0
Raúl Fernández,1,1,1945-02-21,1,0,0,0
Zenón González,3,3,1947-12-18,3,0,0,0
Severo Orgaz,2,2,1947-12-31,2,0,0,0
Guillermo Albornoz,1,1,1945-02-21,0,1,0,0
Jair,15,9,1950-07-13,15,0,0,1
José María Medina,7,3,1946-01-29,0,7,0,0
Ángel Labruna,10,5,1956-01-29,10,0,0,0
Miguel Peredo,2,2,1946-02-08,1,1,0,0
Juan Carlos Salvini,2,1,1946-01-19,2,0,0,0
Porfirio Rolón,1,1,1946-01-19,0,1,0,0
Jorge Benjamín Araya,3,2,1946-02-08,1,2,0,0
Atilio Cremaschi,8,6,1953-03-19,6,2,0,0
José Antonio Vázquez,1,1,1946-01-23,0,1,0,0
Chico,6,4,1950-07-13,6,0,0,0
Juan Bautista Coronel,1,1,1946-01-26,1,0,1,0
Alejandrino Genés,5,4,1947-12-29,2,3,0,0
Delfín Benítez Cáceres,1,1,1946-01-26,0,1,0,0
Juan Bautista Villalba,9,7,1947-12-23,3,6,0,0
Norival Pereira Da Silva,1,1,1946-01-29,1,0,0,0
Santiago Salfate,1,1,1946-02-03,0,1,0,1
Raúl Schiaffino,1,1,1946-02-08,0,1,0,0
Albino Rodríguez,1,1,1946-02-08,1,0,0,0
Adalberto López,4,2,1947-07-17,3,1,0,0
Angel Segura,2,2,1947-07-17,1,1,0,0
Rodrigo Ruíz,1,1,1947-07-13,1,0,0,1
Carlos Septién,2,2,1949-09-04,1,1,0,0
José Minsal,1,1,1947-07-17,1,0,0,0
Antonio Villalón,2,1,1947-07-20,2,0,0,0
Ed Souza,1,1,1947-07-20,0,1,0,0
Ed Valentine,1,1,1947-07-20,0,1,0,0
Luis Gironella,1,1,1947-07-20,1,0,0,0
Antonio Mederos,1,1,1947-07-20,1,0,0,0
Santiago Veiga,2,2,1949-09-21,1,1,0,0
Benigno Gutiérrez,5,4,1949-05-06,3,2,0,0
Julio César Britos,3,3,1947-12-28,0,3,0,0
Alfredo Di Stéfano,13,9,1961-11-23,8,5,0,0
Raúl Sarro,2,2,1947-12-16,0,2,0,0
Héctor Magliano,4,3,1947-12-13,0,4,0,0
Félix Castillo,7,7,1956-02-09,1,6,0,0
Máximo Mosquera,6,6,1957-04-06,3,3,0,0
Leocadio Marín,6,4,1947-12-29,2,4,0,0
Carlos Varela,1,1,1947-12-09,1,0,0,0
Miguel Busquets,1,1,1947-12-09,1,0,0,0
Valeriano López,2,2,1947-12-11,0,2,0,0
Carlos Gómez Sánchez,5,3,1949-05-04,2,3,0,0
Jorge Peñaloza,1,1,1947-12-11,0,1,0,0
Pedro Hugo López,5,4,1949-04-20,1,4,0,1
Fernando Riera,4,4,1950-07-02,2,2,0,0
Washington Puente,4,3,1953-03-23,0,4,0,0
César Garnica,1,1,1947-12-16,1,0,0,0
Mario Fernández,1,1,1947-12-18,1,0,0,0
Enrique Ávalos,2,2,1949-05-08,0,2,0,0
Carlos Arango,5,5,1957-06-16,3,2,0,1
Luis Guzmán,3,2,1947-12-27,0,3,0,0
Juan Castillo,1,1,1947-12-27,0,1,0,0
Andrés Prieto,2,2,1950-07-02,2,0,0,0
Osvaldo Sáez,3,2,1947-12-31,2,1,0,0
Rafael Granados,1,1,1947-12-29,0,1,0,0
Duberty Aráoz,1,1,1947-12-31,0,1,1,0
Raimundo Infante,3,2,1949-05-08,2,1,0,1
Armando Tapia,1,1,1947-12-31,1,0,0,0
Arturo Tardío,1,1,1947-12-31,1,0,0,0
Octavio Sergio da Costa,1,1,1949-04-03,1,0,0,0
Simão,5,3,1949-04-24,5,0,0,0
Sigifredo Cuchuca,1,1,1949-04-03,0,1,0,0
Víctor Ugarte,9,8,1963-03-31,7,2,0,3
Manuel Salamanca,1,1,1949-04-06,0,1,0,0
Benedicto Godoy Véizaga,2,2,1949-05-06,2,0,0,0
César López Fretes,4,3,1950-06-29,2,2,0,0
Jorge Duilio Benitez,7,4,1949-05-08,0,7,0,0
Nininho,3,1,1949-04-10,3,0,0,0
Víctor Pedraza,3,2,1949-04-20,0,3,0,0
Manuel Drago,1,1,1949-04-10,0,1,0,0
Ramón Castro,4,3,1949-05-04,0,4,0,0
Nelson Moreno,1,1,1949-04-13,0,1,0,0
Víctor Artega,1,1,1949-04-13,1,0,0,0
José Vargas,2,2,1949-05-03,1,1,0,0
Dionisio Arce,7,4,1949-04-30,2,5,0,1
Roberto Drago,5,4,1956-02-01,0,5,0,0
Dagoberto Moll,2,2,1949-05-04,0,2,0,0
Víctor Celestino Algañaraz,1,1,1949-04-17,1,0,0,0
Ernesto Betancourt,1,1,1949-04-17,0,1,0,0
Millón Medeiros,1,1,1949-04-17,1,0,0,1
Orlando de Azevedo Viarina,2,2,1949-04-24,2,0,0,0
Carlos Rojas,1,1,1949-04-17,1,0,0,0
Juan Emilio Salinas,2,2,1949-04-24,0,2,0,0
Marcos Bermeo,1,1,1949-04-20,0,1,1,0
Jose Maria Garcia,2,1,1949-04-20,0,2,0,0
Gerardo Arce,1,1,1949-04-24,1,0,1,0
Augusto da Costa,1,1,1949-04-24,1,0,0,0
Carlos Sánchez,1,1,1949-04-25,1,0,1,0
Luz Gastelbondo,1,1,1949-04-25,0,1,0,0
Miguel Martínez,1,1,1949-04-25,1,0,0,0
Alfredo Pérez,1,1,1949-04-25,0,1,0,0
Juan Ayala,3,3,1949-05-08,1,2,0,0
Cornelio Heredia,2,2,1955-03-06,0,2,0,2
Ulises Ramos,1,1,1949-04-27,1,0,0,0
Pedro Fernández,1,1,1949-04-30,0,1,0,0
Danilo Alvim,1,1,1949-04-30,1,0,0,0
Alfredo Mosquera,3,2,1949-05-04,1,2,0,0
Enrique Cantos,3,3,1957-03-24,0,3,0,0
Nelson Pérez,1,1,1949-05-03,1,0,0,0
Guido Andrade,1,1,1949-05-03,0,1,0,0
Rafael Maldonado,1,1,1949-05-03,0,1,0,0
Nemesio Rojas,1,1,1949-05-06,1,0,0,0
Davy Walsh,2,2,1953-10-04,1,1,0,0
Sune Andersson,3,3,1950-07-09,1,2,0,2
Hasse Jeppson,3,2,1950-06-25,1,2,0,0
Nils Liedholm,3,3,1958-06-29,3,0,0,1
Camille Wagner,1,1,1949-06-26,0,1,0,0
René Maillard,2,2,1949-09-18,1,1,0,0
Jacques Fatton,6,4,1954-06-23,3,3,0,0
Robert Ballaman,8,6,1961-05-20,8,0,0,0
Kiki Antenen,1,1,1949-06-26,1,0,0,0
Michel Reuter,1,1,1949-06-26,0,1,0,0
Milutin Pajević,3,1,1949-08-21,3,0,0,0
Božidar Senčar,1,1,1949-08-21,1,0,0,0
Željko Čajkovski,6,5,1950-06-28,2,4,0,0
Stjepan Bobek,4,4,1950-06-28,1,3,0,1
Antonio Flores,2,2,1949-09-25,2,0,0,0
Luis Luna,2,2,1949-09-11,2,0,0,0
Luis de la Fuente,4,2,1949-09-18,4,0,0,0
Johnny Gavin,2,2,1956-10-03,2,0,0,1
Con Martin,3,2,1949-11-13,3,0,0,2
Horacio Casarín,5,3,1950-07-02,5,0,0,0
Frank Wallace,3,3,1950-07-02,1,2,0,0
José Gómez,1,1,1949-09-14,1,0,0,0
Marko Valok,2,1,1949-09-18,0,2,0,0
Zlatko Čajkovski,1,1,1949-09-18,0,1,0,0
Yehoshua Glazer,7,4,1961-03-19,5,2,0,0
Armand Muller,1,1,1949-09-18,1,0,0,0
Jim Kremer,1,1,1949-09-18,1,0,0,0
Hans-Peter Friedländer,1,1,1949-09-18,0,1,0,0
Héctor Ortiz,2,2,1950-06-28,2,0,0,1
John Souza,2,2,1949-09-21,1,1,0,0
Mario Ochoa,1,1,1949-09-18,1,0,0,0
Ben Wattman,1,1,1949-09-18,0,1,0,0
Walter Bahr,1,1,1949-09-21,1,0,0,0
Pete Matevich,2,1,1949-09-21,2,0,0,0
Jacinto Barquín,1,1,1949-09-21,0,1,0,0
José Naranjo,3,2,1954-01-10,3,0,0,0
Henry Morris,3,1,1949-10-01,0,3,0,0
William Waddell,2,1,1949-10-01,0,2,0,1
Billy Steel,1,1,1949-10-01,0,1,0,0
Lawrence Reilly,2,2,1953-11-04,1,1,0,0
Samuel Smyth,3,2,1949-11-16,2,1,0,0
Jimmy Mason,1,1,1949-10-01,0,1,0,0
Peter Farrell,1,1,1949-10-09,0,1,0,0
Jorma Vaihela,2,2,1953-09-23,1,1,0,0
Henri Baillot,2,2,1949-10-30,1,1,0,0
Stan Mortensen,4,3,1950-06-25,2,2,0,0
Jackie Milburn,3,1,1949-10-15,0,3,0,0
Mal Griffiths,1,1,1949-10-15,1,0,0,0
John McPhail,1,1,1949-11-09,1,0,0,0
Alexander Linwood,1,1,1949-11-09,1,0,0,0
Karl-Erik Palmér,6,4,1950-07-16,1,5,0,0
Jack Rowley,4,1,1949-11-16,4,0,0,0
Jack Froggatt,1,1,1949-11-16,1,0,0,0
Stan Pearson,2,1,1949-11-16,2,0,0,0
Bobby Brennan,1,1,1949-11-16,0,1,0,0
Fahreddin Cansever,3,1,1949-11-20,3,0,0,0
Bülent Eken,1,1,1949-11-20,1,0,0,0
Lefter Küçükandonyadis,5,4,1959-04-26,3,2,0,1
Erol Keskin,2,2,1954-06-20,1,1,0,0
Gündüz Kılıç,1,1,1949-11-20,1,0,0,0
Prvoslav Mihajlović,2,1,1949-12-11,0,2,0,1
Marius Walter,1,1,1949-12-11,1,0,0,0
Jean Luciano,1,1,1949-12-11,1,0,0,0
Telmo Zarra,7,6,1950-07-16,4,3,0,0
Estanislau Basora,7,5,1957-05-26,6,1,0,0
José Luis Panizo,1,1,1950-04-02,1,0,0,0
Fernando Cabrita,1,1,1950-04-02,0,1,0,0
Luis Molowny,1,1,1950-04-02,1,0,0,0
José Travassos,1,1,1950-04-09,1,0,0,0
Jesus Correia,1,1,1950-04-09,1,0,0,0
Agustín Gaínza,2,2,1954-01-06,1,1,0,0
Roy Bentley,1,1,1950-04-15,0,1,0,0
Baltazar,11,9,1954-06-16,8,3,0,0
Wilf Mannion,1,1,1950-06-25,0,1,0,0
Riccardo Carapellese,2,2,1950-07-02,2,0,0,0
Ermes Muccinelli,2,2,1953-11-13,1,1,0,0
Gino Pariani,1,1,1950-06-25,0,1,0,0
Silvestre Igoa,2,2,1950-07-13,1,1,0,0
Rajko Mitić,1,1,1950-06-25,0,1,0,0
Kosta Tomašević,2,2,1950-06-28,0,2,0,0
Tihomir Ognjanov,1,1,1950-06-25,0,1,0,0
Alfredo dos Santos,1,1,1950-06-28,1,0,0,0
Joe Gaetjens,1,1,1950-06-29,0,1,0,0
Stig Sundqvist,3,3,1950-07-16,1,2,0,0
Atilio López,4,4,1953-04-01,2,2,0,0
Thomaz Soares da Silva,2,2,1950-07-13,2,0,0,0
Óscar Míguez,15,11,1957-06-30,4,11,0,2
Ernesto Vidal,1,1,1950-07-02,0,1,0,0
Juan Alberto Schiaffino,5,4,1954-06-26,0,5,0,0
Julio Pérez,2,2,1955-03-23,0,2,0,0
Alcides Ghiggia,4,4,1950-07-16,0,4,0,0
George Robledo,4,3,1955-03-06,4,0,0,0
Joe Maca,1,1,1950-07-02,0,1,0,1
Egisto Pandolfini,3,3,1954-06-20,2,1,0,1
René Bader,1,1,1950-07-02,0,1,0,0
Charles Antenen,6,4,1961-11-12,2,4,0,0
Maneca,1,1,1950-07-09,1,0,0,0
Friaça,1,1,1950-07-16,1,0,0,0
Bror Mellberg,1,1,1950-07-16,0,1,0,0
Carlos Romero,3,3,1953-03-28,0,3,0,0
Rubén Fernández,4,3,1953-04-01,0,4,0,0
Ángel Berni,4,4,1953-03-16,1,3,0,0
Óscar Gómez Sánchez,10,8,1959-04-02,3,7,0,0
Júlio Botelho,8,4,1954-06-27,4,4,0,0
Francisco Rodrigues,2,1,1953-03-01,0,2,0,0
Pinga,4,2,1954-06-16,2,2,0,0
Francisco Molina,7,3,1953-03-23,5,2,0,0
Walter Morel,3,3,1955-03-30,0,3,0,0
Osvaldo Balseiro,4,3,1953-03-23,0,4,0,0
Eduardo Guzmán,1,1,1953-03-08,0,1,0,0
Ricardo Alcón,4,4,1959-03-21,3,1,0,0
Alberto Terry,8,7,1957-04-13,7,1,0,1
Ipojucan Lins de Araújo,1,1,1953-03-15,1,0,0,0
Juan Angel Romero,1,1,1953-03-16,0,1,0,0
Ramón Santos,2,2,1953-03-28,2,0,0,0
Luis Navarrete,1,1,1953-03-19,1,0,0,0
Omar Méndez,1,1,1953-03-23,0,1,0,0
Donald Peláez,3,2,1953-03-28,0,3,0,0
Nílton Santos,2,2,1958-06-08,1,1,0,0
Pablo León,1,1,1953-03-27,0,1,0,0
René Meléndez,5,4,1956-01-24,3,2,0,0
Guillermo Díaz Carmona,1,1,1953-03-28,0,1,0,0
Manuel Gavilán,1,1,1953-04-01,0,1,0,0
Frane Matošić,1,1,1953-05-09,1,0,0,0
Henri Coppens,7,4,1957-06-05,4,3,0,1
Léopold Anoul,5,4,1954-06-20,3,2,0,0
Kalevi Lehtovirta,3,2,1953-08-05,3,0,0,0
Bengt Berndtsson,1,1,1953-05-28,1,0,0,0
Arne Selmosson,1,1,1953-05-28,1,0,0,0
Jean-Louis Straetmans,1,1,1953-05-28,0,1,0,0
Victor Lemberechts,1,1,1953-05-28,0,1,0,0
Emil Pažický,1,1,1953-06-14,1,0,0,0
František Vlk,3,2,1953-09-06,1,2,0,0
Gunnar Thoresen,1,1,1953-06-24,1,0,0,0
Knut Dahlen,1,1,1953-06-24,1,0,0,0
Herbert Binkert,1,1,1953-06-24,0,1,0,0
Werner Otto,1,1,1953-06-24,0,1,0,0
Gerhard Siedl,1,1,1953-06-24,0,1,0,0
József Pecsovszky,2,1,1953-06-28,2,0,0,0
Dobromir Tashkov,1,1,1953-06-28,0,1,0,0
Alexandru Ene,3,3,1957-09-29,2,1,0,0
Tomás Balcázar,6,4,1954-06-19,4,2,0,0
Gregorio Gómez,1,1,1953-07-19,1,0,0,0
Nicolás Tellez,1,1,1953-07-19,1,0,0,0
Pedro Arnauda,3,1,1953-07-19,3,0,0,0
Nils-Åke Sandell,4,2,1953-08-16,2,2,0,0
Hans Persson,1,1,1953-08-05,0,1,0,0
Olavi Lahtinen,3,3,1957-07-27,1,2,0,0
Nils Rikberg,1,1,1953-08-05,1,0,0,0
Gösta Sandberg,1,1,1953-08-16,1,0,0,0
Herbert Sandin,1,1,1953-08-16,1,0,0,0
Harald Hennum,3,3,1957-06-12,3,0,0,0
Fritz Walter,5,4,1954-06-30,2,3,0,2
Stefan Bozhkov,1,1,1953-09-06,1,0,0,1
Roger Piantoni,8,7,1961-09-28,6,2,0,0
Antoine Kohn,1,1,1953-09-20,1,0,0,0
Raymond Kopa,7,7,1960-03-27,5,2,0,3
Raymond Cicci,1,1,1953-09-20,0,1,0,0
Léon Glovacki,2,2,1953-10-04,0,2,0,0
Édouard Kargu,1,1,1953-09-20,0,1,0,0
Pierre Flamion,2,2,1953-10-04,0,2,0,0
Mathieu Bollen,2,1,1953-09-23,2,0,0,0
Ernst Ocwirk,3,3,1954-07-03,2,1,0,0
Erich Probst,12,6,1960-03-27,11,1,0,0
José Águas,3,3,1961-05-21,2,1,0,0
Ernst Happel,1,1,1953-09-27,1,0,0,1
Theodor Wagner,6,3,1956-09-30,3,3,0,0
Robert Dienst,2,2,1957-09-29,1,1,0,0
Charlie Fleming,2,1,1953-10-03,0,2,0,0
Norman Lockhart,1,1,1953-10-03,1,0,0,1
Jackie Henderson,1,1,1953-10-03,0,1,0,0
Armand Penverne,1,1,1953-10-04,0,1,0,0
Joseph Ujlaki,5,3,1960-09-25,0,5,0,0
Reg Ryan,2,2,1953-10-28,2,0,0,2
Frank O'Farrell,1,1,1953-10-04,1,0,0,0
Victor Mees,3,2,1957-06-05,3,0,0,0
Ivor Allchurch,10,9,1965-10-27,5,5,0,0
Dennis Wilshaw,3,2,1954-06-20,0,3,0,0
Nat Lofthouse,6,4,1954-06-26,2,4,0,0
Gavril Serfözö,1,1,1953-10-11,0,1,0,0
Ivan Kolev,4,4,1965-11-21,1,3,0,1
Valeriu Călinoiu,1,1,1953-10-11,0,1,0,0
Max Morlock,12,7,1954-07-04,9,3,0,0
Horst Schade,1,1,1953-10-11,1,0,0,0
František Šafránek,1,1,1953-10-25,0,1,0,1
Arthur Fitzsimons,2,1,1953-10-28,2,0,0,0
Tommy Eglington,1,1,1953-10-28,1,0,0,0
Thanasis Bembis,1,1,1953-11-01,1,0,0,0
Allan Brown,2,2,1954-04-03,2,0,0,0
Bobby Johnstone,1,1,1953-11-04,1,0,0,0
John Charles,4,3,1958-06-08,1,3,0,0
Miloš Milutinović,4,3,1957-11-17,3,1,0,0
Harold Hassall,2,1,1953-11-11,2,0,0,0
Eddie McMorran,1,1,1953-11-11,0,1,0,0
Ad-Diba,6,3,1957-02-16,5,1,0,0
Amleto Frignani,3,3,1954-06-20,1,2,0,0
Hans Nordahl,1,1,1953-11-22,0,1,0,0
Ottmar Walter,5,4,1954-06-30,3,2,0,0
Helmut Rahn,11,9,1958-06-28,7,4,0,0
Jean Desgranges,2,1,1953-12-17,2,0,0,0
Jean Vincent,12,8,1960-07-06,12,0,0,0
Just Fontaine,21,9,1959-12-13,20,1,0,0
Jacques Foix,1,1,1953-12-17,1,0,0,0
Rafael Ávalos,1,1,1953-12-27,0,1,0,0
José Luis Lamadrid,5,4,1954-06-19,2,3,0,0
Venancio García,1,1,1954-01-06,1,0,0,0
Recep Adanır,1,1,1954-01-06,0,1,0,0
Miguel González,2,2,1957-03-10,2,0,0,0
Rafael Alsua,1,1,1954-01-06,1,0,0,0
William Scheppel,1,1,1954-01-10,1,0,1,0
Bill Looby,4,3,1954-04-04,0,4,0,0
Alfredo Torres,2,1,1954-01-14,2,0,0,0
Alaa El-Hamouly,1,1,1954-01-24,0,1,0,0
Giampiero Boniperti,3,2,1954-06-17,2,1,0,0
Eduardo Ricagni,1,1,1954-01-24,1,0,0,0
Manuel Lugo,3,2,1954-02-21,1,2,0,0
José Parodi,4,4,1958-06-15,3,1,0,0
Ireneo Hermosilla,1,1,1954-02-14,1,0,0,0
Silvio Parodi,6,5,1959-12-22,2,4,0,0
Ted Robledo,1,1,1954-02-21,1,0,0,0
Ken Naganuma,1,1,1954-03-07,1,0,0,0
Chung Nam-sik,2,2,1954-03-14,0,2,0,0
Choi Kwang-suk,2,2,1954-03-14,0,2,0,0
Sung Nak-woon,3,3,1956-09-15,1,2,0,0
Choi Chung-min,5,3,1960-10-14,3,2,0,0
George Cummins,2,2,1957-10-02,0,2,0,0
Dimitris Kokkinakis,1,1,1954-03-08,0,1,0,0
Georgios Kamaras,1,1,1954-03-08,0,1,0,0
Toshio Iwatani,2,1,1954-03-14,2,0,0,0
Burhan Sargın,5,3,1954-06-20,2,3,0,0
José Artetxe,1,1,1954-03-17,0,1,0,0
Suat Mamat,4,3,1954-06-20,1,3,0,0
Adrián Escudero,1,1,1954-03-17,0,1,0,0
Eulogio Martínez,2,2,1955-03-02,0,2,0,0
Maurinho,2,2,1956-01-24,2,0,0,0
Branko Zebec,2,2,1954-06-19,0,2,0,0
Todor Veselinović,4,3,1958-06-15,0,4,0,0
Herbert Martin,1,1,1954-03-28,1,0,0,1
Hans Schäfer,8,7,1958-06-28,3,5,0,0
Peter McParland,7,4,1958-06-17,0,7,0,0
Cornelius Casey,1,1,1954-04-03,0,1,0,0
Efrain Chacurian,1,1,1954-04-03,0,1,0,0
Gerard Ellie,2,1,1954-04-03,2,0,0,1
Ivor Broadis,3,2,1954-06-17,0,3,0,0
Johnny Nicholls,1,1,1954-04-03,0,1,0,0
Ronnie Allen,1,1,1954-04-03,0,1,0,0
Jimmy Mullen,2,2,1954-06-20,0,2,0,0
Willie Ormond,1,1,1954-04-03,1,0,0,0
Ruben Mendoza,2,2,1957-07-06,1,1,0,0
Didi,14,11,1959-03-21,12,2,0,1
Julinho,1,1,1954-06-16,1,0,0,0
Jimmy Dickinson,1,1,1954-06-17,1,0,1,0
Bernhard Klodt,1,1,1954-06-17,1,0,0,0
Ferenc Puskás,4,3,1954-07-04,2,2,0,0
Mihály Lantos,2,2,1954-06-27,1,1,0,1
Sándor Kocsis,11,4,1954-06-30,5,6,0,0
Zoltán Czibor,3,3,1954-07-04,2,1,0,0
Péter Palotás,2,1,1954-06-17,2,0,0,0
Josef Hügi,8,4,1957-03-10,6,2,0,0
Ernst Stojaspal,3,2,1954-07-03,3,0,0,1
Raúl Cárdenas,2,2,1961-04-12,2,0,1,0
Carlos Borges,8,5,1959-03-08,1,7,0,0
Julio Abbadie,5,3,1955-03-23,0,5,0,0
Carlo Galli,1,1,1954-06-20,0,1,0,0
Benito Lorenzi,1,1,1954-06-20,0,1,0,0
Alfred Pfaff,1,1,1954-06-20,1,0,0,0
Nándor Hidegkuti,6,4,1957-09-15,1,5,0,0
József Tóth,2,2,1982-06-15,1,1,0,0
Richard Herrmann,1,1,1954-06-20,1,0,0,0
Mustafa Ertan,1,1,1954-06-23,0,1,0,0
Fulvio Nesti,1,1,1954-06-23,0,1,0,0
Tom Finney,2,2,1958-06-08,2,0,0,1
Javier Ambrois,12,6,1957-06-16,1,11,0,1
Alfred Körner,3,2,1958-06-15,1,2,0,0
Djalma Santos,1,1,1954-06-27,1,0,0,1
Ivica Horvat,1,1,1954-06-27,1,0,1,0
Juan Hohberg,3,2,1954-07-03,0,3,0,0
Luis Cruz,1,1,1954-07-03,1,0,1,0
Enrique Hormazábal,10,7,1956-02-12,8,2,0,0
Guillermo Díaz,3,2,1957-09-22,3,0,0,0
Washington Villacreses,1,1,1955-02-27,0,1,0,0
Rodolfo Micheli,8,4,1955-03-30,7,1,0,1
Máximo Rolón,7,6,1956-02-05,3,4,0,1
José Borello,3,3,1955-03-27,3,0,0,0
Salvador Villalba,1,1,1955-03-02,0,1,0,0
Manuel Muñoz,5,4,1956-02-09,5,0,0,0
Guillermo Barbadillo,1,1,1955-03-06,0,1,0,0
Jaime Ramírez,9,8,1962-06-02,7,2,0,1
Ricardo Bonelli,1,1,1955-03-09,1,0,0,0
Ernesto Grillo,2,2,1955-03-16,2,0,0,0
Américo Galván,3,2,1955-03-23,0,3,0,0
Honorato Gonzabay,2,1,1955-03-13,0,2,2,0
Isidro Matute,3,2,1955-03-23,3,0,0,0
Carlos Cecconato,2,2,1956-02-01,2,0,0,0
Roberto Castillo,1,1,1955-03-30,1,0,0,0
Guillermo Escalada,8,7,1961-07-30,4,4,0,0
José Walter Roque,2,2,1957-04-01,1,1,0,0
Antonio Gómez,1,1,1956-01-21,0,1,0,0
Omar Sívori,4,4,1957-04-06,3,1,0,0
Federico Vairo,1,1,1956-01-22,1,0,0,0
Leonel Sánchez,11,10,1965-10-12,9,2,0,3
Alvaro José Rodrigues Valente,1,1,1956-02-01,1,0,0,0
Moysés Ferreira Alves,1,1,1956-02-01,1,0,0,0
Luís Trochillo,1,1,1956-02-05,0,1,0,0
Isaac Andrade,1,1,1956-02-05,0,1,0,0
José Fernández,4,3,1957-03-28,1,3,0,0
Au Chi Yin,2,1,1956-09-01,2,0,0,0
Nahum Stelmach,9,7,1961-10-15,8,1,0,0
Tang Yee Kit,1,1,1956-09-06,1,0,0,0
Ko Po Keung,2,2,1956-09-09,2,0,0,0
Kim Ji-sung,1,1,1956-09-06,0,1,0,0
Choi Kwang-seok,1,1,1956-09-06,0,1,0,0
Woo Sang-kwon,5,4,1960-10-17,4,1,0,1
Trần Văn Tổng,2,2,1956-09-12,0,2,0,0
Chu Wing Wah,1,1,1956-09-09,1,0,0,1
Lê Hữu Đức,3,2,1956-09-15,0,3,0,0
Trải Văn Đào,1,1,1956-09-15,0,1,0,0
Gerhard Hanappi,3,2,1957-09-25,2,1,0,0
Otto Walzhofer,1,1,1956-09-30,1,0,0,0
Ernst Kozlicek,1,1,1956-09-30,1,0,0,0
Walter Haummer,1,1,1956-09-30,1,0,0,0
Dermot Curtis,3,3,1957-10-02,1,2,0,0
Aage Rou Jensen,1,1,1956-10-03,0,1,0,0
Thadée Cisowski,9,3,1958-10-01,7,2,0,0
Denis Houf,1,1,1956-11-11,0,1,0,0
Maurice Willems,3,2,1957-09-04,0,3,0,0
Tommy Taylor,8,3,1957-05-15,6,2,0,0
Ove Bech Nielsen,2,1,1956-12-05,0,2,0,0
Duncan Edwards,2,1,1956-12-05,2,0,0,0
Billy Bingham,2,2,1962-11-28,1,1,0,0
Manuel Vasques,2,2,1957-05-26,2,0,0,0
Jorge Monge,4,2,1961-03-29,1,3,0,0
Rubén Jiménez Rodríguez,2,2,1957-02-17,1,1,0,0
Jorge Vickers,1,1,1957-02-10,1,0,0,0
Danilo Montero Campos,2,2,1957-08-04,0,2,0,0
Álvaro Murillo,3,2,1957-03-03,2,1,0,0
Augusto Espinoza,3,3,1960-08-28,2,1,0,0
Raafat Attia,1,1,1957-02-10,0,1,0,1
Boraî Bashir,1,1,1957-02-10,1,0,0,0
Mario Cordero,3,3,1963-03-28,2,1,0,1
Francisco López Contreras,3,3,1963-03-29,2,1,0,0
Rodolfo Herrera González,3,2,1957-03-03,3,0,0,0
Jorge Larraz,5,4,1957-04-01,2,3,0,4
José Sasía,9,9,1962-06-06,0,9,0,0
Siddiq Manzul,2,2,1959-05-29,1,1,0,1
Luis Suárez Miramontes,4,3,1959-06-28,1,3,0,0
Osvaldo Héctor Cruz,2,2,1957-04-03,2,0,0,0
Antonio Valentín Angelillo,8,5,1957-04-03,8,0,0,0
Humberto Maschio,9,4,1957-04-03,9,0,0,2
"Delio ""Maravilla"" Gamboa",3,2,1957-04-01,2,1,0,1
Alberto Valencia,1,1,1957-03-13,0,1,0,0
Oreste Corbatta,14,12,1960-12-17,12,2,0,6
José Macia,3,3,1957-03-24,3,0,0,0
Wilfred de Lanoy,2,1,1957-03-14,0,2,0,0
Edgard Meulens,1,1,1957-03-14,0,1,0,0
José Sanfilippo,10,6,1962-06-02,9,1,0,1
Cor van der Gijp,2,1,1957-03-20,2,0,0,0
Johnny Halsdorf,1,1,1957-03-20,0,1,0,0
Coen Dillen,1,1,1957-03-20,1,0,0,0
Toon Brusselers,1,1,1957-03-20,1,0,0,0
Evaristo de Macedo,8,3,1957-03-28,8,0,0,0
Joel Antônio Martins,2,1,1957-03-21,2,0,0,0
Carlos Verdejo,2,1,1957-03-21,2,0,0,0
Sergio Espinoza,1,1,1957-03-21,1,0,0,0
Alejandro Carrillo,1,1,1957-03-21,0,1,0,0
José María Carranza,1,1,1957-03-23,0,1,0,0
Juan Seminario,3,2,1959-03-10,1,2,0,0
Manuel Rivera,2,1,1957-03-27,2,0,0,0
Juan Bassa,1,1,1957-03-27,1,0,0,0
Luis Norberto Campero,3,2,1957-04-01,0,3,0,0
Humberto Álvarez,1,1,1957-04-01,1,0,0,1
Jaime Gutiérrez,2,2,1957-06-20,2,0,0,0
Crescencio Gutiérrez,6,5,1961-04-12,5,1,0,0
Salvador Reyes Monteón,11,7,1965-03-07,8,3,0,0
Héctor Hernández,4,3,1962-06-07,1,3,0,1
Aluísio Francisco da Luz,1,1,1957-04-13,0,1,0,0
Valdir Pereira,1,1,1957-04-21,1,0,0,0
Sergio Cervato,1,1,1957-04-25,1,0,0,0
Ed Murphy,4,3,1965-03-21,2,2,0,0
Alfredo Hernández,3,1,1957-04-28,0,3,0,0
Enrique Sesma,2,2,1957-07-03,1,1,0,0
Tommy Casey,1,1,1957-05-01,1,0,0,0
Billy Simpson,1,1,1957-05-01,1,0,0,0
Jimmy McIlroy,4,4,1961-05-10,2,2,0,1
Roy Vernon,5,4,1965-12-01,5,0,0,0
John Atyeo,4,3,1957-05-19,2,2,0,0
Jackie Mudie,6,4,1958-06-11,4,2,0,0
Ladislao Kubala,4,3,1957-11-24,1,3,0,0
John Hewie,1,1,1957-05-08,1,0,0,1
Rusli Ramang,4,2,1957-06-02,2,2,0,0
John Jensen,4,4,1994-10-12,4,0,0,0
Johnny Haynes,3,3,1960-10-19,0,3,0,0
Mel Charles,1,1,1957-05-19,0,1,0,0
Günther Wirth,2,2,1957-06-16,1,1,0,0
Willy Tröger,1,1,1957-05-19,1,0,0,0
Alf Ringstead,1,1,1957-05-19,1,0,0,0
Roger Vonlanthen,2,2,1957-11-06,1,1,0,0
Tommy Ring,1,1,1957-05-19,0,1,0,0
Georgi Dimitrov,6,5,1985-09-25,2,4,0,0
Suleiman Faris,1,1,1957-05-24,0,1,0,0
Jabra Al-Zarqa,1,1,1957-05-24,1,0,0,0
Noud van Melis,3,2,1957-09-11,1,2,0,0
Karl Koller,2,2,1958-06-15,2,0,0,0
Hans Buzek,2,2,1957-09-29,1,1,0,0
Karl Stotz,1,1,1957-05-26,1,0,0,1
Ray Daniel,1,1,1957-05-26,1,0,1,0
Tadeusz Kraus,4,3,1957-10-27,2,2,0,0
António Dias Teixeira,1,1,1957-05-26,1,0,0,0
Matateu,3,3,1960-05-08,2,1,0,0
Enrique Mateos,1,1,1957-05-26,1,0,0,0
Gordon Smith,1,1,1957-05-26,0,1,0,0
Zhang Honggen,1,1,1957-06-02,1,0,0,0
Nian Weisi,1,1,1957-06-02,1,0,0,0
Sun Fucheng,1,1,1957-06-02,1,0,0,0
Endang Witarsa,1,1,1957-06-02,0,1,0,0
Wang Lu,1,1,1957-06-02,1,0,0,0
Célestin Oliver,2,1,1957-06-02,2,0,0,0
René Dereuddre,1,1,1957-06-02,1,0,0,0
Said Brahimi,1,1,1957-06-02,1,0,0,0
Richard Orlans,2,1,1957-06-05,2,0,0,0
André Piters,1,1,1957-06-05,1,0,0,0
Paul Vandenberg,4,2,1957-09-04,1,3,0,0
Þórður Þórðarson,2,1,1957-06-05,0,2,0,0
Ríkharður Jónsson,4,3,1962-08-12,1,3,0,0
Lajos Tichy,15,12,1964-04-25,5,10,0,1
Kjell Kristiansen,1,1,1957-06-12,1,0,0,0
Vlastimil Bubník,4,4,1960-07-09,2,2,0,0
Pavol Molnár,1,1,1957-06-16,1,0,0,0
Vaggelis Panakis,1,1,1957-06-16,1,0,0,0
Titus Ozon,1,1,1957-06-16,0,1,0,0
Ángel Jara Saguier,2,2,1957-07-14,1,1,0,0
Juan Bautista Agüero,5,5,1958-06-15,4,1,0,0
Óscar Aguilera,1,1,1957-06-20,0,1,0,0
Ricardo Díaz,1,1,1957-06-20,1,0,0,0
Norm McLeod,1,1,1957-06-22,1,0,0,0
Brian Philley,2,2,1957-07-06,1,1,0,0
Harry Keough,1,1,1957-06-22,0,1,0,1
Art Hughes,2,1,1957-06-22,2,0,0,0
Gogie Stewart,2,2,1957-07-06,1,1,0,0
Ferenc Machos,4,2,1957-11-10,4,0,0,0
József Bozsik,2,2,1958-06-08,2,0,0,0
Boris Tatushin,1,1,1957-06-23,1,0,0,0
Nikita Simonyan,5,3,1958-06-08,1,4,0,0
Anatoli Ilyin,6,5,1958-09-28,2,4,0,0
Carlos González,2,1,1957-06-30,2,0,0,0
Edward Jankowski,4,2,1957-11-03,1,3,0,0
Mauri Vanhanen,1,1,1957-07-05,1,0,0,0
Ostap Steckiw,1,1,1957-07-06,0,1,0,0
James Murphy,1,1,1957-07-06,1,0,0,0
Enrique Jara Saguier,2,1,1957-07-07,2,0,0,0
Florencio Amarilla,5,2,1958-06-08,3,2,0,1
Yuriy Voynov,2,2,1959-09-27,1,1,0,0
Igor Netto,2,2,1957-08-15,1,1,0,0
Eladio Benítez,1,1,1957-07-28,1,0,0,0
William Martínez,1,1,1957-07-28,1,0,0,0
Hubert Sambo,1,1,1957-08-04,1,0,0,0
Anatoli Isayev,2,1,1957-08-15,0,2,0,0
Eduard Streltsov,4,3,1967-06-11,1,3,0,0
Maryan Wisniewski,9,8,1963-02-27,7,2,0,0
Þórður Jónsson,2,2,1957-09-04,2,0,0,0
André van Herpe,1,1,1957-09-04,0,1,0,0
Jean-Pierre Fiedler,1,1,1957-09-11,0,1,0,0
Abe Lenstra,3,2,1957-09-25,3,0,0,0
Servaas Wilkes,1,1,1957-09-11,1,0,0,0
Kees Rijvers,1,1,1957-09-11,1,0,0,0
Léon Letsch,1,1,1957-09-11,0,1,0,0
Todor Diev,5,5,1963-09-29,5,0,0,0
Des Palmer,3,1,1957-09-25,3,0,0,0
Cliff Jones,3,3,1963-03-20,3,0,0,1
Manfred Kaiser,1,1,1957-09-25,0,1,0,0
Ausberto García,6,6,1963-03-31,6,0,0,0
Máximo Alcócer,11,8,1963-03-31,11,0,0,0
Helmut Senekowitsch,1,1,1957-09-29,0,1,0,0
Muhamed Mujić,4,3,1959-10-25,2,2,0,0
Norberto Menéndez,4,4,1958-06-11,3,1,0,0
Norberto Conde,1,1,1957-10-13,0,1,0,0
Roberto Zárate,5,4,1963-03-13,5,0,0,0
Jaime Belmonte,2,2,1958-06-11,2,0,0,0
Ligorio López,2,2,1957-10-27,1,1,0,0
Gerard Cieślik,2,1,1957-10-20,2,0,0,0
Valentin Kozmich Ivanov,11,9,1965-05-30,6,5,0,0
Eliseo Prado,1,1,1957-10-27,1,0,0,0
Juan Soto Quiros,1,1,1957-10-27,1,0,0,0
Anton Moravčík,1,1,1957-10-27,0,1,0,0
Helmut Müller,1,1,1957-10-27,1,0,0,0
Ladislav Novák,1,1,1957-10-27,0,1,0,0
Hristo Iliev,6,4,1962-12-16,4,2,0,0
Panayot Panayotov,2,1,1957-11-03,2,0,0,0
Krum Yanev,1,1,1957-11-03,1,0,0,0
Spiro Debarski,1,1,1957-11-03,1,0,0,0
Ginter Gawlik,1,1,1957-11-03,1,0,0,0
Lucjan Brychczy,6,5,1967-10-08,4,2,0,0
Iosif Petschovsky,1,1,1957-11-03,1,0,0,1
Nicolae Tătaru,2,2,1962-11-25,2,0,0,0
Cornel Cacoveanu,1,1,1957-11-03,1,0,0,0
Archie Robertson,1,1,1957-11-06,1,0,0,0
Ferdinando Riva,1,1,1957-11-06,0,1,0,0
Alex Scott,1,1,1957-11-06,1,0,0,0
Károly Sándor,6,6,1963-11-03,4,2,0,0
Lajos Csordás,2,1,1957-11-10,2,0,0,0
Edgar Falch,1,1,1957-11-10,1,0,1,0
Dobrosav Krstić,1,1,1957-11-10,1,0,0,0
Kostas Nestoridis,1,1,1957-11-10,0,1,0,0
Aleksandar Petaković,3,3,1958-06-11,1,2,0,0
Genrich Fedosov,1,1,1957-11-24,0,1,0,0
Guido Gratton,2,1,1957-12-22,2,0,0,0
Gino Pivatelli,1,1,1957-12-22,1,0,0,0
Dave Bowen,1,1,1958-01-15,0,1,0,0
Wilbur Cush,2,2,1958-06-08,1,1,0,0
Dino da Costa,1,1,1958-01-15,0,1,0,0
Uwe Seeler,14,13,1970-06-14,8,6,0,0
José Altafini,3,2,1961-10-15,0,3,0,0
Aleksandr Ivanov,1,1,1958-06-08,0,1,0,0
Derek Kevan,2,2,1958-06-15,1,1,0,0
Jorge Lino Romero,2,2,1958-06-15,1,1,0,0
Jimmy Murray,1,1,1958-06-08,1,0,0,0
Agne Simonsson,8,6,1965-05-05,7,1,0,0
Ludovico Avio,1,1,1958-06-11,1,0,0,0
Milan Dvořák,2,2,1958-06-15,1,1,0,1
Zdeněk Zikán,4,3,1958-06-17,2,2,0,0
Cayetano Ré,4,2,1959-03-15,1,3,0,0
Bobby Collins,1,1,1958-06-11,0,1,0,0
Kurt Hamrin,7,6,1964-11-04,5,2,0,0
Jiří Feureisl,1,1,1958-06-15,0,1,0,0
Václav Hovorka,2,1,1958-06-15,0,2,0,0
Vavá,9,6,1962-06-17,5,4,0,0
Sammy Baird,1,1,1958-06-15,0,1,0,0
József Bencsics,1,1,1958-06-15,1,0,0,0
Radivoje Ognjanović,1,1,1958-06-15,0,1,0,0
Zdravko Rajkov,1,1,1958-06-15,0,1,0,0
Terry Medwin,2,2,1962-11-07,0,2,0,0
Pelé,26,17,1970-06-21,20,6,0,0
Lennart Skoglund,1,1,1958-06-24,1,0,0,0
Gunnar Gren,1,1,1958-06-24,1,0,0,0
Hans Cieslarczyk,1,1,1958-06-28,0,1,0,0
Yvon Douis,2,2,1963-02-27,2,0,0,0
Mário Zagallo,2,2,1962-05-30,1,1,0,0
Slava Metreveli,7,7,1965-10-17,4,3,0,0
János Göröcs,4,4,1968-05-04,3,1,0,0
Ilias Yfantis,1,1,1958-10-01,0,1,0,0
Nicolae Oaidă,1,1,1958-11-02,1,0,0,0
Gheorghe Constantin,2,2,1962-11-25,2,0,0,0
Constantin Dinulescu,1,1,1958-11-02,1,0,0,0
Stéphane Bruey,1,1,1958-12-03,0,1,0,0
Roger Marche,1,1,1958-12-03,1,0,1,0
Pedro Waldemar Manfredini,2,1,1959-03-07,2,0,0,0
Pedro Eugenio Callá,2,2,1959-03-11,2,0,0,0
Juan José Pizzuti,4,3,1959-12-09,4,0,0,0
Luis Hernán Álvarez,1,1,1959-03-07,0,1,0,0
Raúl Belén,3,2,1959-03-30,3,0,0,0
Víctor Guaglianone,1,1,1959-03-08,0,1,0,0
Vladas Douksas,3,3,1959-03-18,0,3,0,0
Domingo Pérez,3,3,1967-01-29,1,2,0,0
José Aveiro,6,4,1959-04-02,3,3,0,0
Héctor Demarco,3,3,1959-03-30,0,3,0,0
Miguel Ángel Loayza,5,3,1959-03-21,3,2,0,0
Juan Joya,2,1,1959-03-14,2,0,0,0
Ildefonso Sanabria,1,1,1959-03-15,0,1,0,0
Rubén Héctor Sosa,7,6,1960-12-17,5,2,0,0
Víctor Benítez,1,1,1959-03-18,1,0,1,0
Paulo Valentim,5,2,1959-03-26,3,2,0,0
Armando Tobar,1,1,1959-03-21,1,0,0,0
Vladislao Cap,1,1,1959-03-22,1,0,0,0
Mario Soto,3,2,1979-08-29,1,2,0,0
Juan Soto Mura,2,1,1959-03-26,0,2,0,0
Chinesinho,1,1,1959-03-29,1,0,0,0
Mario Moreno,1,1,1959-04-02,1,0,0,0
Liam Tuohy,3,3,1962-09-02,2,1,0,0
Noel Cantwell,6,4,1967-02-22,5,1,0,2
Imrich Stacho,1,1,1959-05-10,1,0,0,1
Titus Buberník,5,3,1960-05-29,5,0,0,0
Ladislav Pavlovič,2,2,1960-07-09,1,1,0,0
Milan Dolinský,3,3,1959-10-18,2,1,0,0
Erich Hof,10,5,1968-05-19,8,2,0,3
Mahmoud El-Gohary,3,1,1959-05-22,3,0,0,0
Mimi El-Sherbini,1,1,1959-05-22,1,0,0,0
Abdelmutaleb Nasir,1,1,1959-05-25,0,1,0,0
Essam Baheeg,2,1,1959-05-29,2,0,0,0
Milan Galić,17,14,1965-09-19,5,12,0,0
Lazar Tasić,1,1,1959-05-31,1,0,0,0
Mário Coluna,6,5,1965-01-24,5,1,0,0
Ernest Pohl,3,3,1965-10-24,2,1,0,0
Gerhard Vogt,1,1,1959-06-28,0,1,0,0
Domiciano Cavém,2,2,1960-05-22,1,1,0,0
Horst Kohle,1,1,1959-06-28,0,1,0,0
Ove Ødegaard,2,1,1959-09-23,0,2,0,0
Horst Nemec,3,2,1960-03-27,3,0,0,0
Karl Skerlan,1,1,1959-09-23,1,0,0,0
Poul Pedersen,1,1,1959-09-23,1,0,0,0
Bent Hansen,1,1,1959-09-23,1,0,0,0
Ladislav Kačáni,1,1,1959-09-23,0,1,0,0
Enric Gensana,1,1,1959-10-14,1,0,0,0
Francisco Gento,3,3,1967-05-31,2,1,0,0
John Kramer,1,1,1959-10-18,0,1,0,0
Adolf Scherer,10,7,1962-06-13,8,2,0,1
Paulo Pisaneschi,4,2,1959-12-19,3,1,0,0
Alcides Silveira,3,2,1959-12-16,0,3,0,3
Mario Ludovico Bergara,4,3,1959-12-16,0,4,0,0
Eligio Antonio Insfrán,1,1,1959-12-09,0,1,0,0
Pedro Antonio Cabral,1,1,1959-12-09,0,1,0,0
Carlos Alberto Raffo,10,8,1963-03-31,6,4,0,0
Walter Horak,1,1,1959-12-13,0,1,0,0
Rudolf Pichler,1,1,1959-12-13,0,1,0,0
Geraldo José da Silva,2,2,1959-12-22,0,2,0,0
Zé de Mello,1,1,1959-12-19,0,1,0,0
Omar Higinio García,1,1,1959-12-22,1,0,0,0
Romulo Gómez,3,3,1965-10-12,1,2,2,0
Alberto Spencer,4,4,1965-08-22,3,1,0,0
José Vicente Balseca,1,1,1959-12-25,1,0,0,0
Climaco Cañarte,1,1,1959-12-25,1,0,0,0
Jean-Jacques Marcel,2,2,1960-12-11,1,1,0,0
Bernard Rahis,1,1,1960-03-27,0,1,0,0
François Heutte,3,2,1960-07-06,2,1,0,0
Joaquim Santana,1,1,1960-05-08,1,0,0,0
Bora Kostić,4,3,1961-06-04,3,1,0,0
Josef Masopust,3,3,1962-06-17,1,2,0,0
Dragoslav Šekularac,3,2,1961-10-08,3,0,0,0
Zvezdan Čebinac,2,2,1961-10-08,2,0,0,0
Valentin Ivanov,3,2,1964-06-17,0,3,0,0
Viktor Ponedelnik,10,9,1964-06-17,6,4,0,0
Ante Žanetić,1,1,1960-07-06,0,1,0,0
Tomislav Knez,1,1,1960-07-06,0,1,0,0
Dražan Jerković,8,6,1964-09-29,1,7,0,0
Rigoberto Rojas,1,1,1960-08-21,1,0,0,0
Fred Masella,1,1,1960-08-21,0,1,0,0
Juan Ulloa,6,4,1961-03-29,4,2,0,0
Edward Acquah,7,4,1963-12-01,5,2,0,0
Edward Boateng,1,1,1960-08-28,1,0,0,0
Dejo Fayemi,2,2,1960-09-10,1,1,0,1
Edward Aggrey-Fynn,2,2,1963-12-01,2,0,0,1
Mohamadu Salisu,1,1,1960-08-28,1,0,0,0
Pinula Contreras,4,2,1960-09-25,3,1,0,0
Rubén Jiménez,5,3,1963-04-07,3,2,0,0
Carlos Humberto Suazo,2,2,1960-09-25,2,0,0,0
Ronald Leaky,1,1,1960-09-04,1,0,0,0
Marvin Rodríguez,4,4,1961-03-29,3,1,0,0
Godwin Emenako,1,1,1960-09-10,1,0,0,0
Walter Pearson,3,3,1963-04-05,2,1,0,0
Kai Pahlman,2,2,1961-09-28,1,1,0,1
Eduvigis Rudolfo Dirksz,2,1,1960-10-02,0,2,0,0
August Foe a Man,1,1,1960-10-02,1,0,0,0
Cho Yoon-ok,4,2,1960-10-17,4,0,0,0
Moon Jung-sik,2,2,1960-10-21,2,0,0,0
Nguyễn Văn Tu,1,1,1960-10-14,0,1,0,0
Luk Man Wai,1,1,1960-10-16,1,0,0,0
Yiu Cheuk Yin,1,1,1960-10-16,1,0,0,0
Rafi Levi,1,1,1960-10-19,1,0,0,0
Shlomo Levi,5,3,1960-11-27,5,0,0,0
Avraham Menchel,1,1,1960-10-19,1,0,0,0
Trần Văn Nhung,1,1,1960-10-19,0,1,0,1
Amnon Aharonskind,1,1,1960-10-19,1,0,0,0
Bobby Charlton,14,10,1968-06-08,9,5,0,0
Jimmy Greaves,4,2,1962-06-02,0,4,0,0
Bobby Smith,3,2,1963-02-27,0,3,0,0
Rune Börjesson,3,2,1961-05-28,3,0,0,0
Yngve Brodd,5,4,1961-11-12,1,4,0,0
Albert Brülls,4,4,1962-06-03,2,2,0,0
Billy McAdams,3,1,1960-10-26,3,0,0,0
Gert Dörfel,3,2,1960-11-20,0,3,0,0
Mohamed Khalfi,2,2,1961-05-28,2,0,0,0
Rached Meddeb,2,2,1962-01-20,1,1,0,0
Abdallah Azhar,3,3,1961-11-23,2,1,0,1
Sigfrido Mercado,3,3,1961-04-12,2,1,0,0
Helmut Bicek,2,2,1965-03-07,2,0,0,1
Carl Fister,1,1,1960-11-03,1,0,0,0
Al Zerhusen,1,1,1960-11-03,1,0,0,0
Isidoro Díaz,10,7,1965-05-07,5,5,0,0
Koji Sasaki,1,1,1960-11-06,0,1,0,0
Chung Soon-cheon,4,3,1961-10-08,2,2,0,0
Michalis Yasemis,2,2,1960-11-27,1,1,0,1
Boaz Kofman,1,1,1960-11-13,0,1,0,0
Abdelmajid Chetali,3,3,1965-11-21,2,1,0,0
Abdelmajid Tlemçani,1,1,1960-11-13,1,0,0,0
Lahcen Chicha,1,1,1960-11-13,0,1,0,0
Marcel Paeschen,1,1,1960-11-20,1,0,0,0
Heinz Schneiter,3,3,1962-06-03,1,2,0,0
Paul Van Himst,15,9,1972-06-17,10,5,0,1
Helmut Haller,9,6,1969-05-21,7,2,0,1
Shlomo Nahari,1,1,1960-11-27,1,0,0,0
Martín Pando,2,2,1960-12-17,1,1,0,0
Ricardo José Maria Ramaciotti,1,1,1960-12-04,0,1,0,0
Lucien Cossou,4,3,1964-04-25,4,0,0,0
Brahim Kerrit,1,1,1961-01-22,0,1,0,0
Kebede Metaferia,1,1,1961-03-19,0,1,0,0
Luciano Vassallo,7,6,1968-01-19,6,1,0,4
Fernand Brosius,1,1,1961-03-19,1,0,1,0
Yaúca,4,2,1961-10-08,3,1,0,0
Carlos Vivo Goban,1,1,1961-03-22,1,0,0,0
Manrique Quesada,2,1,1961-03-29,2,0,0,0
Francisco Rojas,1,1,1961-03-29,1,0,0,0
Francisco Flores,4,2,1961-04-12,4,0,0,0
Eduardo González Palmer,2,1,1961-04-05,2,0,0,0
Álvaro Grant,1,1,1961-04-12,0,1,0,0
Flórián Albert,11,8,1969-05-25,5,6,0,0
Phil Woosnam,1,1,1961-04-19,1,0,0,0
Alfonso Rodríguez Salas,1,1,1961-04-19,0,1,0,0
Edwin Miliano Loran,2,1,1961-04-23,2,0,0,0
Eusebio Escobar,1,1,1961-04-30,1,0,0,0
Máté Fenyvesi,3,3,1965-09-05,1,2,0,0
Andreas Papaemmanouil,4,3,1964-12-09,3,1,0,0
Ralph Brand,3,2,1961-05-07,2,1,0,0
Joe Haverty,1,1,1961-05-03,0,1,0,0
David Herd,2,1,1961-05-03,2,0,0,0
Faustino Delgado,1,1,1961-05-07,1,0,0,1
Héctor González,4,4,2004-03-31,2,2,0,0
Alex Young,2,1,1961-05-07,0,2,0,0
Richard Kreß,1,1,1961-05-10,1,0,0,0
Tomáš Pospíchal,4,3,1961-11-29,4,0,0,0
Andrej Kvašňák,10,8,1969-12-03,6,4,0,2
Josef Kadraba,2,2,1962-06-13,2,0,0,0
Henk Groot,3,3,1962-11-11,1,2,0,0
Dieter Erler,4,4,1963-11-03,3,1,0,0
Joaquín Peiró,2,2,1962-06-03,1,1,0,0
Roger Claessen,3,3,1967-11-22,1,2,0,0
Ron Flowers,4,4,1962-10-03,2,2,0,3
Torbjörn Jonsson,3,3,1965-09-26,3,0,0,0
Metin Oktay,3,3,1961-11-12,2,1,0,0
Tomislav Kaloperović,1,1,1961-06-04,1,0,0,1
Yoo Pan-soon,1,1,1961-06-11,0,1,0,0
Valery Voronin,4,4,1965-06-27,3,1,0,0
Jan Szmidt,1,1,1961-06-25,1,0,0,0
Valentin Bubukin,2,1,1961-07-01,2,0,0,0
Mikheil Meskhi,3,3,1965-06-27,2,1,0,0
Bjørn Borgen,1,1,1961-07-01,0,1,0,0
Eldar Hansen,1,1,1961-07-01,0,1,0,0
Luis Cubilla,5,5,1973-07-08,1,4,0,0
Ángel Cabrera,2,2,1962-06-02,2,0,0,0
Wilfredo Camacho,5,5,1963-03-31,4,1,0,0
Ernő Solymosi,4,4,1968-05-11,2,2,1,1
Peter Ducke,7,6,1975-09-27,2,5,0,0
Ray Pointer,2,2,1961-10-25,2,0,0,0
Dennis Viollet,1,1,1961-09-28,1,0,0,0
Camille Dimmer,3,2,1963-10-30,0,3,0,0
Jacques Faivre,2,1,1961-09-28,2,0,0,0
Ernest Schultz,1,1,1961-09-28,1,0,0,0
Ian St. John,3,2,1961-11-29,1,2,0,0
Denis Law,7,6,1968-11-06,4,3,0,0
Ady Schmit,5,3,1964-09-29,3,2,0,0
Nicolas Hoffmann,1,1,1961-10-08,1,0,0,0
Eusébio,26,18,1973-03-28,9,17,0,5
Johnny Giles,1,1,1961-10-08,1,0,0,0
Petar Radaković,2,2,1962-06-10,1,1,0,0
Reuven Young,1,1,1961-10-15,1,0,0,0
Francisco Lojacono,1,1,1961-10-15,0,1,0,1
Mario Corso,3,2,1961-11-04,1,2,0,0
Jim McLaughlin,2,1,1961-10-17,2,0,0,0
Anthonie van der Linden,3,2,1962-11-11,1,2,0,0
Tivadar Monostori,1,1,1961-10-22,1,0,0,0
John Connelly,1,1,1961-10-25,1,0,0,0
Sauli Pietiläinen,1,1,1961-10-29,0,1,0,0
Dimitar Yakimov,4,4,1969-12-07,2,2,0,0
Petar Velichkov,1,1,1961-10-29,1,0,0,0
Josef Jelínek,1,1,1961-10-29,1,0,0,0
Amby Fogarty,3,3,1963-10-13,2,1,0,0
Rolf Wüthrich,2,2,1962-05-30,1,1,0,0
Norbert Eschmann,1,1,1961-10-29,1,0,0,0
Roald Jensen,1,1,1961-10-29,0,1,0,0
Aydın Yelken,1,1,1961-10-29,1,0,0,0
Omar Sivori,4,1,1961-11-04,4,0,0,0
Antonio Angelillo,1,1,1961-11-04,1,0,0,0
Luis del Sol,1,1,1961-11-12,0,1,0,0
Gennadi Gusarov,2,2,1963-11-10,0,2,0,0
Aleksei Mamykin,2,2,1962-06-06,1,1,0,0
Marcelino Martínez,4,3,1964-06-21,4,0,0,0
Sellam Riahi,1,1,1961-11-23,0,1,0,0
Enrique Collar,2,2,1962-11-01,2,0,0,0
Yoo Pan-sun,1,1,1961-11-26,1,0,0,0
Jiří Hledík,1,1,1961-11-29,1,0,0,0
Ammar Merrichkou,1,1,1962-01-14,0,1,0,0
Moncef Cherif,1,1,1962-01-14,0,1,0,0
Girma Tekle,4,4,1968-01-12,4,0,0,0
Mengistu Worku,11,8,1970-02-10,9,2,0,0
John Bunyenyezi,1,1,1962-01-18,0,1,0,0
Badawi Abdel Fattah,3,2,1962-01-21,1,2,0,0
Saleh Selim,1,1,1962-01-18,1,0,0,0
Mohamed Salah Jedidi,4,4,1965-11-12,2,2,0,0
Chedly Laaouini,1,1,1962-01-20,1,0,0,0
Italo Vassalo,1,1,1962-01-21,1,0,0,0
Héctor Facundo,1,1,1962-05-30,1,0,0,0
Francisco Zuluaga,1,1,1962-05-30,1,0,0,1
Jozef Štibrányi,1,1,1962-05-31,1,0,0,0
Jorge Toro,2,2,1962-06-13,2,0,0,0
Josip Skoblar,4,3,1967-05-03,3,1,0,2
Georgi Sokolov,1,1,1962-06-03,1,0,0,0
Igor Chislenko,8,8,1967-08-30,4,4,0,0
Germán Aceros,3,3,1963-03-31,2,1,0,0
Marcos Coll,1,1,1962-06-03,1,0,0,0
Antonio Rada,3,2,1965-08-07,3,0,0,1
Marino Klinger,1,1,1962-06-03,1,0,0,0
Adelardo Rodríguez,1,1,1962-06-06,0,1,0,0
Amarildo Tavares da Silveira,3,2,1962-06-17,3,0,0,0
Horst Szymaniak,2,2,1965-11-14,0,2,0,1
Vojislav Melić,1,1,1962-06-07,0,1,0,0
Václav Mašek,2,2,1963-03-31,2,0,0,0
Alfredo del Águila,1,1,1962-06-07,0,1,0,0
Bruno Mora,3,3,1965-12-07,3,0,0,0
Giacomo Bulgarelli,3,2,1964-11-04,3,0,0,0
Garrincha,5,3,1966-07-12,3,2,0,0
Gerry Hitchens,1,1,1962-06-10,0,1,0,0
Eladio Rojas,2,2,1962-06-16,2,0,0,0
Zito,1,1,1962-06-17,1,0,0,0
Örjan Martinsson,2,1,1962-06-21,0,2,0,0
Ole Madsen,14,9,1969-06-15,9,5,0,0
Eyvind Clausen,2,2,1963-06-29,2,0,0,0
Eddie Theobald,2,2,1970-12-20,1,1,0,1
Henning Enoksen,2,2,1963-06-29,2,0,0,0
Carl Bertelsen,3,3,1964-06-20,1,2,0,0
Garðar Árnason,1,1,1962-09-02,1,0,0,0
Yvon Goujon,3,2,1963-10-26,2,1,0,0
Derek Dougan,4,4,1971-04-21,2,2,0,0
Billy Humphries,1,1,1962-10-10,0,1,0,0
Vicente Guillot,3,1,1962-11-01,3,0,0,0
José Luis Veloso,2,2,1962-11-25,1,1,0,0
Ion Nunweiller,1,1,1962-11-01,1,0,1,0
Leif Eriksson,4,3,1969-06-19,3,1,0,0
John Krogh,1,1,1962-11-04,0,1,0,0
Jacques Stockman,5,3,1967-03-19,1,4,0,0
Armand Jurion,2,2,1965-05-09,1,1,0,1
Velibor Vasović,2,2,1965-11-07,2,0,0,0
Georgi Asparuhov,14,11,1969-06-15,11,3,0,1
Charles Hertig,1,1,1962-11-11,0,1,0,0
Sjaak Swart,2,2,1966-11-30,2,0,0,0
Kurt Liebrecht,1,1,1962-11-21,1,0,0,1
Rudolf Kučera,1,1,1962-11-21,0,1,0,0
Cicerone Manolache,1,1,1962-11-25,1,0,0,0
Johnny Crossan,1,1,1962-11-28,1,0,0,0
Gianni Rivera,10,9,1974-06-15,8,2,0,1
Alberto Orlando,4,1,1962-12-02,4,0,0,0
Joseph Urpani,1,1,1962-12-08,1,0,0,0
Carl Emil Christiansen,1,1,1962-12-08,0,1,0,0
Hernâni Ferreira da Silva,2,1,1962-12-16,2,0,0,0
Bobby Tambling,1,1,1963-02-27,0,1,0,0
Carlos Campillo,2,2,1963-03-20,1,1,0,0
Jorge Hugo Fernández,1,1,1963-03-10,1,0,0,0
Mario Rodríguez,5,4,1963-03-28,3,2,0,0
Renán López,1,1,1963-03-10,1,0,0,0
Fortunato Castillo,4,4,1965-08-22,4,0,0,0
Enrique Raymondi,6,4,1965-08-15,3,3,0,0
Jorge Bolaños,2,2,1963-03-31,0,2,0,0
Flávio Minuano,5,3,1963-03-31,3,2,0,0
Enrique Tenemás,1,1,1963-03-13,0,1,0,0
Alberto Gallardo,7,7,1970-06-14,1,6,0,0
Marco Antônio García Alves,2,2,1963-03-31,1,1,0,0
Oswaldo Taurisano,3,2,1963-03-27,3,0,0,0
Fernando Consul,1,1,1963-03-14,1,0,0,0
Delio Gamboa,3,3,1966-11-30,1,2,0,0
Eladio Zárate,4,4,1963-03-27,1,3,0,0
César Cabrera,3,3,1963-03-31,1,2,0,0
Oppe Quiñónez,1,1,1963-03-14,0,1,0,0
Alonso Botero,2,2,1963-03-31,1,1,0,0
Pelayo Ayala,1,1,1963-03-17,0,1,0,0
Pedro Pablo León,6,4,1969-08-03,1,5,0,0
Nemesio Mosquera,2,2,1965-06-02,0,2,0,0
Carlos Pineda Alvarado,1,1,1963-03-20,0,1,0,0
Raúl Armando Savoy,4,2,1963-03-24,4,0,0,0
Leonardo Palacios,1,1,1963-03-20,0,1,0,0
Félix Arambulo,1,1,1963-03-20,0,1,0,0
Cecilio Martínez,3,2,1963-03-27,2,1,0,0
"Eduardo ""Volkswagen"" Hernández",9,7,1965-03-30,9,0,0,0
Mario Monge,4,3,1965-03-14,4,0,0,0
Rodolfo Ruiz,2,1,1963-03-23,2,0,0,0
Alfredo Ruano,1,1,1963-03-23,1,0,0,0
Armando Mendieta,1,1,1963-03-23,0,1,0,0
Jorge Roldán,4,4,1973-12-05,3,1,0,0
Eduardo de León,4,4,1967-03-14,3,1,0,1
Everardo Vega,1,1,1963-03-23,0,1,0,1
Adolfo Díaz Gáez,1,1,1963-03-23,0,1,0,0
Ernesto Humberto Juárez,1,1,1963-03-24,1,0,0,0
Francisco González,1,1,1963-03-24,1,0,0,0
Edgar Marín,6,4,1965-03-30,4,2,0,0
Juan José Gámez,2,1,1963-03-24,2,0,0,0
Juan González,4,2,1963-04-03,1,3,0,0
Luis Vázquez,1,1,1963-03-24,1,0,0,0
Ronald Delanoy,1,1,1963-03-24,0,1,0,0
Guillermo Ortiz Camargo,3,2,1963-03-28,1,2,0,1
Jesús del Muro,1,1,1963-03-24,0,1,1,0
Benjamín Velasco,1,1,1963-03-25,0,1,1,0
René Rodríguez Reyes,1,1,1963-03-25,1,0,0,0
Néstor Azón,1,1,1963-03-27,0,1,0,0
Félix Guerra,2,2,1963-03-29,0,2,0,0
Carlos Suazo,2,2,1963-04-03,1,1,0,0
César Reynosa,1,1,1963-03-27,1,0,0,0
Dámaso Silva,1,1,1963-03-27,0,1,0,0
Antony Ewing,1,1,1963-03-27,1,0,0,0
Haroldo Juárez,1,1,1963-03-27,1,0,0,0
Angelo Sormani,1,1,1963-03-27,0,1,0,0
Ramiro Blacut,2,2,1969-07-27,2,0,0,0
Vicente Pereda,1,1,1963-03-28,0,1,0,0
Armando Garrido,1,1,1963-03-28,0,1,0,0
Fernando Cuenca,1,1,1963-03-28,0,1,0,0
Albino Morales,1,1,1963-03-28,0,1,0,0
Felipe Barahona,1,1,1963-03-29,0,1,0,0
Luis Góyez,1,1,1963-03-29,0,1,0,0
Carlos Valderrama,7,7,1997-11-16,3,4,0,1
Juan Santamaría,2,1,1963-03-29,0,2,0,0
Luis Carlos Ponce,1,1,1963-03-29,0,1,0,0
Toribio Briesen,1,1,1963-03-30,0,1,0,0
Locelles Dinckley,1,1,1963-03-30,1,0,0,0
Daniel Pablo,1,1,1963-03-30,0,1,0,0
Juan Carlos Lallana,1,1,1963-03-31,1,0,0,0
Almir Da Silva,1,1,1963-03-31,0,1,0,0
Hugo Peña,6,5,1967-03-19,4,2,0,0
Nilmo Edwards,1,1,1963-03-31,0,1,0,0
Piet Kruiver,2,2,1963-10-30,1,1,0,0
Anton Allemann,2,2,1965-11-14,2,0,0,0
Armando Chacón,1,1,1963-04-03,1,0,0,0
Eugene Testing,3,3,1965-04-08,0,3,0,0
George Sillie,1,1,1963-04-03,0,1,0,0
Ruben Brandborg,2,1,1963-04-03,0,2,0,0
Dolores Cruz,2,2,1967-03-05,1,1,0,0
Enrique Córdoba,1,1,1963-04-07,1,0,0,0
Mauricio Ernesto González,6,4,1968-12-22,5,1,0,0
Juan Maximiliano Pablo,1,1,1963-04-07,0,1,0,0
Amancio Amaro,9,8,1972-10-19,9,0,0,0
Willie Irvine,2,2,1965-11-24,0,2,0,0
Jens Petersen,1,1,1963-06-29,1,0,0,1
Klaas Nuninga,1,1,1963-09-11,1,0,0,0
Paul May,1,1,1963-09-11,0,1,0,0
Slaven Zambata,7,4,1968-09-25,3,4,0,0
Örjan Persson,3,2,1969-06-19,2,1,0,0
Harry Bild,1,1,1963-09-18,1,0,0,0
Walter Koleznik,1,1,1963-10-13,0,1,0,0
Rudi Flögel,2,2,1967-09-24,1,1,0,0
Ferenc Bene,25,22,1972-05-06,12,13,0,0
Jürgen Nöldner,3,3,1965-10-31,2,1,0,0
Gyula Rákosi,2,2,1965-10-09,1,1,0,0
Robert Herbin,3,3,1967-10-28,2,1,0,0
Panajot Pano,2,2,1971-11-14,2,0,0,0
Werner Heine,1,1,1963-11-03,0,1,0,0
Roland Ducke,1,1,1963-11-03,0,1,0,0
Mohamed Morsi Hussein,4,2,1963-11-26,4,0,0,0
Hassan El-Shazly,12,7,1974-03-06,11,1,0,1
Asuquo Ekpe,1,1,1963-11-24,0,1,0,0
Joseph Bassey,1,1,1963-11-24,0,1,0,0
Albert Onyeanwuna,1,1,1963-11-24,0,1,0,0
Wilberforce Mfum,6,5,1968-01-19,4,2,0,0
Nasr Eddin Abbas,6,4,1970-02-10,2,4,0,0
Girma Tesfaye,1,1,1963-11-28,1,0,0,0
Ibrahim Yahia El-Kawarty,1,1,1963-11-28,0,1,0,0
Abdelaziz Ibrahim Adam,1,1,1963-11-28,0,1,0,0
Ezz El-Din Yaqoub,1,1,1963-11-30,1,0,0,0
Louis Pilot,4,3,1965-11-06,3,1,0,0
Henri Klein,2,1,1963-12-04,2,0,0,0
Johny Léonard,3,3,1969-04-23,0,3,0,1
Josep Maria Fusté,2,2,1966-07-20,1,1,0,0
Andy McEvoy,3,3,1966-11-16,1,2,0,0
Pedro Zaballa,2,1,1964-04-08,0,2,0,0
Néstor Combin,4,3,1965-11-06,2,2,0,0
Ferenc Sipos,1,1,1964-05-23,1,0,0,0
Daan Schrijvers,1,1,1964-05-24,1,0,0,1
Bennie Muller,1,1,1964-05-24,1,0,0,0
Mordechai Spiegler,9,8,1973-05-21,6,3,0,1
K. Appalaraju,1,1,1964-05-27,1,0,0,0
Inder Singh,2,2,1964-06-02,1,1,0,0
Yohai Aharoni,1,1,1964-05-29,1,0,0,0
Park Seung-ok,1,1,1964-05-30,0,1,0,0
Cheung Yiu Kwok,1,1,1964-06-02,1,0,0,0
Sukumar Samajpati,1,1,1964-06-02,0,1,0,0
Chuni Goswami,1,1,1964-06-02,0,1,0,0
Moshe Leon,1,1,1964-06-03,1,0,0,0
Gideon Tish,1,1,1964-06-03,1,0,0,0
Lee Soon-myung,1,1,1964-06-03,0,1,0,0
Chus Pereda,5,3,1965-10-27,5,0,0,0
Dezső Novák,3,2,1965-10-09,3,0,0,1
Galimzyan Khusainov,2,2,1965-06-27,1,1,0,0
Vladica Kovačević,1,1,1964-09-29,1,0,0,0
André Guy,2,2,1967-09-17,0,2,0,0
Marcel Artelesa,1,1,1964-10-04,0,1,0,0
Jobby Crossan,5,3,1965-05-07,5,0,0,2
Stevie Chalmers,1,1,1964-10-21,1,0,0,0
Dave Gibson,1,1,1964-10-21,1,0,0,0
Juhani Peltonen,6,6,1967-09-24,3,3,0,1
Hennie van Nee,2,2,1965-03-17,0,2,0,0
Frans Geurtsen,1,1,1964-10-25,0,1,0,0
Rudolf Brunnenmeier,3,2,1965-11-14,1,2,0,0
Giacinto Facchetti,3,3,1967-03-22,2,1,0,0
Stig Holmqvist,1,1,1964-11-04,1,0,1,0
Sandro Mazzola,14,10,1970-10-31,10,4,0,0
Erik Johansen,2,2,1965-05-27,1,1,0,0
Harald Berg,3,3,1967-09-03,2,1,0,0
Angel Rambert,1,1,1964-11-11,1,0,0,0
René-Pierre Quentin,9,8,1971-04-21,6,3,0,0
George Best,7,5,1971-04-21,5,2,0,1
Köbi Kuhn,3,3,1965-05-02,2,1,0,1
Giorgos Sideris,10,7,1969-10-15,8,2,0,1
Mogens Berg,1,1,1964-11-29,0,1,0,0
Mimis Papaioannou,12,11,1977-05-10,9,3,0,0
Oscar Black,1,1,1965-01-16,1,0,0,0
Patrick Blair,1,1,1965-01-16,1,0,0,0
Virgilio Sille,2,2,1965-01-30,0,2,0,0
Ángel Piedra,1,1,1965-01-20,1,0,0,0
Lascelles Dunkley,4,3,1968-12-01,2,2,0,0
Fevzi Zemzem,2,2,1965-10-23,1,1,0,0
Jaime Graça,3,3,1967-11-12,3,0,0,0
Antonio dos Santos,1,1,1965-02-07,1,0,0,0
Nicolás Martínez,1,1,1965-02-07,1,0,0,0
Jeff Gellineau,1,1,1965-02-07,1,0,0,0
Siegfried Haltman,3,2,1965-03-14,2,1,0,0
Alvin Corneal,3,2,1967-03-08,1,2,0,1
Andy Aleong,2,1,1965-02-07,2,0,0,0
Tarcisio Rodríguez Viquez,1,1,1965-02-12,1,0,0,0
Leonel Hernández,9,7,1968-11-27,8,1,0,2
Errol Daniels,4,3,1965-05-22,3,1,0,0
Juan González Soto,1,1,1965-02-28,0,1,0,0
Stanley Humbert Krenten,2,2,1965-03-14,2,0,0,0
José Luis González Dávila,3,3,1970-06-14,2,1,0,0
José Luis Aussin,1,1,1965-03-04,1,0,0,0
Juan Francisco Barraza,4,4,1968-12-15,4,0,0,0
Walt Schmotolocha,1,1,1965-03-07,1,0,0,0
Pedro Jirón,1,1,1965-03-11,0,1,0,0
Gerardo Barrios Morales,1,1,1965-03-11,0,1,0,0
Ramiro Navarro,1,1,1965-03-12,1,0,0,0
Sergio Méndez,3,3,1965-04-11,2,1,0,0
"Carlos Castillo, honduran footballer",1,1,1965-03-14,0,1,0,0
Jorge Liévano,1,1,1965-03-14,1,0,0,0
Kenneth Kluivert,1,1,1965-03-14,1,0,0,0
Edmund Waterval,2,1,1965-03-14,2,0,0,0
Bobby Sookram,1,1,1965-03-14,0,1,0,0
Terry Neill,1,1,1965-03-17,1,0,0,0
Mike England,3,3,1974-11-20,2,1,0,0
José Ricardo Taylor,1,1,1965-03-21,1,0,0,0
Guido Peña,4,1,1965-03-28,4,0,0,0
William Quirós,4,2,1965-05-11,4,0,0,0
Javier Valdivia,3,2,1970-06-07,2,1,0,0
Alberto López,1,1,1965-03-28,1,0,0,0
Carlos Valdez,2,2,1965-04-04,2,0,0,0
Guy Saint-Vil,9,8,1973-12-07,6,3,0,1
Virgilio Sillie,2,2,1965-04-06,0,2,0,0
Javier Fragoso,7,5,1970-06-07,5,2,0,0
Ernesto Cisneros,10,6,1965-05-16,6,4,0,0
Fernando de Paz,1,1,1965-04-04,1,0,0,0
Ricardo Clark,3,3,2009-09-09,2,1,0,0
Edgar Zúñiga,1,1,1965-04-06,1,0,0,0
Felipe Ruvalcaba,1,1,1965-04-06,0,1,0,0
Edwin Loran,1,1,1965-04-06,0,1,0,0
Hilario Bertrand,1,1,1965-04-06,1,0,1,0
Mauricio Alonso Rodríguez,3,2,1969-09-21,0,3,0,0
Joseph Obas,4,4,1969-04-20,3,1,0,0
Klaus-Dieter Sieloff,2,1,1965-04-24,2,0,0,0
Wolfgang Overath,8,5,1974-06-30,8,0,0,0
Heinz Strehl,1,1,1965-04-24,1,0,0,0
Nicolae Georgescu,2,2,1965-10-23,1,1,0,0
Viorel Mateianu,2,2,1965-05-30,2,0,0,1
Carol Creiniceanu,1,1,1965-05-02,1,0,0,0
Asher Welch,1,1,1965-05-03,1,0,0,0
Aarón Padilla Gutiérrez,2,2,1965-05-07,1,1,0,0
Syd Bartlett,1,1,1965-05-03,1,0,0,0
Ignacio Jáuregui,1,1,1965-05-03,0,1,0,0
José Ángel Iribar,1,1,1965-05-05,1,0,1,0
Robert Jashari,1,1,1965-05-07,0,1,0,0
Fernando Jiménez,1,1,1965-05-11,1,0,0,0
Víctor Zegarra,1,1,1965-05-16,1,0,0,0
Art Welch,1,1,1965-05-22,1,0,0,0
Eberhard Vogel,8,7,1975-10-12,4,4,0,1
Roman Lentner,1,1,1965-05-23,1,0,0,0
Boris Kazakov,1,1,1965-05-23,1,0,0,0
Pedro Rocha,9,8,1969-08-10,6,3,0,0
Héctor Silva,5,3,1965-06-13,4,1,0,0
Danilo Menezes,1,1,1965-05-23,1,0,0,0
Martti Hyvärinen,1,1,1965-05-27,1,0,0,0
Davie Wilson,1,1,1965-05-27,0,1,0,0
John Greig,2,2,1965-11-09,1,1,0,0
Ernest Brenner,1,1,1965-05-27,0,1,0,0
Arne Pedersen,1,1,1965-05-27,1,0,0,0
Edy Dublin,1,1,1965-05-27,0,1,0,0
Kai Sjøberg,1,1,1965-05-27,1,0,0,0
Per Kristoffersen,1,1,1965-05-27,1,0,0,0
Graham Williams,1,1,1965-05-30,1,0,1,0
Ron Davies,4,4,1971-04-21,2,2,0,1
Argenis Tortolero,1,1,1965-05-30,1,0,0,0
Rafael Santana,5,5,2000-03-11,3,2,0,0
Luis Zavalla,2,1,1965-06-02,0,2,0,0
Humberto Scovino,2,2,1967-01-28,1,1,0,0
Freddy Elie,1,1,1965-06-02,1,0,0,0
José Urruzmendi,4,3,1967-01-29,3,1,0,0
Nikola Kotkov,6,4,1968-04-06,6,0,0,1
Stoyan Kitov,1,1,1965-06-13,1,0,0,0
Jesús Peláez Miranda,1,1,1965-06-13,0,1,0,0
Sorin Avram,1,1,1965-06-14,0,1,0,0
Finn Seemann,1,1,1965-06-16,1,0,0,0
Olav Nilsen,4,4,1970-11-11,1,3,0,0
Vladimir Barkaya,2,1,1965-06-27,2,0,0,0
Washington Muñoz,5,5,1973-06-28,2,3,0,0
Vicente Rodríguez,3,3,2004-09-08,1,2,0,0
Juan Carlos Rojas,4,3,1967-02-01,1,3,0,1
Ricardo González,1,1,1965-08-01,1,0,1,0
Ermindo Onega,4,3,1966-07-19,4,0,0,0
Luis Artime,11,7,1967-01-28,9,2,0,0
Eugenio Méndez,2,1,1965-08-01,2,0,0,0
Alberto Fouilloux,3,2,1965-08-22,3,0,0,0
Hermenegildo Segrera,4,3,1969-08-24,1,3,0,0
Carlos Campos Sánchez,3,3,1966-11-30,2,1,0,0
Ignacio Prieto,4,3,1966-11-30,3,1,0,1
Raúl Bernao,4,3,1967-01-22,3,1,0,0
Rolando Vargas,1,1,1965-08-17,0,1,0,0
Ramón Quevedo,1,1,1965-08-22,1,0,0,0
Celino Mora,5,4,1967-02-01,2,3,0,0
Rubén Marcos,7,6,1967-01-26,6,1,0,1
José Ramos Delgado,1,1,1965-08-29,1,0,1,0
János Farkas,10,8,1969-06-15,8,2,0,0
Kálmán Mészöly,6,6,1967-05-10,3,3,0,4
František Knebort,4,2,1965-10-09,2,2,0,0
Dan Coe,1,1,1965-09-19,0,1,0,0
Karol Jokl,6,5,1969-12-03,3,3,0,0
Dragan Džajić,15,13,1976-06-19,8,7,0,0
Džemaludin Mušović,1,1,1965-09-19,0,1,0,0
Semi Nuoranen,1,1,1965-09-26,1,0,0,0
Werner Krämer,2,2,1965-11-14,0,2,0,0
Anatoli Banişevski,5,3,1965-10-27,0,5,0,0
Philippe Gondet,3,2,1965-11-06,3,0,0,0
Dušan Kabát,2,2,1969-05-04,0,2,0,0
Billy McNeill,2,2,1969-05-17,2,0,0,0
Jerzy Sadek,4,3,1966-10-02,3,1,0,0
Yozhef Sabo,4,3,1967-09-06,1,3,0,2
Tommy Troelsen,1,1,1965-10-17,1,0,0,0
Nedim Doğan,1,1,1965-10-23,1,0,0,0
Włodzimierz Lubański,21,10,1977-05-01,17,4,0,0
Johnny Thio,5,3,1967-11-22,4,1,0,0
Ole Fritsen,2,2,1965-12-01,1,1,0,0
Carlos Lapetra,1,1,1965-10-27,1,0,0,0
Paolo Barison,4,2,1966-07-13,3,1,0,0
Lars Granström,2,1,1965-11-07,0,2,0,0
Ove Kindvall,9,6,1973-11-11,5,4,0,1
Bo Larsson,8,5,1973-11-27,4,4,0,3
Ole Stavrum,1,1,1965-11-07,0,1,0,0
Wilfried Puis,5,4,1975-09-27,3,2,0,1
José Ufarte,1,1,1965-11-10,0,1,0,0
Osei Kofi,9,7,1972-07-02,4,5,0,1
Ben Acheampong,3,2,1965-11-19,1,2,0,0
Pierre Kalala Mukendi,3,2,1968-01-21,3,0,0,1
Cecil Jones Attuquayefio,2,1,1965-11-12,0,2,0,0
Tahar Chaïbi,3,3,1969-06-13,3,0,0,0
Mongi Delhoum,1,1,1965-11-12,1,0,0,0
Abdelwahab Lahmar,1,1,1965-11-12,1,0,0,0
Alfred Heiß,1,1,1965-11-14,0,1,0,0
Kostas Panayiotou,2,2,1968-02-17,0,2,2,0
Eustache Manglé,4,2,1968-01-16,1,3,0,0
Robert Hosp,1,1,1965-11-14,1,0,0,0
Theo Laseroms,1,1,1965-11-14,0,1,0,0
Louis Camara,2,1,1965-11-19,0,2,0,0
El Hadji Oumar Guèye,1,1,1965-11-19,0,1,0,0
Matar Niang,2,1,1965-11-19,0,2,0,0
Kwame Nti,1,1,1965-11-19,1,0,0,0
Paa Nii Lutterodt,1,1,1965-11-19,1,0,0,0
Joseph Bléziri,1,1,1965-11-19,0,1,0,0
Ivan Mráz,2,1,1965-11-21,2,0,0,0
Ayhan Elmastaşoğlu,2,2,1967-02-22,1,1,0,0
Alexander Horváth,2,2,1967-10-01,2,0,0,0
Rahamim Talbi,1,1,1965-11-21,1,0,0,0
Konan Yoboué,1,1,1965-11-21,1,0,0,0
Pak Doo-ik,2,2,1966-07-19,1,1,0,0
Pak Seung-zin,5,4,1966-07-23,3,2,0,0
Im Seung-Hwi,1,1,1965-11-21,1,0,0,0
Han Bong-Zin,2,1,1965-11-21,2,0,0,0
Les Scheinflug,2,2,1965-11-24,1,1,0,1
Ion Pârcălab,1,1,1965-11-21,1,0,0,0
Alexandru Badea,1,1,1965-11-21,1,0,0,0
Frank Odoi,3,2,1968-01-19,1,2,0,0
Mexhit Haxhiu,1,1,1965-11-24,1,0,0,0
Kim Seung-il,2,1,1965-11-24,0,2,0,0
Wyn Davies,3,3,1968-02-28,2,1,0,0
Kaj Poulsen,1,1,1965-12-01,0,1,0,0
Ronnie Rees,2,2,1968-02-28,2,0,0,0
Ezio Pascutti,1,1,1965-12-07,1,0,0,0
Ivan Vutsov,2,2,1966-07-16,1,1,2,0
Sigfried Held,2,2,1969-05-21,2,0,0,0
Franz Beckenbauer,5,4,1970-06-14,4,1,0,0
Eduard Malofeyev,6,5,1967-10-31,1,5,0,0
Anatoliy Banishevskiy,6,5,1972-05-13,4,2,0,0
Pirri,10,9,1976-10-10,8,2,0,2
Enrique Borja,2,2,1973-12-18,0,2,0,0
Gérard Hausser,1,1,1966-07-13,1,0,0,0
José Augusto de Almeida,4,3,1968-12-11,0,4,0,0
José Augusto Torres,5,5,1968-12-11,3,2,1,0
Tostão,13,6,1970-06-14,8,5,0,0
Héctor De Bourgoing,1,1,1966-07-15,1,0,0,1
Julio César Cortés,2,2,1969-08-10,1,1,0,0
Manuel Sanchís Martínez,1,1,1966-07-15,1,0,0,0
Roger Hunt,4,3,1966-10-22,3,1,0,0
António Simões,2,2,1973-10-13,1,1,0,0
Rildo da Costa Menezes,1,1,1966-07-19,1,0,0,0
Ivan Davidov,1,1,1966-07-20,0,1,1,0
Valeriy Porkujan,4,3,1966-07-25,0,4,0,0
Lothar Emmerich,1,1,1966-07-20,1,0,0,0
Geoff Hurst,13,10,1971-12-01,11,2,0,0
Li Dong-woon,1,1,1966-07-23,1,0,0,0
Yang Seung-kook,1,1,1966-07-23,1,0,0,0
Martin Peters,7,7,1971-02-03,2,5,0,0
Wolfgang Weber,1,1,1966-07-30,0,1,0,0
Miel Pijs,1,1,1966-09-07,1,0,0,0
Johan Cruyff,25,16,1977-03-26,20,5,0,0
Dezső Molnár,1,1,1966-09-07,0,1,0,0
Zoltán Varga,1,1,1966-09-21,1,0,0,0
Andrzej Jarosik,5,4,1969-11-09,4,1,0,1
Jan Liberda,1,1,1966-10-02,1,0,0,0
Ryszard Grzegorczyk,2,2,1966-10-22,1,1,0,0
Alekos Alexiadis,2,1,1966-10-16,2,0,0,0
Pertti Mäkipää,1,1,1966-10-16,0,1,0,0
Fleury Di Nallo,5,4,1968-04-24,2,3,0,0
Georges Lech,5,5,1971-11-10,3,2,0,0
Mircea Dridea,3,2,1966-12-03,1,2,0,0
Constantin Frățilă,5,2,1966-12-03,3,2,0,0
Fritz Künzli,10,9,1971-10-13,7,3,0,0
Karl Odermatt,6,6,1973-04-08,3,3,0,0
Nikola Tsanev,2,1,1966-11-13,2,0,0,0
Petar Zhekov,6,5,1971-12-04,4,2,0,0
Kjetil Hasund,2,1,1966-11-13,0,2,0,0
Inge Danielsson,3,2,1967-11-05,1,2,0,0
Terry Hennessey,1,1,1966-11-16,1,0,1,0
Jack Charlton,2,2,1967-04-15,2,0,0,0
Frank O'Neill,1,1,1966-11-16,1,0,0,0
Ogün Altıparmak,3,3,1968-10-23,1,2,0,0
Jimmy Nicholson,5,5,1971-10-13,2,3,0,0
Bobby Murdoch,3,3,1969-04-16,2,1,0,0
Bobby Lennox,2,2,1967-04-15,1,1,0,0
Nicolae Dobrin,6,6,1972-10-29,4,2,0,0
Virginio De Paoli,1,1,1966-11-26,1,0,0,0
Yves Herbet,1,1,1966-11-26,0,1,0,0
Hervé Revelli,5,3,1971-04-24,0,5,0,0
Pedro Araya,3,2,1967-01-22,3,0,0,0
Manuel Saavedra,1,1,1966-11-30,1,0,0,0
Alfonso Cañón,1,1,1966-11-30,0,1,0,0
Willy van der Kuijlen,4,2,1975-09-03,4,0,0,0
Costakis Pierides,1,1,1966-12-03,1,0,0,0
Mircea Lucescu,5,5,1975-05-11,3,2,0,1
José María García Lavilla,1,1,1966-12-07,1,0,0,0
Polo Carrera,2,2,1975-07-27,2,0,0,0
Benigno Apocada,2,2,1967-01-22,0,2,0,0
Arístides del Puerto,2,2,1967-01-25,2,0,0,0
Julio Montero Castillo,1,1,1967-01-17,1,0,0,0
Roberto Troncoso,1,1,1967-01-17,1,0,1,0
Jorge Oyarbide,4,3,1967-01-26,4,0,0,0
Oscar Mas,1,1,1967-01-18,1,0,0,0
Rafael Albrecht,3,3,1969-08-31,3,0,0,1
Julio Gallardo,3,2,1967-01-26,2,1,0,0
Juan Francisco Riveros,1,1,1967-01-22,0,1,0,0
Juan Carlos Carone,1,1,1967-01-25,1,0,0,0
Silvio Marzolini,1,1,1967-01-25,1,0,0,0
Juan Carlos Sarnari,1,1,1967-01-28,1,0,0,0
Antonio Ravelo,2,2,1967-02-01,1,1,0,0
Antonio González,1,1,1967-02-01,0,1,0,0
Ramón Colmán,1,1,1967-02-01,0,1,0,0
Manuel Recinos,3,3,1967-03-19,2,1,0,0
Raúl Arellano Gallo,3,1,1967-03-06,3,0,0,0
Manuel Lapuente,2,2,1973-12-08,2,0,0,0
Gerry Browne,2,2,1967-03-17,0,2,0,0
Joseph Pierre,1,1,1967-03-08,1,0,0,0
Rudy Sobalvarro,1,1,1967-03-08,0,1,0,0
Thomas Máximo,1,1,1967-03-08,1,0,0,0
Francisco Romero,1,1,1967-03-10,0,1,0,0
Claude Némurin,1,1,1967-03-10,1,0,0,0
Jean-Claude Désir,3,3,1973-12-01,2,1,0,0
Luis Estrada,3,2,1967-03-14,2,1,0,0
Manuel Cerda Canela,1,1,1967-03-12,1,0,0,0
Fernando Bustos,1,1,1967-03-12,1,0,0,0
Enrique Grey Fúnez,2,1,1967-03-17,2,0,0,0
Manuel Cuadra,1,1,1967-03-17,1,0,0,0
Kelvin Berassa,2,1,1967-03-17,0,2,0,0
Jesús Prado,1,1,1967-03-19,0,1,0,0
Angelo Domenghini,7,6,1970-06-03,6,1,0,0
Jan Mulder,1,1,1967-04-05,0,1,0,0
Piet Keizer,8,5,1972-11-01,6,2,0,1
Henning Frenzel,7,5,1971-04-24,5,2,0,0
Gerd Müller,39,24,1974-07-07,24,15,0,3
Hannes Löhr,3,2,1967-10-07,3,0,0,0
Jim McCalliog,1,1,1967-04-15,0,1,0,0
Florea Martinovici,1,1,1967-04-23,1,0,0,0
Emil Dumitriu,3,1,1967-04-23,3,0,0,0
Ion Ionescu,2,1,1967-04-23,2,0,0,0
Stathis Chaitas,1,1,1967-05-10,0,1,0,0
Wim Suurbier,3,3,1971-02-24,1,2,0,0
Zygfryd Szołtysik,2,2,1970-10-14,2,0,0,0
Juraj Szikora,1,1,1967-05-21,0,1,0,0
Vojtech Masný,1,1,1967-05-21,0,1,0,0
Rolf Blättler,6,4,1973-09-26,6,0,0,0
Ramón Grosso,1,1,1967-05-31,1,0,0,0
Custódio Pinto,1,1,1967-06-01,0,1,0,0
Ingvar Svensson,1,1,1967-06-01,1,0,0,0
Wolfram Löwe,7,7,1977-10-12,3,4,0,0
Kresten Bjerre,4,3,1971-05-26,4,0,0,2
Odd Iversen,6,6,1977-09-07,4,2,0,1
Anatoliy Byshovets,8,6,1971-10-13,3,5,0,0
Franz Wolny,1,1,1967-06-11,0,1,0,0
Helmut Siber,3,3,1968-05-19,2,1,0,0
Dinko Dermendzhiev,6,6,1970-06-02,4,2,0,0
Jozef Adamec,7,4,1969-12-03,6,1,0,0
Josef Jurkanin,1,1,1967-06-18,1,0,0,0
Mario Bertini,1,1,1967-06-25,0,1,0,0
Murtaz Khurtsilava,2,2,1968-05-11,2,0,0,0
Thomas Nordahl,3,2,1975-06-30,2,1,0,0
Sven Otto Birkeland,1,1,1967-09-03,1,0,0,0
Harald Sunde,2,2,1973-08-02,1,1,0,0
Valery Maslov,1,1,1967-09-06,0,1,0,0
Simo Syrjävaara,1,1,1967-09-06,1,0,0,0
Leopold Grausam,3,3,1967-10-15,2,1,0,0
Tom Søndergaard,2,2,1967-10-11,1,1,0,0
Rinus Israël,3,3,1971-11-17,2,1,0,1
Johan Devrindt,12,7,1971-05-26,8,4,0,0
Janusz Żmijewski,3,1,1967-10-08,0,3,0,0
Erik Dyreborg,1,1,1967-10-11,0,1,0,0
Gerhard Körner,1,1,1967-10-11,1,0,0,1
Herbert Pankau,2,1,1967-10-11,2,0,0,0
Dave Clements,1,1,1967-10-21,1,0,0,0
Alan Ball Jr.,1,1,1967-10-21,0,1,0,1
José Eulogio Gárate,4,3,1969-10-15,4,0,0,0
Ladislav Kuna,4,4,1971-10-27,2,2,0,0
Gigi Riva,20,11,1973-10-20,12,8,0,2
Tom Turesson,4,3,1970-10-28,3,1,0,0
Richard Dürr,1,1,1967-11-08,1,0,0,1
Vasil Mitkov,1,1,1967-11-12,1,0,0,0
Edin Sprečo,2,2,1969-06-04,1,1,0,0
Ivica Osim,3,2,1968-09-25,3,0,0,0
Vojin Lazarević,1,1,1967-11-12,1,0,0,0
John Dempsey,1,1,1967-11-22,1,0,1,0
Ray Treacy,3,3,1975-05-10,2,1,0,0
Turlough O'Connor,1,1,1967-11-22,0,1,0,1
Alan Gilzean,5,3,1969-10-22,2,3,0,0
Alan Durban,2,2,1971-10-13,1,1,0,0
Ronnie McKinnon,2,2,1971-02-03,2,0,1,0
Charly Loubet,5,3,1971-11-10,4,1,0,0
Jean Klein,1,1,1967-12-23,0,1,0,0
Jean-Louis Bozon,1,1,1968-01-12,0,1,0,0
Laurent Pokou,15,8,1973-06-03,1,14,0,0
Ignace Muwawa,1,1,1968-01-12,0,1,0,0
Nicodème Kabamba,2,1,1968-01-12,0,2,0,1
Polly Ouma,2,2,1977-02-13,1,1,0,0
Doudou Diongue,1,1,1968-01-12,0,1,0,0
Yatma Diop,2,2,1968-01-14,0,2,0,0
Hacène Lalmas,3,1,1968-01-14,3,0,0,0
Mokhtar Kalem,2,2,1972-03-02,2,0,0,0
Jean Foutika,2,2,1968-01-16,2,0,0,0
Yatma Diouck,2,2,1968-01-16,0,2,0,0
Saio Ernest Mokili,1,1,1968-01-14,1,0,0,0
Bekuretsion Gebre-Hiwot,1,1,1968-01-14,1,0,0,0
Kidumu Mantantu,3,3,1974-03-09,1,2,0,0
Elias Tshimanga,1,1,1968-01-16,1,0,0,0
Shewangizaw Agonafer,1,1,1968-01-16,1,0,0,0
Boualem Amirouche,2,2,1968-11-17,1,1,0,1
Denis Obua,3,3,1977-02-27,0,3,0,0
Léon Mungamuni,3,2,1970-02-09,1,2,0,0
Ibrahim Sunday,5,5,1972-07-02,3,2,0,0
Henri Konan,1,1,1968-01-19,0,1,0,1
Melis Asprou,1,1,1968-02-17,1,0,0,0
Pambos Papadopoulos,1,1,1968-02-17,1,0,0,0
John Hughes,1,1,1968-02-24,1,0,0,0
Dimitar Penev,2,2,1969-06-15,1,1,1,0
Pierino Prati,5,5,1971-11-20,3,2,0,0
Vahidin Musemić,6,3,1968-09-25,5,1,0,0
Ilija Petković,3,2,1974-06-18,3,0,0,0
Norman Hunter,2,2,1973-01-24,1,1,0,0
Homayoun Behzadi,4,4,1968-05-19,4,0,0,0
Ali Jabbari,5,3,1972-05-19,2,3,0,0
Hla Htay,2,2,1968-05-16,1,1,0,0
Wong Chi-keung,1,1,1968-05-11,0,1,0,0
Giora Spiegel,6,5,1969-10-01,3,3,0,0
Moshe Romano,3,2,1968-05-17,2,1,0,0
Roby Young,1,1,1968-05-12,0,1,0,0
Yuan Kuan Yick,1,1,1968-05-12,1,0,0,0
Hossein Kalani,7,5,1972-05-19,7,0,0,0
Akbar Eftekhari,2,2,1968-05-16,2,0,0,0
Gholam Hossein Farzami,1,1,1968-05-13,1,0,0,0
Ye Nyunt,1,1,1968-05-14,1,0,0,0
Li Kwok Keung,1,1,1968-05-15,1,0,0,0
Mak Tian-fu,1,1,1968-05-15,0,1,0,0
Li Huan-wen,1,1,1968-05-17,0,1,0,0
Shmuel Rosenthal,1,1,1968-05-17,1,0,0,0
Aung Khin,1,1,1968-05-18,1,0,0,0
Suk Bahadur,1,1,1968-05-18,1,0,0,0
Helmut Redl,4,3,1969-11-05,3,1,0,0
Nicos Kantzilieris,1,1,1968-05-19,0,1,0,0
Parviz Ghelichkhani,5,4,1973-08-24,5,0,0,1
Pietro Anastasi,3,3,1974-06-15,2,1,0,0
Turo Flink,1,1,1968-06-19,1,0,0,0
Odilon Polleunis,8,5,1972-06-14,7,1,0,0
Wim Jansen,1,1,1968-09-04,1,0,0,0
Wim van Hanegem,4,4,1977-08-31,4,0,0,0
Vladimír Hagara,3,3,1973-06-02,2,1,0,0
Arto Tolsa,3,3,1969-06-25,2,1,0,0
Tibor Vigh,2,2,1968-10-13,2,0,0,0
Sergio Zanatta,1,1,1968-10-06,1,0,0,0
Nick Papadakis,2,1,1968-10-06,2,0,0,0
Léon Semmeling,1,1,1968-10-09,1,0,0,0
Tommy Lindholm,2,2,1969-06-25,1,1,0,1
Johann Eigenstiller,1,1,1968-10-13,0,1,1,0
Willy Roy,3,3,1968-11-11,1,2,0,0
Ralph McPate,2,1,1968-10-13,2,0,0,0
Norman Patterson,1,1,1968-10-13,1,0,0,0
Siegfried Stritzl,1,1,1968-10-13,0,1,0,0
Eric McMordie,1,1,1968-10-23,1,0,0,0
William Campbell,1,1,1968-10-23,1,0,0,0
Luigi Riva,7,4,1969-11-22,4,3,0,0
Dietrich Albrecht,1,1,1968-10-26,1,0,0,0
Hristo Bonev,19,15,1976-10-09,10,9,0,6
Jacinto Santos,2,1,1968-10-27,2,0,0,0
Jacinto João,2,2,1970-10-14,1,1,0,0
Emment Kapengwe,3,2,1968-11-08,2,1,0,0
Babiker Santo,3,2,1968-11-08,1,2,0,0
Sandy Kaposa,1,1,1968-10-27,1,0,0,0
Dickson Makwaza,1,1,1968-10-27,1,0,0,0
Peter Millar,3,1,1968-11-02,3,0,0,0
Gerry Baker,2,1,1968-11-02,2,0,0,0
Winston Trott,1,1,1968-11-02,0,1,0,0
Clyde Best,1,1,1968-11-02,0,1,0,0
Boujemaa Benkhrif,1,1,1968-11-03,1,0,0,0
August Starek,4,4,1973-05-23,0,4,0,0
Billy Bremner,2,2,1974-11-20,2,0,0,0
Godfrey Chitalu,8,5,1980-06-01,6,2,0,0
Abdel Kafi El-Sheikh,1,1,1968-11-08,1,0,0,0
Ismaeil Bakhit,2,1,1968-11-08,2,0,0,0
Rudolph Smith,1,1,1968-11-11,0,1,1,0
Ezzedine Chakroun,4,3,1972-12-17,1,3,0,0
David Stokes,1,1,1968-11-17,1,0,0,0
Selwyn Murren,1,1,1968-11-17,1,0,1,0
Tyrone de la Bastide,1,1,1968-11-17,1,0,1,0
Nelson Melgar,3,2,1969-11-29,3,0,0,0
Guy François,3,3,1969-09-28,2,1,0,0
Florea Dumitrache,12,8,1973-10-14,6,6,0,2
Flavius Domide,1,1,1968-11-23,1,0,0,0
Paul Ruben Corte,2,1,1968-11-24,2,0,0,0
Ruud Schoonhoven,2,1,1968-11-24,2,0,0,0
Roy Vanenburg,2,1,1968-11-24,2,0,0,0
Hugues Guillaume,2,2,1968-12-08,2,0,0,0
Philippe Vorbe,1,1,1968-11-25,1,0,0,0
Warren Archibald,5,2,1973-12-14,0,5,0,0
Walford Vaughns,1,1,1968-11-27,1,0,0,0
Roy Sáenz,6,5,1971-11-27,4,2,0,0
Eduardo Chavarria,2,2,1968-12-29,2,0,0,0
Mario Vega,1,1,1968-12-01,1,0,0,0
Edgar Núñez,1,1,1968-12-01,1,0,0,0
Joel Estrada,2,1,1968-12-01,2,0,0,0
Victor Manuel Azucar,2,1,1968-12-01,2,0,0,0
Juan Ramón Martínez,7,5,1969-10-08,4,3,0,0
Wouter Brokke,1,1,1968-12-05,1,0,0,0
Antonio Martina,1,1,1968-12-05,1,0,0,0
José Urquia,1,1,1968-12-05,1,0,0,0
Donaldo Rosales,2,2,1968-12-29,1,1,0,0
Rafael Dick,1,1,1968-12-05,1,0,0,0
Evan Welsh,1,1,1968-12-05,0,1,0,0
Joseph Aghoghovbia,1,1,1968-12-07,1,0,0,0
Norbert Owona,2,2,1972-03-04,1,1,0,0
Reynold Saint Surin,1,1,1968-12-08,1,0,0,0
Marco Antonio Mendoza,1,1,1968-12-08,1,0,0,0
Reynaldo Mejia,1,1,1968-12-08,1,0,0,0
Colin Stein,6,2,1969-05-17,4,2,0,0
Giorgos Dedes,2,2,1969-04-16,2,0,0,0
Terry Harkin,2,1,1968-12-11,0,2,0,0
José Quintanilla,2,2,1969-06-27,1,1,0,0
Elcio Martina,1,1,1968-12-15,0,1,0,0
David Ayo,1,1,1968-12-22,1,0,0,0
Dieudonné Bassanguen,1,1,1968-12-22,1,0,0,0
Augustine Ofuokwu,1,1,1968-12-22,0,1,0,0
Peter Anieke,1,1,1968-12-22,0,1,0,0
Olumuyiwa Oshode,2,2,1969-05-10,1,1,0,0
Rigoberto Gómez,3,3,1971-12-04,3,0,0,0
Jules Lagadeau,2,1,1968-12-22,2,0,0,0
Stuart Oosthuizen,1,1,1968-12-22,1,0,0,0
Edwin Schal,3,3,1977-10-15,1,2,0,1
Hassan Akesbi,1,1,1969-01-05,0,1,0,0
Emile Pierre Diéme,1,1,1969-01-05,1,0,0,0
Abdoulaye Makhtar Diop,1,1,1969-01-05,1,0,0,0
Mahmoud Al-Jahani,1,1,1969-01-26,1,0,0,0
Mohamed Koussa,1,1,1969-01-26,1,0,0,0
Emmanuel Feseha,1,1,1969-02-09,1,0,0,0
Zerga Geremew,2,1,1969-02-09,2,0,0,0
Asmeron Germa,2,1,1969-02-09,2,0,0,0
Ahmed Ben Soed,1,1,1969-02-09,0,1,0,0
Driss Bamous,1,1,1969-02-13,1,0,0,0
Cherkaoui Hafnaoui,1,1,1969-02-13,1,0,0,0
Juan Manuel Asensi,5,5,1978-12-13,4,1,0,0
Édgar González,1,1,1969-02-23,1,0,0,0
Dick van Dijk,1,1,1969-03-26,1,0,0,0
Theo Pahlplatz,3,2,1971-11-17,3,0,0,0
Hans-Jürgen Kreische,9,6,1974-11-16,3,6,0,0
John Toshack,7,7,1975-04-16,3,4,0,0
Peter Rock,1,1,1969-04-16,1,0,0,0
Georges Vuilleumier,2,1,1969-04-16,0,2,0,0
Wilhelm Kreuz,5,5,1979-08-29,4,1,0,0
Panicos Efthimiadis,1,1,1969-04-19,1,0,0,0
Kazimierz Deyna,14,11,1978-06-10,9,5,0,2
Jerzy Wilim,1,1,1969-04-20,1,0,0,0
Miguel Ángel Bustillo,1,1,1969-04-30,1,0,0,0
Miroslav Pavlović,1,1,1969-04-30,0,1,0,0
Hasabu El Sagheir,1,1,1969-05-04,0,1,0,0
Kostas Eleftherakis,3,3,1974-11-20,2,1,0,0
Vasilis Botinos,3,2,1969-10-15,2,1,0,0
Fernando Peres,2,2,1971-11-21,2,0,0,1
Eamonn Rogers,2,2,1971-05-30,2,0,0,1
Sjaak Roggeveen,1,1,1969-05-07,1,0,0,0
Abekah Ankrah,1,1,1969-05-10,0,1,0,0
Sebastian Broderick Imasuen,1,1,1969-05-10,1,0,0,0
Ali Gagarin,6,4,1976-03-06,4,2,0,1
Kebede Asfaw,1,1,1969-05-11,0,1,0,0
Jagdoul,1,1,1969-05-11,1,0,0,0
Bruno Michaud,1,1,1969-05-14,0,1,1,0
Eddie Gray,1,1,1969-05-17,1,0,0,0
Willie Henderson,1,1,1969-05-17,1,0,0,0
Tommy Gemmell,1,1,1969-05-17,1,0,0,0
Sam Garba,1,1,1969-05-18,0,1,0,0
Emmanuel Ola,1,1,1969-05-18,1,0,0,0
Max Lorenz,1,1,1969-05-21,1,0,0,0
Horst-Dieter Höttges,1,1,1969-05-21,1,0,0,0
Antal Dunai,5,5,1972-10-15,2,3,0,0
Ole Sørensen,3,2,1969-06-15,3,0,0,0
Josip Bukal,4,2,1970-10-14,0,4,0,0
Denijal Pirić,1,1,1969-06-04,0,1,0,0
Leonard Wells,1,1,1969-06-08,1,0,0,0
Don Givens,12,7,1979-05-02,10,2,0,0
Moulay Khanousi,1,1,1969-06-13,0,1,0,0
Houmane Jarir,4,3,1970-06-03,2,2,0,0
Abdesselem Cheman,1,1,1969-06-13,1,0,0,0
Ulrik le Fevre,1,1,1969-06-15,1,0,0,0
Elmer Acevedo,2,2,1969-09-21,1,1,0,0
Ove Grahn,4,4,1975-06-30,3,1,0,1
Roland Grip,1,1,1969-06-19,0,1,0,0
Ola Dybwad-Olsen,4,3,1971-09-08,4,0,0,0
José Cardona,1,1,1969-06-27,1,0,0,0
Rúben Bareño,1,1,1969-07-06,0,1,0,0
Oscar Zubía,1,1,1969-07-06,0,1,0,0
Atilio Ancheta,1,1,1969-07-20,1,0,0,0
Juan Américo Díaz,1,1,1969-07-27,1,0,0,0
Aníbal Tarabini,1,1,1969-07-27,0,1,0,0
Raúl Alvarez,2,2,1969-08-10,2,0,0,0
Adolfo Olivares,2,2,1969-08-03,1,1,0,0
Francisco Valdés,3,2,1973-08-05,3,0,0,0
Ramiro Tobar,1,1,1969-07-27,1,0,1,0
Félix Lasso,2,2,1975-07-24,1,1,0,0
Jaime González,2,1,1969-07-27,2,0,0,0
Luis Mendoza Benedetto,1,1,1969-08-02,1,0,0,0
Javier Tamayo,1,1,1969-08-02,0,1,0,0
Tom Rodríguez,1,1,1969-08-03,1,0,0,0
Pablo Rojas,1,1,1969-08-06,0,1,0,0
Alcides Sosa,1,1,1969-08-06,0,1,0,0
Roberto Challe,2,2,1970-06-06,0,2,0,0
Héctor Chumpitaz,2,2,1970-06-02,1,1,1,0
Aurelio Martínez,1,1,1969-08-10,0,1,0,0
Valentín Mendoza,1,1,1969-08-17,0,1,1,0
Jairzinho,12,11,1974-06-30,9,3,0,0
Eduardo Antunes Coimbra,2,2,1969-08-21,1,1,0,0
Teófilo Cubillas,15,10,1978-06-11,6,9,0,2
Luis Cruzado,1,1,1969-08-17,1,0,0,0
Orlando Mesa,1,1,1969-08-21,0,1,0,0
Rivellino,7,7,1974-06-30,5,2,0,0
Jorge Ramírez Gallego,1,1,1969-08-21,0,1,0,0
Lorenzo Gimenez,1,1,1969-08-21,1,0,0,0
Saturnino Arrúa,4,3,1973-09-30,4,0,0,0
Oswaldo Ramírez,5,4,1975-10-22,2,3,0,1
Alberto Rendo,1,1,1969-08-31,1,0,0,0
Henk Wery,1,1,1969-09-07,0,1,0,0
Garba Okoye,4,3,1969-11-08,3,1,0,0
Nasr El-Din Abbas,2,2,1969-10-03,1,1,0,0
Jadallah Kheirelseid,1,1,1969-09-13,0,1,0,0
László Fazekas,7,6,1982-06-15,6,1,0,0
Mohammed El Filali,2,2,1969-10-26,2,0,0,0
Mohammed Lawal,2,2,1969-11-08,1,1,0,1
Ahmed Faras,12,10,1976-03-11,10,2,0,0
Claude Barthélemy,1,1,1969-09-28,0,1,0,0
Yehoshua Feigenbaum,2,1,1969-09-28,2,0,0,0
Sunday Ineh,1,1,1969-10-03,0,1,0,0
Awad Koka,1,1,1969-10-03,1,0,0,0
Samuel Opone,1,1,1969-10-03,0,1,0,0
Ahmed Bushara Wahba,2,2,1972-02-29,1,1,0,0
Tom McColl,4,4,1969-11-23,1,3,0,0
Masashi Watanabe,1,1,1969-10-10,1,0,0,0
Aritatsu Ogi,1,1,1969-10-10,0,1,1,0
Ray Baartz,5,5,1973-11-10,2,3,0,0
Josy Kirchens,1,1,1969-10-10,1,0,0,0
Bronisław Bula,2,2,1971-09-22,1,1,0,0
Kim Ki-bok,1,1,1969-10-12,1,0,0,0
Teruki Miyamoto,2,2,1969-10-16,0,2,0,0
Park Soo-Il,2,2,1969-10-20,2,0,0,0
Yasuyuki Kuwahara,1,1,1969-10-12,0,1,0,0
Johnny Watkiss,2,2,1969-12-14,1,1,0,0
Lee Yi-woo,1,1,1969-10-14,1,0,0,0
Giorgos Koudas,2,2,1973-01-17,2,0,0,0
Bent Jensen,1,1,1969-10-15,0,1,0,1
Vladimir Muntyan,3,2,1975-10-12,2,1,0,0
Givi Nodia,2,2,1969-10-22,2,0,0,0
Manuel Velázquez,2,2,1975-04-17,2,0,0,0
Joaquín Sierra,1,1,1969-10-15,1,0,0,0
Jeong Gang-Ji,2,1,1969-10-18,2,0,0,0
Rudolf Belin,1,1,1969-10-19,1,0,0,0
Metodije Spasovski,2,1,1969-10-19,2,0,0,0
Jimmy Johnstone,1,1,1969-10-22,0,1,0,0
Klaus Fichtel,1,1,1969-10-22,1,0,0,0
Reinhard Libuda,2,2,1970-06-07,1,1,0,0
Lajos Szűcs,2,2,1971-10-27,2,0,0,0
Wietse Veenstra,1,1,1969-10-22,1,0,0,0
David Powell,1,1,1969-10-22,1,0,0,0
Jean-Claude Bras,2,1,1969-11-01,2,0,0,0
Jean Djorkaeff,1,1,1969-11-01,1,0,0,1
Zoltán Halmosi,1,1,1969-11-05,1,0,0,0
Lajos Puskás,1,1,1969-11-05,1,0,0,0
Lajos Kocsis,7,7,1972-10-15,4,3,0,2
Emerich Dembrovschi,5,5,1972-10-29,3,2,0,0
Mimis Domazos,2,2,1973-01-17,1,1,0,0
Kakhi Asatiani,3,2,1970-06-06,0,3,0,0
Ender Konca,1,1,1969-11-16,1,0,0,0
Vitaliy Khmelnytskyi,2,2,1970-06-06,0,2,0,0
Álvaro Cascante,2,2,1969-11-27,2,0,0,0
Edward Dawkins,1,1,1969-11-23,1,0,1,0
Bobby Chalmers,2,2,1969-11-29,2,0,0,0
Jaime Grant,2,2,1969-11-30,2,0,0,0
Ismael Croes,1,1,1969-11-27,0,1,0,0
Tomás Gamboa,1,1,1969-11-27,1,0,0,0
Marco Fión,2,2,1969-12-02,1,1,0,0
Francisco Mancilla,1,1,1969-11-27,1,0,0,0
Alfonso Sabater,1,1,1969-11-27,1,0,0,0
Carlos Regales,2,2,1969-12-06,0,2,0,0
Daniel Salamanca,2,1,1969-11-29,2,0,0,0
Rolando Valdez,1,1,1969-11-29,1,0,0,0
Edgar Meulens,1,1,1969-11-29,1,0,1,0
Johnny Warren,1,1,1969-11-29,0,1,0,0
Phillemon Tegire,1,1,1969-11-29,0,1,1,0
Willie Rutherford,1,1,1969-11-29,0,1,0,0
Delroy Scott,1,1,1969-11-30,1,0,0,0
Joshua Hamilton,1,1,1969-11-30,1,0,0,0
Everald Cummings,3,2,1973-12-14,0,3,0,0
Keith Douglas,1,1,1969-11-30,0,1,0,0
Ulrich Haynes,2,2,1969-12-02,0,2,0,0
Melvin Loefstok,2,1,1969-12-02,2,0,0,0
Martijn,2,2,1969-12-06,1,1,0,0
František Veselý,3,3,1976-06-16,3,0,0,0
Víctor Ruiz,8,5,2001-06-20,6,2,0,2
Wálter Elizondo,1,1,1969-12-04,1,0,0,1
David Zeman,1,1,1969-12-04,1,0,1,0
Adelbert Toppenberg,3,2,1973-12-05,0,3,0,0
José Álvarez Crespo,1,1,1969-12-04,1,0,0,0
Leopoldo Barba,1,1,1969-12-04,1,0,0,0
David Largie,1,1,1969-12-06,1,0,0,0
Marco Antonio Fión,1,1,1969-12-07,0,1,0,0
Vicente Wanchope,1,1,1969-12-07,1,0,0,0
Paul Philipp,3,3,1975-10-15,2,1,0,2
Emmanuel Koum,2,1,1970-02-06,2,0,0,0
Paul-Gaston N'Dongo,5,5,1973-02-25,4,1,0,0
Omar Ali Hasab El-Rasoul,4,4,1972-02-25,4,0,0,0
Kwasi Owusu,8,5,1973-02-10,2,6,0,1
Ali Abo Greisha,7,6,1974-03-11,6,1,0,0
Soriba Soumah,4,4,1974-03-07,1,3,0,4
Taha Basry,4,4,1976-03-03,4,0,0,0
Jean-Marie Tsébo,2,2,1970-02-10,1,1,0,0
Jean Manga Onguéné,4,4,1980-10-12,2,2,0,0
François Tahi,1,1,1970-02-08,0,1,0,0
Petit Sory,3,3,1976-03-03,1,2,0,0
André Kalonzo,1,1,1970-02-09,1,0,0,0
Sayed Abdel Razek,2,2,1972-12-08,2,0,0,0
Diomandé Losseni,2,2,1970-02-14,0,2,0,0
Ousmane Thiam Tollo,2,2,1977-02-27,1,1,0,1
Malik Jabir,1,1,1970-02-14,1,0,0,0
Muhamad El-Basheer El-Asyad,2,1,1970-02-14,2,0,0,0
Ildo Maneiro,1,1,1970-06-02,0,1,0,0
Juan Mujica,1,1,1970-06-02,0,1,0,0
Wilfried Van Moer,5,4,1979-10-17,4,1,0,0
Raoul Lambert,13,11,1977-09-03,11,2,0,5
Ladislav Petráš,5,5,1976-10-13,3,2,0,0
Alexandru Neagu,3,3,1972-05-17,1,2,0,0
Asparuh Nikodimov,1,1,1970-06-07,1,0,0,0
Todor Kolev,1,1,1970-06-07,1,0,0,0
Juan Ignacio Basaguren,1,1,1970-06-07,1,0,0,0
Dobromir Zhechev,1,1,1970-06-11,1,0,0,0
Maouhoub Ghazouani,2,2,1972-12-03,0,2,0,0
Allan Clarke,3,3,1973-10-17,2,1,0,3
Gustavo Peña,1,1,1970-06-11,1,0,0,1
Alan Mullery,1,1,1970-06-14,1,0,0,0
Javier Guzmán,3,2,1977-10-22,2,1,1,0
Víctor Espárrago,1,1,1970-06-14,0,1,0,0
Clodoaldo,1,1,1970-06-17,1,0,0,0
Roberto Boninsegna,6,6,1974-11-20,2,4,0,0
Karl-Heinz Schnellinger,1,1,1970-06-17,1,0,0,0
Tarcisio Burgnich,1,1,1970-06-17,0,1,0,0
Gérson,1,1,1970-06-21,1,0,0,0
Carlos Alberto Torres,1,1,1970-06-21,1,0,0,0
Milan Albrecht,1,1,1970-10-07,1,0,0,0
Matti Paatelainen,3,3,1976-06-13,1,2,0,0
László Nagy,4,3,1977-10-29,1,3,0,0
Geir Karlsen,1,1,1970-10-07,0,1,1,0
Willie Vassallo,1,1,1970-10-11,1,0,0,0
Michalis Kritikopoulos,1,1,1970-10-11,0,1,0,0
Radu Nunweiller,2,2,1972-09-20,1,1,0,0
Robert Gadocha,7,7,1975-09-10,7,0,0,0
Tommy Carroll,1,1,1970-10-14,1,0,0,1
Dan Brzokoupil,1,1,1970-10-14,0,1,0,0
Kamuran Yavuz,1,1,1970-10-17,0,1,0,0
Giancarlo De Sisti,3,3,1971-11-20,2,1,0,1
Thomas Parits,5,3,1972-06-10,5,0,0,0
Louis Floch,1,1,1970-11-11,1,0,0,0
Michel Mézy,1,1,1970-11-11,1,0,0,0
John O'Hare,3,3,1971-11-10,3,0,0,0
Carles Rexach,2,2,1971-05-30,1,1,0,0
Luis Aragonés,1,1,1970-11-11,1,0,0,0
Tsvetan Atanasov,1,1,1970-11-15,1,0,0,0
Tor Fuglset,1,1,1970-11-15,0,1,0,0
Viktor Kolotov,8,7,1975-05-18,6,2,0,2
Gennady Yevryuzhikhin,3,2,1971-06-07,2,1,0,0
Nikos Charalambous,1,1,1970-11-15,1,0,0,0
Vitaliy Shevchenko,2,2,1971-05-30,1,1,0,0
Metin Kurt,1,1,1970-12-13,1,0,0,0
Astrit Ziu,1,1,1970-12-13,0,1,0,0
Cemil Turan,7,5,1977-11-27,5,2,0,1
Kurt Müller,3,3,1975-05-10,1,2,0,0
André De Nul,1,1,1971-02-17,1,0,0,0
Willi Lippens,1,1,1971-02-24,1,0,0,0
Jurica Jerković,2,2,1981-11-29,1,1,0,0
Martin Chivers,5,4,1971-12-01,3,2,0,0
Francis Lee,3,3,1972-04-29,3,0,0,0
Pat Stanton,1,1,1971-04-21,1,0,1,0
Roland Citherlet,1,1,1971-04-21,1,0,0,0
Ján Čapkovič,4,3,1971-11-14,0,4,0,0
Vladimír Táborský,1,1,1971-04-21,0,1,0,0
Gilbert Dussier,5,4,1975-10-19,3,2,0,1
Horst Köppel,1,1,1971-04-25,0,1,0,0
José Luis Violeta,1,1,1971-05-09,0,1,0,0
Zoran Filipović,2,2,1977-11-13,0,2,0,0
Jimmy Conway,1,1,1971-05-10,1,0,0,0
Jan Banaś,1,1,1971-05-12,0,1,0,0
Medin Zhega,1,1,1971-05-12,1,0,0,0
Chris Lawler,1,1,1971-05-12,1,0,0,0
Rui Rodrigues,3,3,1975-11-19,2,1,0,0
Vítor Baptista,2,1,1971-05-12,2,0,0,0
Erik Sandvad,1,1,1971-05-12,1,0,1,0
Bozhil Kolev,5,5,1975-04-27,4,1,0,1
Petko Petkov,1,1,1971-05-19,1,0,0,0
Stefan Velichkov,1,1,1971-05-19,1,0,0,0
Jan Olsson,1,1,1971-05-26,1,0,0,0
Johann Schmidradner,1,1,1971-05-30,0,1,0,1
Karl Kodat,1,1,1971-05-30,0,1,0,0
Tony Dunne,2,2,1974-11-20,1,1,2,0
Vladimir Fedotov,3,2,1972-10-18,2,1,0,0
Stefanis Michael,2,2,1976-05-23,1,1,0,0
Finn Laudrup,2,2,1972-10-18,2,0,0,0
Mladen Vasilev,1,1,1971-06-09,0,1,0,0
Günter Netzer,2,2,1972-04-29,1,1,0,1
Jürgen Grabowski,3,3,1974-06-30,2,1,0,0
Jaroslav Pollák,1,1,1971-06-16,0,1,0,0
František Karkó,2,1,1971-06-16,0,2,0,0
Kostas Davourlis,1,1,1971-06-18,1,0,0,0
Kostas Aidiniou,1,1,1971-06-18,1,0,0,0
Josef Stering,3,2,1977-04-30,3,0,0,0
Jacques Vergnes,1,1,1971-09-08,0,1,0,0
Bernard Blanchet,2,2,1971-12-04,0,2,0,0
Anghel Iordănescu,7,7,1980-10-15,4,3,0,2
Nicolae Lupescu,2,2,1971-11-24,1,1,0,0
Nihat Yayöz,1,1,1971-09-22,0,1,0,0
Volodymyr Muntyan,1,1,1971-09-22,1,0,0,0
Péter Juhász,1,1,1971-09-25,1,0,0,0
Csaba Vidáts,2,2,1973-06-13,2,0,0,0
Jacky Novi,1,1,1971-10-09,0,1,1,0
Kurt Jara,10,9,1981-05-28,6,4,0,0
Hans Pirkner,2,2,1977-04-30,2,0,0,1
Barry Hulshoff,3,3,1973-09-12,2,1,0,0
Archie Gemmill,6,5,1980-03-26,4,2,0,3
Daniel Jeandupeux,1,1,1971-10-13,1,0,0,0
Anton Weibel,1,1,1971-10-13,0,1,1,0
Gil Reece,2,2,1975-05-01,1,1,0,0
Mike Summerbee,1,1,1971-11-10,1,0,0,0
Ilir Përnaska,3,2,1980-10-19,2,1,0,0
Oeki Hoekema,1,1,1971-11-17,1,0,0,0
Alfonso Estupiñán,1,1,1971-11-20,0,1,0,0
Robert Sara,1,1,1971-11-20,0,1,0,0
Anthony Douglas,2,2,1971-12-05,2,0,0,0
Miguel Ángel Matamoros,1,1,1971-11-21,0,1,0,1
Francisco Piedra,1,1,1971-11-23,1,0,0,0
Andrés Roldán,1,1,1971-11-23,1,0,0,0
José Verdecia,1,1,1971-11-23,1,0,0,0
Jorge Brand,1,1,1971-11-23,0,1,0,0
Quino Sierra,2,1,1971-11-24,2,0,0,0
Francisco Javier Aguilar García,1,1,1971-11-24,1,0,0,0
Enrique Lora,1,1,1971-11-24,1,0,0,0
José Francisco Rojo,2,2,1972-02-16,1,1,0,0
José Alfredo Jiménez,1,1,1971-11-26,0,1,0,0
Roberto Rodríguez,3,3,1971-12-02,0,3,0,2
Hernán Morales,1,1,1971-11-27,1,0,0,0
Oscar Hernandez,1,1,1971-11-27,0,1,0,0
Wilfred Cave,2,2,1971-11-30,2,0,0,0
Pierre Bayonne,4,3,1977-10-12,1,3,0,0
Emmanuel Sanon,10,8,1977-10-16,6,4,0,0
Leintz Domingue,3,3,1977-10-23,1,2,0,1
Ramon Moraldo,1,1,1971-11-28,0,1,1,0
Claude Barthelemy,1,1,1971-11-28,0,1,0,0
Clibert Lennard,1,1,1971-11-30,1,0,0,0
José Luis Elejalde,1,1,1971-11-30,0,1,0,0
Dagoberto Lara,1,1,1971-11-30,0,1,0,0
Arnulfo Echeverría,1,1,1971-12-01,0,1,0,0
Jean-Claude Desir,1,1,1971-12-01,1,0,0,0
Atanas Mihaylov,2,2,1972-11-19,1,1,0,0
Octavio Muciño,6,2,1973-12-08,4,2,0,0
Emilio Valle,1,1,1971-12-05,0,1,0,0
Aubert Philips,1,1,1971-12-05,1,0,0,0
Steve David,8,6,1973-12-17,1,7,0,0
Sammy Morgan,3,3,1975-10-29,3,0,0,0
Jean-Baptiste N'Doga,2,2,1972-03-04,2,0,0,0
Jonathan Niva,1,1,1972-02-23,0,1,0,0
Bakary Traoré,1,1,1972-02-24,1,0,0,0
Edmond Apéti Kaolo,3,2,1972-02-28,0,3,0,1
Fantamady Keita,5,4,1972-03-02,3,2,0,0
Bako Touré,2,2,1972-03-02,2,0,0,0
Covi Adé,1,1,1972-02-24,0,1,0,0
Paul Moukila,2,2,1974-03-03,2,0,0,0
Mayanga Maku,7,6,1974-03-07,0,7,0,0
Joseph Yegba Maya,1,1,1972-02-26,1,0,0,0
Simo Emmanuel Mvé,1,1,1972-02-26,1,0,0,0
Daniel Arudhi Nicodémus,1,1,1972-02-26,1,0,0,0
Jean Kalala N'Tumba,7,5,1973-08-19,3,4,0,0
Bushara Abdel-Nadief,1,1,1972-02-27,0,1,0,0
François N'Doumbé,1,1,1972-02-28,1,0,0,0
Peter Ouma,2,2,1973-08-19,2,0,0,0
Jean-Michel M'Bono,6,4,1974-03-05,5,1,0,0
François M'Pelé,3,3,1974-03-09,3,0,0,0
Kamal Abdel Wahab,1,1,1972-02-29,0,1,0,0
Jonas Bahamboula,2,2,1977-02-13,1,1,0,0
Noël Birindi Minga,2,2,1974-03-05,1,1,0,0
Adama Traoré,5,4,2021-10-07,5,0,0,0
Kakoko Etepé,7,7,1974-03-07,3,4,0,0
Gary Ngassebe,1,1,1972-03-02,0,1,0,0
Jean-Paul Akono,1,1,1972-03-04,1,0,0,1
Philippe Michel Mouthé,1,1,1972-03-04,1,0,0,0
Moussa Diakhité,1,1,1972-03-05,0,1,0,0
Moussa Traoré,2,2,1996-01-25,0,2,0,0
Maxime Camara,1,1,1972-03-12,1,0,0,0
Rabah Gamouh,2,2,1980-12-28,0,2,0,0
Chérif Souleymane,4,4,1977-02-13,3,1,0,0
Smith Samuel,1,1,1972-03-12,1,0,0,0
Humberto Coelho,3,2,1980-12-17,3,0,0,0
Nené,12,11,1984-06-20,6,6,0,0
Artur Jorge,1,1,1972-03-29,1,0,0,0
Rui Jordão,11,10,1984-11-14,7,4,0,1
Uli Hoeneß,3,3,1976-05-22,2,1,0,1
László Branikovits,2,2,1975-04-16,2,0,0,0
Lajos Sătmăreanu,1,1,1972-04-29,0,1,0,0
Josef Hickersberger,3,1,1972-04-30,3,0,0,0
Norbert Hof,1,1,1972-04-30,1,0,0,0
István Juhász,1,1,1972-05-06,1,0,0,0
Safar Iranpak,2,2,1972-05-16,2,0,0,0
Jawad Khalaf,1,1,1972-05-08,0,1,0,0
Fayez Marzouq,1,1,1972-05-08,0,1,0,0
Park Su-deok,1,1,1972-05-10,0,1,0,0
Lee Hoi-taek,1,1,1972-05-10,0,1,0,0
Cha Bum-kun,8,8,1977-11-05,4,4,0,1
Park Lee-chun,4,4,1972-05-19,1,3,0,1
Doeur Sokhom,3,3,1972-05-16,2,1,0,0
Chico Faria,1,1,1972-05-10,0,1,0,0
Ammo Yousif,1,1,1972-05-11,0,1,0,0
Supakit Meelarpkit,2,2,1973-05-16,1,1,1,0
Mohammad Sultan,1,1,1972-05-12,0,1,0,0
Ibrahim Al Duraihem,3,3,1977-03-17,0,3,0,1
Eduard Kozynkevych,1,1,1972-05-13,1,0,0,0
Prapon Tantariyanond,3,2,1972-05-17,3,0,0,0
Sok Sun Hean,1,1,1972-05-14,1,0,0,0
Tes Sean,1,1,1972-05-14,1,0,0,0
Sea Cheng Eang,1,1,1972-05-14,1,0,0,0
István Szőke,2,2,1972-05-17,1,1,0,0
Einar Gunnarsson,1,1,1972-05-18,1,0,1,0
Ich Narding,2,1,1972-05-19,2,0,0,0
Tol Kimchi,2,1,1972-05-19,0,2,0,0
Frans Janssens,1,1,1972-05-22,1,0,0,0
Jean Dockx,1,1,1972-05-22,1,0,0,0
Joseph Mapulanga,3,3,1974-03-09,2,1,0,0
Ramoseli Thietsi,1,1,1972-06-04,0,1,0,0
Freddie Mwila,3,1,1972-06-04,3,0,0,0
Peter Pumm,1,1,1972-06-10,1,0,0,0
Anatoliy Konkov,3,3,1977-04-24,2,1,0,0
Lajos Kű,1,1,1972-06-17,0,1,0,1
Joseph Ghartey,1,1,1972-06-18,0,1,0,0
Abukari Gariba,2,1,1972-06-18,0,2,0,0
Herbert Wimmer,2,2,1974-11-20,1,1,0,0
Kembo Uba Kembo,6,4,1973-12-09,6,0,0,0
Miikka Toivola,2,2,1979-10-17,1,1,0,0
Clifford Odame,1,1,1972-07-02,1,0,0,1
Damien Kamilou,1,1,1972-07-02,0,1,0,0
Daniel Anyanzwa,1,1,1972-07-16,1,0,0,0
William Ouma,6,4,1973-08-19,4,2,0,0
Ezzeldin Osman,1,1,1972-07-23,1,0,0,0
Jan Fuglset,1,1,1972-08-03,1,0,0,1
Tom Lund,8,7,1982-10-13,6,2,0,0
Harry Hestad,2,2,1973-09-12,2,0,0,0
Tor Egil Johansen,3,2,1973-08-02,1,2,0,0
Örn Óskarsson,1,1,1972-08-03,0,1,0,0
Kenneth Olayombo,2,2,1973-02-10,2,0,0,0
Yakubu Mambo,2,2,1973-02-10,2,0,0,0
Sunday Oyarekhua,1,1,1972-08-15,0,1,0,0
Noël Minga,1,1,1972-08-15,1,0,0,0
Olavi Rissanen,3,2,1976-09-22,3,0,0,0
Léon Dolmans,2,2,1973-10-31,1,1,0,2
Jürgen Sparwasser,7,6,1977-10-29,4,3,0,0
Joachim Streich,25,19,1983-11-16,16,9,0,2
Giorgio Chinaglia,2,2,1975-06-05,0,2,0,1
Fabio Capello,3,3,1975-11-22,1,2,0,0
Georges Bereta,1,1,1972-10-13,1,0,0,0
Franz Hasil,1,1,1972-10-15,1,0,0,1
Mama Ouattara,2,2,1972-10-29,1,1,0,0
Ralf Edström,9,6,1975-06-04,7,2,0,0
Roland Sandberg,8,7,1975-08-13,4,4,0,0
Dag Szepanski,1,1,1972-10-15,1,0,0,1
Lou Macari,1,1,1972-10-18,0,1,0,0
Jimmy Bone,1,1,1972-10-18,0,1,0,0
Joe Harper,2,2,1975-09-03,0,2,0,0
Willie Morgan,1,1,1972-10-18,0,1,0,0
Terry Conroy,2,2,1972-11-15,2,0,0,0
Dušan Bajević,6,3,1974-06-18,3,3,0,0
Nico Braun,5,5,1979-10-23,4,1,0,1
Noël Kouamé,2,2,1973-02-11,1,1,0,0
Johan Neeskens,12,9,1976-04-25,7,5,0,5
Theo de Jong,2,2,1974-06-23,1,1,0,0
Willy Brokamp,5,3,1973-08-29,5,0,0,0
Jean-Michel Larqué,1,1,1972-11-15,0,1,0,0
Kenny Dalglish,14,12,1984-11-14,8,6,0,0
Peter Lorimer,2,2,1974-06-14,1,1,0,0
Colin Bell,3,2,1974-10-30,2,1,0,0
Jovan Aćimović,1,1,1972-11-18,1,0,0,0
Georgi Denev,6,5,1975-06-11,5,1,0,0
Helmut Köglberger,2,2,1975-03-16,0,2,0,0
Charles Spiteri,1,1,1972-11-25,0,1,1,0
Tekeste Gebremedhin,1,1,1972-11-25,0,1,0,0
Nassoro Mashoto,1,1,1972-11-25,1,0,0,0
Louis Gomis Diop,1,1,1972-12-03,1,0,0,0
Moustapha Choukri,3,3,1973-06-03,1,2,0,0
Ali Khalil,3,3,1974-03-06,3,0,0,0
Tariku Ingdawerk,3,2,1973-04-15,2,1,0,0
Seyoum Tesfaye,2,2,1976-02-29,2,0,0,0
Daniel Imbert,4,4,1974-03-07,2,2,0,0
John Shore,1,1,1972-12-10,0,1,0,0
Osman Arpacıoğlu,2,1,1972-12-10,2,0,0,0
Köksal Mesçi,1,1,1972-12-10,1,0,0,1
Anwar Jackaria,1,1,1972-12-17,0,1,0,0
Mohieddine Habita,2,2,1973-02-11,2,0,0,1
Rubén Óscar Valdez,2,1,1973-01-17,0,2,0,0
José Claramunt,3,3,1974-09-25,1,2,0,1
Kokos Antoniou,1,1,1973-02-14,1,0,0,0
Erroll Bennett,5,5,1980-03-01,0,5,0,0
Alexis Tumahai,1,1,1973-02-17,0,1,0,0
Roger Mandin,1,1,1973-02-17,1,0,0,0
Brian Turner,11,7,1981-12-19,5,6,0,1
Dave Taylor,3,3,1977-03-20,3,0,0,0
Geoff Brand,1,1,1973-02-17,1,0,0,0
Malcolm Bland,2,2,1973-02-23,2,0,0,0
Alan Vest,4,4,1973-03-16,2,2,0,0
Terio Vakatawa,1,1,1973-02-17,0,1,0,0
Jean Hmae,2,1,1973-02-18,2,0,0,0
Segin Wayewol,3,2,1973-02-20,1,2,0,0
Pierre Wacapo,1,1,1973-02-18,1,0,0,0
Michael Dupuy,1,1,1973-02-18,0,1,0,0
Alick Saurei,1,1,1973-02-21,0,1,0,0
Jacky Valette,1,1,1973-02-21,0,1,0,0
Josateki Kurivitu,1,1,1973-02-21,1,0,0,0
Alan Marley,3,3,1973-02-24,3,0,0,0
Colin Latimour,1,1,1973-02-21,1,0,0,0
Jean Xowie,3,3,1980-03-01,2,1,0,0
Antonis Antoniadis,4,4,1975-06-04,2,2,0,1
Juan Cruz Sol,1,1,1973-02-21,1,0,0,0
Roberto Juan Martínez,2,2,1974-09-25,1,1,0,0
Claude Carrara,1,1,1973-02-23,0,1,0,0
Harold Ng Fok,1,1,1973-02-23,0,1,0,0
Gilles Malinowski,1,1,1973-02-23,0,1,0,0
Roland de Marigny,1,1,1973-02-23,0,1,0,0
Brian Hardman,1,1,1973-02-23,1,0,0,0
Raymond Valette,1,1,1973-02-23,0,1,0,0
Gerald Delmas,1,1,1973-02-24,1,0,0,0
Charles Galinie,1,1,1973-02-24,0,1,0,0
Abdesselam Adhouma,1,1,1973-02-25,0,1,0,0
Bernard N'Guessan,2,1,1973-02-25,2,0,0,1
Kamunda Tshinabu,1,1,1973-02-27,1,0,0,1
Ernie Campbell,2,2,1973-03-13,1,1,0,0
Ray Richards,2,2,1973-03-24,2,0,0,0
Adrian Alston,4,3,1973-08-18,4,0,0,0
Riyadh Nouri,2,2,1973-03-21,1,1,0,0
Sarman Panggabean,2,2,1973-03-21,1,1,0,0
Iswadi Idris,3,3,1977-03-09,0,3,0,0
Bashar Rashid,1,1,1973-03-13,1,0,0,0
Sabah Hatim,4,2,1973-03-24,4,0,0,0
Doug Utjesenovic,1,1,1973-03-16,1,0,0,0
Branko Buljevic,2,2,1973-11-10,1,1,0,0
Dennis Tindall,1,1,1973-03-16,0,1,0,0
Bobby Hogg,1,1,1973-03-16,0,1,1,0
Ali Kadhim,2,2,1973-03-24,2,0,0,0
Maurice Tillotson,1,1,1973-03-18,1,0,1,0
Douglas Aziz,1,1,1973-03-21,1,0,0,1
Salah Obeid,1,1,1973-03-21,1,0,0,0
Anjas Asmara,2,2,1977-03-09,0,2,0,0
Jimmy Mackay,3,2,1973-11-13,3,0,0,0
Attila Abonyi,6,5,1977-10-30,4,2,0,1
Martin O'Neill,5,5,1984-09-12,4,1,0,0
Leighton James,7,4,1980-10-15,5,2,0,2
Trevor Hockey,1,1,1973-03-28,1,0,0,0
Burton Mugala,1,1,1973-04-15,1,0,0,0
Boniface Simutowe,1,1,1973-04-15,1,0,0,1
Moses Simwala,3,3,1973-10-21,2,1,0,0
Kassahun Teka,1,1,1973-04-15,0,1,0,1
Sándor Zámbó,2,2,1973-06-13,2,0,0,0
László Bálint,5,5,1981-10-31,3,2,1,0
Hugo Sotil,4,3,1977-03-26,3,1,0,0
Ole Bjørnmose,1,1,1973-05-02,1,0,0,0
Joseph Chahrestan,3,3,1973-05-11,2,1,0,0
Nabil Nano,1,1,1973-05-04,1,0,0,0
Ion Dumitru,2,2,1973-10-14,1,1,0,0
Teodor Țarălungă,1,1,1973-05-06,0,1,0,0
Sabah Bizi,1,1,1973-05-06,1,0,0,0
Gholam Vafakhah,1,1,1973-05-06,1,0,0,0
Ali Parvin,3,3,1977-01-28,2,1,0,0
Fathi Kameel,7,6,1981-12-14,3,4,0,0
Kim Jong-Min,1,1,1973-05-06,1,0,0,0
Akbar Kargarjam,1,1,1973-05-08,1,0,0,0
Trevor Anderson,3,2,1978-10-25,3,0,0,0
Mehdi Monajati,1,1,1973-05-11,1,0,0,0
Pak Sung-Jin,1,1,1973-05-11,0,1,0,0
Mohammad Sadeghi,1,1,1973-05-11,1,0,0,0
Samir Said,2,2,2001-05-07,2,0,0,0
Julio Crisosto,2,2,1975-07-17,2,0,0,0
Sergio Ahumada,4,4,1977-03-06,4,0,0,0
Ali Djabari,1,1,1973-05-13,1,0,0,0
An Se-Uk,1,1,1973-05-13,1,0,0,0
Ma Jung-U,2,1,1973-05-13,2,0,0,0
Volodymyr Onyshchenko,2,2,1973-05-26,2,0,0,0
Abdulghani Tatiche,1,1,1973-05-15,0,1,0,0
Hamad Khalid Bo Hamad,4,3,1977-10-02,0,4,0,0
Moshe Onana,5,4,1973-05-26,5,0,0,0
Shusaku Hirasawa,1,1,1973-05-16,0,1,0,0
Lo Hung-Hoi,1,1,1973-05-17,1,0,0,0
Serge Chiesa,1,1,1973-05-19,1,0,0,0
Mick Martin,4,4,1982-11-17,2,2,1,0
Zvi Farkash,1,1,1973-05-19,1,0,0,0
Itzhak Shum,2,2,1973-05-21,2,0,0,0
Kim Jae-han,5,4,1977-12-04,5,0,0,0
Chung Kyu-Poong,3,2,1973-05-26,3,0,0,0
Hassan Amcharrat,3,3,1978-03-09,1,2,0,0
Kobenan Kouman,7,6,1980-03-15,6,1,0,0
Kunishige Kamamoto,2,1,1973-05-20,0,2,0,0
Koji Mori,1,1,1973-05-20,0,1,0,0
Nguyễn Vinh Quang,1,1,1973-05-20,0,1,1,0
George Borba,1,1,1973-05-21,1,0,0,0
Zvi Rozen,2,1,1973-05-21,2,0,0,0
Kwok Ka-ming,4,4,1977-12-04,1,3,0,0
Shaharuddin Abdullah,1,1,1973-05-23,0,1,0,0
Harun Jusoh,1,1,1973-05-23,0,1,0,0
Yuen Kuen-Chu,2,2,1973-05-26,1,1,0,0
Oleg Blokhin,14,13,1986-10-29,10,4,0,0
Park Yi-Chun,1,1,1973-05-26,1,0,0,0
Zdeněk Nehoda,16,14,1981-05-27,11,5,0,1
Bohumil Veselý,3,1,1973-06-02,3,0,0,0
Přemysl Bičovský,5,4,1983-03-27,3,2,0,0
Chérif Fetoui,2,2,1976-03-01,2,0,0,0
Jarmo Manninen,1,1,1973-06-06,1,0,0,0
Mihály Kozma,1,1,1973-06-13,1,0,0,0
Willington Ortiz,7,7,1985-11-03,3,4,0,0
Ítalo Estupiñán,1,1,1973-07-01,1,0,0,0
Fernando Morena,6,5,1983-09-04,5,1,0,3
Denís Milar,2,2,1979-09-26,2,0,0,1
Per Pettersen,1,1,1973-08-02,0,1,0,0
Héctor Bailetti,1,1,1973-08-05,0,1,0,0
Rogelio Farias,1,1,1973-08-05,1,0,0,0
Akuetteh Armah,1,1,1973-08-05,1,0,0,1
Bernard Chanda,7,5,1977-02-27,4,3,0,0
Brighton Sinyangwe,4,3,1974-03-12,3,1,0,0
Peter Wilson,3,2,2021-11-16,3,0,0,0
Joseph Sam,1,1,1973-08-19,0,1,0,0
Mavuba Mafuila,1,1,1973-08-19,1,0,0,1
Simon Kaushi,3,3,1974-03-12,0,3,0,0
Arie Haan,3,3,1978-06-21,1,2,0,0
Elmar Geirsson,1,1,1973-08-29,0,1,0,0
René van de Kerkhof,4,4,1978-06-18,2,2,0,0
Dick Schneider,1,1,1973-08-29,1,0,0,1
Raúl Morales,1,1,1973-09-02,1,0,0,0
Adalberto Escobar,2,2,1973-10-07,0,2,0,0
Jorge Insfran,2,2,1973-09-30,1,1,0,0
Miguel Ángel Brindisi,3,2,1974-06-30,3,0,0,0
Rubén Ayala,6,4,1974-06-23,5,1,0,1
Oscar Fornari,1,1,1973-09-23,0,1,0,0
Bernd Bransch,2,1,1973-09-26,2,0,0,0
Grzegorz Lato,19,16,1982-06-22,9,10,0,0
Jan Domarski,2,2,1973-10-17,1,1,0,0
Jim Holton,1,1,1973-09-26,1,0,0,0
Joe Jordan,9,9,1982-06-22,4,5,0,0
Pedro Alcides Bareiro,1,1,1973-09-30,1,0,0,0
Juvencio Osorio,2,2,1979-09-13,2,0,0,0
Carlos Guerini,1,1,1973-10-07,1,0,0,0
Ramazan Rragami,1,1,1973-10-10,1,0,0,1
Alfredo Quaresma,1,1,1973-10-13,1,0,0,0
Dumitru Marcu,2,1,1973-10-14,2,0,0,0
Mircea Sandu,2,1,1973-10-14,2,0,0,0
Nicolae Pantea,1,1,1973-10-14,1,0,0,0
Dudu Georgescu,9,7,1979-04-04,8,1,0,2
Ko Jae-wook,1,1,1973-11-10,1,0,0,0
Anton Camilleri,1,1,1973-11-11,1,0,0,0
Mihal Gjika,1,1,1973-11-13,1,0,0,0
Liam O'Kane,1,1,1973-11-14,0,1,0,0
Obby Kapita,4,4,1978-03-05,0,4,0,0
Mehmet Türkkan,1,1,1973-11-18,1,0,0,0
Melih Atacan,1,1,1973-11-18,1,0,0,0
Mohamed Maghfour,1,1,1973-11-25,1,0,0,0
Roland Hattenberger,2,2,1977-10-12,1,1,0,0
Rubén Guifarro,3,3,1973-12-12,3,0,0,0
Óscar Rolando Hernández,1,1,1973-11-29,1,0,0,0
Horacio López Salgado,3,2,1973-12-08,2,1,0,0
Roger Saint-Vil,1,1,1973-12-04,1,0,0,0
René Morales,1,1,1973-12-05,1,0,0,0
Siegfried Schoop,1,1,1973-12-05,0,1,0,0
Héctor Pulido,1,1,1973-12-08,1,0,0,0
Mbungu Ekofa,2,2,1976-03-01,1,1,0,0
Roberto Soza,1,1,1973-12-12,1,0,0,0
Rignald Alfonso Clemencia,1,1,1973-12-12,0,1,0,0
Erroll Maximino St. Jago,1,1,1973-12-12,0,1,0,0
Benjamín Monterroso,1,1,1973-12-13,0,1,0,0
Jorge Alberto Bran Guevara,1,1,1973-12-15,0,1,0,0
Juan Banegas,1,1,1973-12-15,1,0,0,0
Siegfried Brunken,1,1,1973-12-17,0,1,1,0
Stanislav Karasi,4,3,1974-06-30,0,4,0,0
Josip Katalinski,8,7,1976-06-19,6,2,1,1
Ivica Šurjak,8,8,1981-11-29,2,6,0,1
Stanley Mubiru,3,2,1974-03-04,0,3,0,0
Sebastien Lakou,1,1,1974-03-03,1,0,0,0
Ndaye Mulamba,10,6,1976-03-06,4,6,0,0
Bengally Sylla,3,3,1976-03-05,2,1,0,1
Gamal Abdel Azim,1,1,1974-03-04,1,0,0,0
Morciré Sylla,3,2,1976-03-11,2,1,0,0
Jacques Ndomba,1,1,1974-03-07,1,0,0,0
André Mbouta,1,1,1974-03-09,1,0,0,0
Mwepu Ilunga,1,1,1974-03-09,1,0,1,0
Moustafa Abdou,6,5,1977-11-25,6,0,0,0
Hassan Shehata,4,3,1980-03-12,3,1,0,0
Colin Curran,1,1,1974-06-14,1,0,1,0
Paul Breitner,7,6,1982-07-11,6,1,0,2
Romeo Benetti,3,3,1978-06-06,1,2,0,0
Andrzej Szarmach,13,10,1982-07-10,7,6,0,0
Ramón Heredia,1,1,1974-06-15,0,1,0,0
Carlos Babington,1,1,1974-06-15,0,1,0,0
Johnny Rep,11,9,1980-06-14,3,8,0,1
Martin Hoffmann,11,7,1979-10-13,8,3,0,0
Bernhard Cullmann,3,3,1974-12-22,1,2,0,0
Vladislav Bogićević,2,2,1975-06-09,1,1,0,0
Branko Oblak,3,3,1975-11-19,3,0,0,0
René Houseman,4,4,1978-06-21,4,0,0,0
Roberto Perfumo,1,1,1974-06-19,0,1,1,0
Ricardo Pavoni,1,1,1974-06-19,0,1,0,0
Jerzy Gorgoń,1,1,1974-06-19,0,1,0,0
Valdomiro Vaz Franco,1,1,1974-06-22,0,1,0,0
Héctor Yazalde,2,1,1974-06-23,2,0,0,0
Ruud Krol,4,4,1978-09-20,4,0,1,0
Rob Rensenbrink,11,7,1978-09-20,6,5,0,5
Rainer Bonhof,2,2,1980-02-27,2,0,0,1
Conny Torstensson,2,2,1975-09-03,1,1,0,0
Timo Rahja,2,2,1974-09-25,2,0,0,0
Arfon Griffiths,4,4,1975-11-19,3,1,0,0
Johann Krankl,5,4,1975-10-15,3,2,0,2
Tommy Finney,1,1,1974-09-04,0,1,0,0
Jacques Teugels,1,1,1974-09-08,0,1,0,1
Kristen Nygaard,2,2,1977-09-21,1,1,0,2
Henryk Kasperczak,1,1,1974-10-09,1,0,0,0
Maurice Martens,2,2,1977-09-03,2,0,0,0
Christian Coste,1,1,1974-10-12,0,1,0,0
François Van der Elst,10,8,1983-03-30,5,5,0,0
Matthías Hallgrímsson,1,1,1974-10-12,0,1,0,0
Lakis Glezos,1,1,1974-10-13,0,1,0,0
József Horváth,1,1,1974-10-13,0,1,0,0
Mick Channon,6,5,1977-03-30,3,3,0,1
Chris Nicholl,2,2,1979-05-02,1,1,0,0
Momčilo Vukotić,2,2,1976-04-24,2,0,0,0
Jean-Marc Guillou,3,2,1975-09-03,3,0,0,0
Jean Gallice,1,1,1974-11-16,1,0,0,0
Georgios Delikaris,4,3,1978-10-11,3,1,0,0
Quini,3,2,1980-06-15,0,3,0,0
Phil Roberts,1,1,1974-11-20,1,0,0,0
Terry Yorath,1,1,1974-11-20,1,0,0,0
Hans-Peter Schild,1,1,1974-12-01,0,1,0,0
İsmail Arca,2,2,1975-04-30,2,0,1,0
Mehmet Oğuz,1,1,1974-12-01,1,0,0,0
Stavros Sarafis,1,1,1974-12-18,1,0,0,0
Alfredo Megido,1,1,1975-02-05,1,0,0,0
Richard Aquilina,1,1,1975-02-23,1,0,0,0
Vincent Magro,1,1,1975-02-23,1,0,0,0
Malcolm Macdonald,5,1,1975-04-16,5,0,0,0
John Mahoney,1,1,1975-04-16,0,1,0,0
Bryan Hamilton,2,2,1975-10-29,2,0,0,0
Zoltan Crişan,4,3,1975-12-17,2,2,0,0
Antonín Panenka,11,9,1982-06-24,9,2,0,5
Marián Masný,7,5,1979-11-24,3,4,0,0
Manfred Ritschel,1,1,1975-04-27,0,1,0,1
Alpaslan Eratlı,1,1,1975-04-30,0,1,0,0
Kevin Keegan,13,10,1981-06-06,6,7,0,1
Cornel Dinu,1,1,1975-05-11,1,0,0,0
Peter Dahl,1,1,1975-05-11,0,1,0,0
Eoin Hand,1,1,1975-05-18,0,1,0,0
Rudi Elsener,1,1,1975-05-21,1,0,0,0
Gordon McQueen,3,3,1979-06-07,0,3,0,0
Thomas Mavros,7,5,1981-11-29,6,1,0,2
Kostas Iosifidis,1,1,1975-06-04,1,0,0,0
Zvonko Ivezić,1,1,1975-06-04,0,1,0,0
Jóhannes Eðvaldsson,1,1,1975-06-05,1,0,0,0
Ásgeir Sigurvinsson,4,3,1981-10-14,1,3,0,0
Jürgen Pommerenke,1,1,1975-06-05,0,1,0,0
Mário Moínhos,1,1,1975-06-08,0,1,0,0
Ivan Buljan,2,2,1980-09-10,0,2,0,0
Stein Thunberg,1,1,1975-06-09,1,0,0,0
Borislav Dimitrov,1,1,1975-06-11,1,0,0,0
Pavel Panov,5,5,1978-10-11,3,2,0,0
Kiril Milanov,1,1,1975-06-11,1,0,0,0
Erik Just Olsen,1,1,1975-06-30,0,1,0,1
Percy Rojas,3,3,1977-07-17,2,1,0,0
Miguel Ángel Gamboa,3,3,1977-02-27,1,2,0,0
Ovidio Mezza,4,3,1977-03-06,2,2,0,1
Ernesto Díaz,5,5,1979-08-15,4,1,0,0
Hugo Kiesse,2,1,1975-07-24,0,2,0,0
Gonzalo Castañeda,2,2,1975-08-10,1,1,0,0
Eduardo Retat,1,1,1975-07-27,0,1,0,0
Ponciano Castro,2,2,1975-10-16,1,1,0,0
Romeu Evangelista,1,1,1975-07-31,0,1,0,0
Danival,3,3,1975-08-16,1,2,0,0
Palhinha,9,7,1993-09-05,5,4,0,0
Leopoldo Luque,8,5,1978-06-21,5,3,0,0
Ramón Iriarte,1,1,1975-08-03,1,0,0,0
Mario Kempes,9,5,1978-06-25,8,1,0,0
Osvaldo Ardiles,3,3,1982-06-18,2,1,0,0
Julio Asad,1,1,1975-08-06,0,1,0,0
Nelinho,5,4,1978-06-24,5,0,0,1
Oswaldo Calero,1,1,1975-08-07,1,0,0,0
César Cueto,3,3,1985-06-16,3,0,0,0
Juan Carlos Oblitas,8,7,1985-06-23,7,1,0,0
Daniel Killer,3,1,1975-08-10,3,0,0,0
Américo Gallego,1,1,1975-08-10,1,0,0,0
Mario Zanabria,2,1,1975-08-10,2,0,0,0
Ramón Bóveda,1,1,1975-08-10,1,0,0,0
Carlos Báez,1,1,1975-08-10,1,0,0,0
Clemente Rolón,2,1,1975-08-10,2,0,0,0
Roberto Batata,3,2,1975-09-30,3,0,0,0
Cosme da Silva Campos,2,2,1975-10-04,1,1,0,0
Luis Araneda,2,1,1975-08-13,2,0,0,0
Thomas Sjöberg,7,7,1978-06-03,2,5,0,0
Carlos Reinoso,1,1,1975-08-20,0,1,0,0
Marc Berdoll,3,3,1978-09-01,3,0,0,0
Harry Lubse,1,1,1975-09-03,1,0,0,0
Allan Hunter,1,1,1975-09-03,1,0,0,0
Edgar Angulo,1,1,1975-09-21,1,0,0,0
Tibor Nyilasi,20,13,1985-04-03,17,3,0,0
László Pusztai,3,3,1979-05-19,2,1,0,0
Reinhard Häfner,3,3,1981-04-04,0,3,0,0
Enrique Casaretto,2,1,1975-09-30,0,2,0,0
Julio Meléndez,1,1,1975-10-04,0,1,1,0
Jupp Heynckes,4,3,1976-02-28,4,0,0,0
Dominique Bathenay,2,2,1976-11-17,1,1,0,0
José Luis Capón,1,1,1975-10-12,1,0,0,0
Kurt Welzl,7,6,1981-06-17,4,3,0,0
Herbert Prohaska,7,6,1984-05-02,5,2,0,2
Ruud Geels,10,7,1981-10-14,6,4,0,2
Frans Thijssen,3,3,1981-09-09,2,1,0,0
Franjo Vladić,1,1,1975-10-15,1,0,0,0
Drago Vabec,1,1,1975-10-15,1,0,0,0
Sándor Pintér,2,2,1977-10-29,2,0,0,0
Tibor Wollek,1,1,1975-10-19,1,0,0,0
Béla Várady,4,4,1978-10-28,3,1,0,0
Sammy McIlroy,3,3,1980-10-15,3,0,0,0
Lars Bastrup,4,3,1981-06-03,1,3,0,0
Bruce Rioch,2,2,1975-12-17,2,0,0,0
Ted MacDougall,1,1,1975-10-29,1,0,0,0
Dušan Galis,1,1,1975-10-30,1,0,0,0
Anton Ondruš,3,2,1976-06-16,1,2,1,0
Vladimir Onishchenko,2,1,1975-11-12,2,0,0,0
Peter Risi,2,2,1977-06-08,0,2,0,0
Vladimir Veremeyev,1,1,1975-11-12,1,0,0,0
Ángel María Villar,2,2,1979-12-09,0,2,0,0
Santillana,13,9,1984-06-17,8,5,0,0
Stefan Reshko,1,1,1975-11-23,1,0,1,0
João Resende Alves,2,2,1979-05-09,1,1,0,0
Yordan Yordanov,1,1,1975-12-21,0,1,0,0
Ronald Worm,2,1,1976-02-28,2,0,0,0
Erich Beer,3,2,1976-04-24,2,1,0,1
Berti Vogts,2,2,1978-06-21,2,0,1,0
Bernd Hölzenbein,3,3,1978-06-21,1,2,0,0
Solomon Sheferahu,2,2,1976-03-03,2,0,0,0
Ahmed Abouali,1,1,1976-03-01,1,0,0,0
Baba Otu Mohammed,3,2,1976-03-11,2,1,0,0
Sam Ojebode,3,3,1977-07-10,2,1,0,2
Kabasu Babo,1,1,1976-03-01,0,1,0,0
Thompson Usiyan,5,4,1977-07-10,5,0,0,0
Mamadou Aliou Keita,5,4,1976-10-31,2,3,0,0
Abdelâali Zahraoui,2,2,1976-03-09,1,1,0,0
Mohamed Ali,1,1,1976-03-05,1,0,0,0
Jimmy Muguwa,1,1,1976-03-05,0,1,0,0
Abdellah Tazi,1,1,1976-03-06,1,0,0,0
Larbi Chebbak,1,1,1976-03-06,1,0,0,0
Boukari Adamou,1,1,1976-03-07,0,1,0,0
Kama Dumbuya,2,1,1976-03-07,2,0,0,0
Wasieu Sounmonu,2,1,1976-03-07,2,0,0,0
Samuel Tray,1,1,1976-03-07,1,0,0,0
Ahmed Abou Rehab,1,1,1976-03-09,1,0,0,0
Mudashiru Lawal,3,3,1980-12-06,1,2,0,0
Papa Camara,4,4,1977-02-27,4,0,0,0
Ghanem Sultan,1,1,1976-03-11,0,1,1,0
Mohamed El-Seyagui,1,1,1976-03-11,1,0,0,0
Redouane Guezzar,1,1,1976-03-11,1,0,0,0
Joseph Kaboré,2,2,1976-09-04,2,0,0,0
Gagny Coulibaly,1,1,1976-03-13,0,1,0,1
Mahmoud El Khatib,8,5,1980-03-19,5,3,0,0
Haruna Ilerika,2,1,1976-03-14,0,2,0,0
Ossama Khalil,2,2,1977-02-27,2,0,0,0
Ahmed Makrouh,1,1,1976-03-14,0,1,0,0
Sanda Seydou,1,1,1976-03-21,1,0,0,0
William Sango,1,1,1976-03-21,0,1,0,0
Moussa Kanfideni,2,2,1980-07-27,1,1,0,0
Kouligo Zoma,1,1,1976-03-28,0,1,0,0
Joseph Ouattara,1,1,1976-03-28,0,1,0,0
Omar Betrouni,1,1,1976-04-01,1,0,0,0
Jozef Móder,3,2,1976-05-22,1,2,0,0
Danilo Popivoda,2,2,1976-06-17,2,0,0,0
Wim Rijsbergen,1,1,1976-04-25,1,0,0,0
Willie Phiri,2,1,1976-05-09,2,0,0,0
Jack Chamangwana,1,1,1976-05-09,1,0,1,0
Roger Van Gool,2,2,1976-11-10,2,0,0,0
Klaus Toppmöller,1,1,1976-05-22,1,0,0,0
Leonid Buryak,2,2,1977-05-18,2,0,0,0
Ian Evans,2,2,1976-11-17,2,0,1,0
Allan Simonsen,9,9,1983-11-16,6,3,0,3
Niels Tune-Hansen,1,1,1976-05-23,0,1,0,0
Ole Rasmussen,1,1,1976-05-23,0,1,0,0
Abdulaziz Al-Anberi,13,11,1985-04-05,9,4,0,0
Faisal Al-Dakhil,20,16,1985-04-26,16,4,0,1
Nasser Nouraei,3,2,1976-06-08,3,0,0,0
Hassan Rowshan,8,7,1980-09-22,5,3,0,0
Mokhtar Dahari,1,1,1976-06-05,0,1,0,0
Wang Jilian,1,1,1976-06-05,1,0,0,0
Kadhim Waal,1,1,1976-06-06,1,0,0,0
Alireza Azizi,2,1,1976-06-08,2,0,0,0
Alireza Khorshidi,2,2,1976-06-11,2,0,0,0
Gholam Hossein Mazloumi,5,2,1977-01-07,3,2,0,0
Faruq Ibrahim,1,1,1976-06-11,0,1,0,0
Sabah Abdul-Jalil,1,1,1976-06-11,1,0,0,0
Falah Hassan,1,1,1976-06-11,1,0,0,0
He Jia,1,1,1976-06-13,1,0,0,0
Stuart Pearson,1,1,1976-06-13,0,1,0,0
Björn Andersson,1,1,1976-06-16,1,0,0,0
Heinz Flohe,3,2,1978-06-06,2,1,0,0
Dieter Müller,6,4,1978-06-18,2,4,0,0
Willy van de Kerkhof,6,6,1980-06-14,0,6,0,0
Ján Švehlík,1,1,1976-06-20,1,0,0,0
Karol Dobiaš,1,1,1976-06-20,1,0,0,0
Gaston Bawa,1,1,1976-09-04,0,1,0,0
Aki Heiskanen,3,3,1978-10-11,1,2,0,0
Esa Heiskanen,2,1,1976-09-22,2,0,0,0
Gilbert Zender,1,1,1976-09-22,0,1,0,0
Teppo Heikkinen,1,1,1976-09-22,1,0,0,0
Ari Mäkynen,1,1,1976-09-22,1,0,0,1
Lucien Kouassi Kouame,1,1,1976-09-26,1,0,0,0
Michel Platini,27,21,1986-06-21,17,10,0,3
Bernard Lacombe,6,5,1981-12-05,3,3,0,0
Zoltán Kereki,2,2,1977-04-30,1,1,0,0
Bo Börjesson,3,3,1981-06-24,2,1,0,0
Serge Trinchero,1,1,1976-10-09,1,0,0,1
Youssuf Camara,1,1,1976-10-10,0,1,0,0
Ibrahim Kassum,1,1,1976-10-10,1,0,0,0
Opoku Afriyie,4,3,1978-03-16,4,0,0,0
Dennis Tueart,1,1,1976-10-13,1,0,0,0
Jyrki Nieminen,2,2,1978-05-24,1,1,0,0
Joe Royle,1,1,1976-10-13,1,0,0,0
Chris McGrath,3,3,1977-11-16,2,1,0,0
Derek Spence,2,2,1978-10-25,1,1,0,0
Francesco Graziani,8,7,1982-06-23,6,2,0,0
Roberto Bettega,13,9,1981-10-17,6,7,0,0
Giancarlo Antognoni,3,3,1980-12-06,1,2,0,0
Roger Milla,20,16,1994-06-28,15,5,0,1
Joseph Mounoundzi,1,1,1976-10-17,1,0,0,1
Joseph Wamba,1,1,1976-10-17,1,0,0,0
Alirou Rachidou,1,1,1976-10-17,1,0,0,0
Benny Nielsen,3,3,1978-10-11,3,0,0,1
Henning Munk Jensen,2,1,1976-10-27,2,0,0,1
Per Røntved,4,4,1981-06-03,4,0,0,2
Jørgen Kristensen,1,1,1976-10-27,1,0,0,0
Segun Odegbami,10,7,1980-03-22,8,2,0,0
Alloysius Atuegbu,2,1,1976-10-30,2,0,0,0
Kelechi Emeteole,1,1,1976-10-30,1,0,0,0
Ismael Dyfan,2,2,1980-05-31,1,1,0,0
Kunle Awesu,1,1,1976-10-30,1,0,0,0
Mohammed Sama,1,1,1976-10-30,0,1,0,1
Daniel Ebomoa,1,1,1976-10-31,0,1,0,0
Jean-Jacques N'Domba,2,2,1977-02-13,0,2,0,0
Emmanuel Ofei Ansah,1,1,1976-10-31,0,1,0,0
Zbigniew Boniek,14,11,1985-05-30,9,5,0,0
Stanisław Terlecki,4,3,1979-09-12,1,3,0,0
Anani Afanou,1,1,1976-10-31,0,1,0,0
Abdoulaye Ba,1,1,1976-10-31,1,0,0,0
Mehmet Özgül,1,1,1976-10-31,1,0,0,0
Samir Sultan Al Fahad,1,1,1976-11-12,1,0,0,0
Saoud Al Gassem Mohammed Bo Saeed,1,1,1976-11-12,1,0,0,0
Tekalinge Kassahun,1,1,1976-11-14,1,0,0,0
Peter Kotte,1,1,1976-11-17,1,0,0,1
Manuel Fernandes,8,7,2010-09-03,5,3,0,0
Abdul Hamid Al Katbi,1,1,1976-11-26,1,0,0,0
Mohammed Abdul Ghani,1,1,1976-11-26,0,1,0,0
Marwan Khalifa Khouri,1,1,1976-11-26,1,0,0,0
Fernando Chalana,2,2,1977-11-16,1,1,0,0
Stavros Stylianou,1,1,1976-12-05,1,0,0,1
Hans Krankl,19,13,1982-06-21,14,5,0,2
Abdelghani Lakhal,1,1,1976-12-12,1,0,0,0
Tarak Dhiab,2,2,1989-01-22,1,1,0,0
Khemais Labidi,2,2,1977-12-11,2,0,0,0
Mustapha Tahir,2,2,1980-03-09,0,2,0,0
Seydouba Sylla,1,1,1977-01-16,1,0,0,0
Mohamed Akid,3,3,1977-12-11,2,1,0,0
Ali Kaabi,3,3,1978-06-02,1,2,0,0
Washington Oliveira,1,1,1977-02-09,0,1,0,0
Vicente Flores,1,1,1977-02-09,1,0,0,0
Leon Goua G'Bize,2,2,1977-02-27,1,1,0,0
Jérôme Lèbre Mamahou,3,2,1977-07-25,3,0,0,0
Ousmane Badara Bangoura,1,1,1977-02-13,0,1,0,0
José Fabián Paz y Miño,1,1,1977-02-20,1,0,0,0
Carlos Jara Saguier,2,2,1977-03-06,1,1,0,0
Porfirio Jiménez,3,3,1977-03-13,2,1,0,0
Pierre Lingongo,1,1,1977-02-27,1,0,0,0
Pascal Miézan,2,2,1984-03-07,1,1,0,0
Tabania Ametepé,1,1,1977-02-27,0,1,0,0
Quah Kim Song,2,2,1977-03-02,2,0,0,0
Suriamurthy Rajagopal,1,1,1977-02-27,1,0,0,0
Abdulla Nasur,2,2,1978-03-14,0,2,0,0
Alex Chola,2,2,1980-06-01,2,0,0,0
Mahmoud Guendouz,1,1,1977-02-28,1,0,0,0
Amor Jebali,1,1,1977-02-28,0,1,0,0
Waskito Kaihun,1,1,1977-02-28,0,1,0,0
Chung Chor Wai,4,4,1977-10-30,3,1,0,1
Wun Chee Keung,3,2,1977-03-02,1,2,0,0
Lau Wing Yip,9,6,1985-05-04,5,4,0,0
James Wong,4,1,1977-03-01,4,0,0,0
Isa Bakar,2,1,1977-03-01,2,0,0,0
Jesdaporn Na Phatalung,3,2,1977-03-07,1,2,0,1
Witthaya Laohakul,2,2,1977-03-05,1,1,0,0
Niwat Srisawat,2,2,1977-03-07,1,1,0,0
Dollah Kassim,1,1,1977-03-02,1,0,0,0
Juan José Muñante,1,1,1977-03-06,0,1,0,0
Oded Machnes,2,2,1977-03-10,2,0,0,0
Haim Bar,1,1,1977-03-06,1,0,0,0
Eduardo Vilarete,1,1,1977-03-06,0,1,0,0
Mat Noh,1,1,1977-03-06,1,0,0,0
Miguel Aguilar,4,3,1981-02-15,1,3,0,0
Rafael Iriarte,1,1,1977-03-06,1,0,0,0
Cherdsak Chaiyabutr,1,1,1977-03-07,1,0,0,0
Risdianto,1,1,1977-03-07,0,1,0,0
Junaedi Abdillah,1,1,1977-03-07,0,1,0,0
Fung Chi Ming,1,1,1977-03-08,0,1,0,0
Bakri Ibni,1,1,1977-03-08,1,0,0,0
Roberto Dinamite,11,8,1983-09-01,8,3,0,2
Zico,18,12,1985-06-16,15,3,0,5
Marinho Chagas,2,1,1977-03-09,2,0,0,0
Roberto Rivellino,1,1,1977-03-09,1,0,0,0
Ronny Pattinasarany,1,1,1977-03-09,0,1,0,0
Andi Lala,1,1,1977-03-09,0,1,0,0
Itzhak Peretz,1,1,1977-03-10,1,0,0,0
Fat'hi Kameel Fayaz Matar Marzouq,3,3,1977-11-12,1,2,0,0
Jasem Yaqoub,11,10,1981-10-10,6,5,0,3
José Velásquez,5,4,1985-06-30,3,2,0,0
Alejandro Luces,1,1,1977-03-12,1,0,0,0
Jimmy Rooney,3,2,1977-10-16,3,0,0,0
Carlos Aragonés,8,6,1981-03-22,7,1,0,3
José Domingo Insfrán,1,1,1977-03-13,0,1,1,0
Mansour Muftah,12,10,1989-10-28,11,1,0,0
Hassan Myuter Saied Al Suwaidi,1,1,1977-03-13,1,0,0,0
Chang Kuo Chi,2,2,1981-06-06,1,1,0,0
John Kosmina,13,9,1985-11-03,11,2,0,1
Fuad Abou Shaqr,2,2,1977-03-19,1,1,0,0
Nitder Pizzani,2,1,1977-03-17,2,0,0,0
Ebrahim Zowayed,1,1,1977-03-19,0,1,0,0
Ibrahim Al Farhan,1,1,1977-03-19,0,1,0,1
Carlos José Báez,1,1,1977-03-20,0,1,0,0
Elías Figueroa,2,1,1977-03-20,2,0,0,0
Osvaldo Castro,1,1,1977-03-20,1,0,0,0
Keith Nelson,7,4,1977-03-30,6,1,0,0
Clive Campbell,1,1,1977-03-20,1,0,0,0
Kevin Weymouth,1,1,1977-03-20,1,0,0,0
Uri Malmilian,3,2,1985-09-03,2,1,0,0
Park Sang-in,3,3,1977-12-04,3,0,0,0
Choi Jong-duk,3,3,1981-04-24,2,1,0,0
Abdullah Yousuf Ma'yoof,1,1,1977-03-21,0,1,0,0
Farouk Ibrahim Al Awadi Al Saleh,1,1,1977-03-21,0,1,0,0
Anbar Bashir Abubakr,1,1,1977-03-21,1,0,0,1
Steve Sumner,17,8,1985-10-05,14,3,0,1
Lo Chih Tsong,1,1,1977-03-23,1,0,1,0
Peter Ollerton,6,3,1977-10-30,2,4,0,0
Dario Pereyra,2,1,1977-03-27,2,0,0,0
Trevor Francis,8,6,1983-04-27,4,4,0,0
Ray Kennedy,2,2,1977-10-12,1,1,0,0
Liam Brady,5,4,1986-09-10,4,1,0,2
Nick Deacy,2,2,1978-11-29,2,0,0,0
Gregorio Benito,1,1,1977-04-16,1,0,1,0
Walter Schachner,18,15,1985-05-07,11,7,0,0
Mohsin Yousifi,1,1,1977-04-22,1,0,0,0
Habib Shareefi,1,1,1977-04-22,1,0,0,0
David Kipiani,2,2,1977-04-30,1,1,0,0
Takis Antoniou,1,1,1977-05-15,1,0,0,0
Włodzimierz Mazur,2,2,1979-05-02,1,1,0,1
Andrey Zhelyazkov,3,3,1980-10-19,3,0,0,0
Ismael Sylla,1,1,1977-06-05,1,0,0,0
Claudio Gentile,1,1,1977-06-08,0,1,0,0
Ingi Björn Albertsson,1,1,1977-06-11,1,0,0,0
Hossein Kazerani,2,2,1977-11-18,1,1,0,0
Ghafour Jahani,5,4,1977-11-25,4,1,0,0
Néjib Liman,2,2,1980-06-29,2,0,0,0
Ali Sylla,1,1,1977-06-19,0,1,0,0
Témime Lahzami,3,3,1980-06-29,3,0,0,0
Moncef Khouini,1,1,1977-06-19,1,0,0,0
Murray Barnes,2,2,1981-07-26,1,1,0,0
Godwin Iwelumo,2,2,1977-10-21,1,1,0,0
Gilberto Alves,2,2,1977-07-14,1,1,0,0
Toninho Cerezo,1,1,1977-07-14,1,0,0,0
Marcelo Oliveira,1,1,1977-07-14,1,0,0,0
Farouk Gaafar,2,2,1977-11-25,2,0,0,1
Maher Hammam,2,2,1980-03-08,2,0,0,0
Adokiye Amiesimaka,2,2,1978-03-05,1,1,0,0
Gilbert Van Binst,1,1,1977-09-03,1,0,0,0
Paul Courant,1,1,1977-09-03,1,0,0,0
Rune Ottesen,1,1,1977-09-07,1,0,0,0
Bohdan Masztaler,1,1,1977-09-21,1,0,0,0
Asa Hartford,1,1,1977-09-21,1,0,0,0
Miroslav Gajdůšek,2,2,1979-05-01,0,2,0,0
Luis Ramírez Zapata,4,3,1985-02-27,1,3,0,0
Brian Budd,1,1,1977-10-08,1,0,0,0
Felix McDonald,2,1,1977-10-08,2,0,0,0
Delano Rigters,1,1,1977-10-08,0,1,0,0
Mario René Alfaro,2,2,1977-10-16,1,1,0,0
Christian Chukwu,2,2,1978-03-05,2,0,0,0
Johnny N'Wadioha,1,1,1977-10-08,1,0,0,0
Octávio Machado,1,1,1977-10-09,0,1,0,0
Allan Hansen,2,2,1982-09-22,2,0,0,1
Hugo Sánchez,11,9,1993-06-30,8,3,0,1
Víctor Rangel,7,4,1978-06-10,7,0,0,0
Arsène Auguste,1,1,1977-10-09,0,1,0,0
Buzz Parsons,3,3,1977-10-22,2,1,0,0
Remie Olmberg,2,2,1977-10-20,0,2,0,2
Mike Bakic,2,2,1977-10-20,2,0,0,0
José Emilio Mitrovich,2,2,1977-10-19,1,1,0,0
Paul Mariner,7,7,1983-11-16,4,3,0,0
Javier Cárdenas,2,2,1977-10-19,2,0,0,0
Norberto Huezo,3,3,1981-11-19,2,1,0,1
Don Masson,1,1,1977-10-12,0,1,0,1
Kai Haaskivi,2,2,1979-10-31,0,2,0,0
Renato Zaccarelli,2,2,1978-06-02,1,1,0,0
Raul Isiordia,2,1,1977-10-15,2,0,0,0
Alfred Jiménez,2,1,1977-10-15,2,0,0,0
Rafael Chávez,1,1,1977-10-15,1,0,0,0
Bob Lenarduzzi,1,1,1977-10-16,1,0,0,0
Arturo Vázquez Ayala,2,2,1978-06-02,2,0,0,2
Guy Dorsainville,1,1,1977-10-20,0,1,0,0
Mágico González,7,6,1993-05-02,5,2,0,0
Errol Emanuelson,1,1,1977-10-20,0,1,0,0
Elmer Rosas,3,2,1977-10-23,3,0,0,0
Mokhtar Mokhtar,2,2,1980-03-08,2,0,0,0
Sergio Rivera,2,1,1977-10-23,0,2,0,0
Eugenio Leal,1,1,1977-10-26,1,0,0,0
Rubén Cano,3,3,1978-12-13,2,1,0,0
Hartmut Schade,2,2,1977-11-16,1,1,0,0
Gerd Weber,4,3,1979-10-13,2,2,0,1
András Törőcsik,3,3,1983-12-03,1,2,0,0
Sándor Zombori,2,2,1978-06-10,1,1,0,0
Tang Hung Cheong,1,1,1977-10-30,1,0,0,0
Colin Bennett,1,1,1977-10-30,0,1,0,0
Claudio Sulser,5,4,1982-11-17,5,0,0,0
Badr Abdul Hameed Bo Abbas,1,1,1977-11-05,1,0,0,0
Lee Young-Moo,2,1,1977-11-11,0,2,0,0
Godwin Odiye,1,1,1977-11-12,0,1,1,0
Iosif Vigu,1,1,1977-11-13,1,0,0,0
Safet Sušić,9,6,1990-06-19,5,4,0,0
Dražen Mužinić,1,1,1977-11-13,0,1,0,0
László Bölöni,6,6,1987-03-25,5,1,0,0
Aleksandar Trifunović,1,1,1977-11-13,0,1,0,0
Trevor Brooking,4,3,1981-06-06,1,3,0,0
Dominique Rocheteau,10,7,1986-06-09,9,1,0,0
Chavdar Tsvetkov,5,4,1981-05-13,4,1,0,0
Christian Dalger,1,1,1977-11-16,1,0,0,0
Gerry Armstrong,11,10,1984-11-14,7,4,0,1
Seninho,1,1,1977-11-16,1,0,0,0
Francisco Vital,1,1,1977-11-16,1,0,0,0
Volkan Yayim,1,1,1977-11-16,1,0,0,0
Abderraouf Ben Aziza,4,3,1978-03-09,3,1,0,0
Sedat Özden,4,3,1979-10-28,1,3,0,0
István Halász,1,1,1977-11-30,0,1,0,0
Windsor del Llano,1,1,1977-11-30,0,1,1,0
Franco Causio,2,2,1978-06-24,1,1,0,0
Behtash Fariba,8,5,1980-09-29,2,6,0,0
Habib Khabiri,1,1,1977-12-03,0,1,0,0
Kim Ho-Kon,1,1,1977-12-04,1,0,0,0
Huh Jung-Moo,6,5,1986-06-10,5,1,0,0
Chan Fat Chi,1,1,1977-12-04,0,1,0,0
Ahmed Abdel Baki,1,1,1977-12-11,0,1,0,0
Karim Abdul Razak,2,2,1978-03-14,2,0,0,0
Hubert Hien,1,1,1978-03-05,0,1,0,0
Mamadaou Koïta,1,1,1978-03-05,0,1,0,0
Phillip Omondi,3,3,1978-03-14,0,3,0,0
Edward Semwanga,1,1,1978-03-06,0,1,0,0
Jacques Mamounoubala,1,1,1978-03-06,1,0,0,0
Godfrey Kisitu,2,2,1978-03-11,0,2,0,0
Patrick Phiri,1,1,1978-03-08,0,1,0,0
Bizwell Phiri,2,2,1980-11-30,1,1,0,0
Willie Klutse,2,2,1980-03-13,2,0,0,0
Mohsen Labidi,1,1,1978-03-09,1,0,0,0
Samuel Musenze,1,1,1978-03-09,0,1,0,0
George Alhassan,7,5,1985-04-21,3,4,0,0
Mohammed Ahmed,1,1,1978-03-10,1,0,0,0
Moses Msereko,1,1,1978-03-11,0,1,0,0
Martins Eyo,1,1,1978-03-14,1,0,0,0
Frank Stapleton,15,14,1987-09-09,10,5,0,1
Tony Grealish,6,6,1985-06-02,5,1,0,0
Henning Jensen,2,2,1978-10-25,1,1,0,0
Gerry Daly,8,7,1983-11-16,6,2,0,1
Søren Lerby,8,8,1986-06-08,5,3,0,1
Atik Ismail,4,3,1979-07-04,4,0,0,0
Károly Csapó,1,1,1978-06-02,0,1,0,0
Daniel Bertoni,4,4,1982-06-23,4,0,0,0
Paolo Rossi,10,7,1983-12-22,5,5,0,1
Néjib Ghommidh,1,1,1978-06-02,0,1,0,0
Mokhtar Dhouieb,1,1,1978-06-02,0,1,0,0
Daniel Ruiz,4,3,1980-06-18,1,3,0,1
José Reinaldo de Lima,2,2,1981-02-22,1,1,0,0
Daniel Passarella,6,6,1985-05-26,4,2,0,2
Hansi Müller,1,1,1978-06-06,1,0,0,0
Karl-Heinz Rummenigge,32,21,1986-06-29,25,7,0,3
András Tóth,1,1,1978-06-06,1,0,0,1
Andranik Eskandarian,1,1,1978-06-07,0,1,1,0
Iraj Danaeifard,2,2,1980-09-24,2,0,0,0
Christian Lopez,1,1,1978-06-10,1,0,0,0
Ernie Brandts,5,4,1978-10-11,2,3,1,0
Erich Obermayer,1,1,1978-06-14,1,0,0,0
Dirceu,3,2,1978-06-24,3,0,0,0
Rüdiger Abramczik,1,1,1978-06-18,1,0,0,0
Alberto Tarantini,1,1,1978-06-21,1,0,0,0
Dick Nanninga,4,3,1981-02-22,1,3,0,0
Bruno Pezzey,5,5,1982-11-17,4,1,0,0
Mats Nordgren,1,1,1978-09-01,0,1,0,0
Didier Six,7,7,1982-06-24,5,2,0,0
Anders Grönhagen,3,3,1979-10-23,1,2,0,0
Marek Kusto,1,1,1978-09-06,0,1,0,0
Andy Gray,2,2,1980-03-26,1,1,0,0
Arne Larsen Økland,4,4,1982-10-27,1,3,0,0
Julien Cools,2,2,1980-06-15,2,0,0,0
Frank Arnesen,10,8,1984-06-19,7,3,0,4
Bob Latchford,4,3,1979-02-07,2,2,0,0
Phil Neal,2,2,1982-12-15,1,1,0,0
Seppo Pyykkö,1,1,1978-09-20,1,0,0,0
László Tieber,1,1,1978-09-20,0,1,0,0
Yuri Chesnokov,2,2,1979-05-19,2,0,0,0
Volodymyr Bezsonov,2,2,1980-10-15,2,0,0,0
Werner Peter,1,1,1978-10-04,1,0,0,0
Pétur Pétursson,5,4,1989-09-20,3,2,0,1
Hans-Jürgen Riediger,1,1,1978-10-04,1,0,0,0
Hasse Borg,3,3,1981-06-03,3,0,0,3
Juanito,3,3,2006-06-23,1,2,0,1
Vahid Halilhodžić,4,3,1981-11-21,4,0,0,0
Marius Trésor,2,2,1982-07-08,0,2,0,0
Romain Michaux,1,1,1978-10-07,1,0,0,0
Albert Gemmrich,1,1,1978-10-07,0,1,0,0
Ivan Iliev,1,1,1978-10-11,0,1,0,0
Takis Nikoloudis,3,2,1979-09-12,3,0,0,0
Maik Galakos,3,2,1978-10-28,3,0,0,0
László Szokolai,2,2,1985-04-03,2,0,0,0
Eurico Gomes,1,1,1978-10-11,1,0,0,0
Franky Vercauteren,9,9,1987-04-01,4,5,0,0
Piet Wildschut,1,1,1978-10-11,0,1,0,0
Markus Tanner,2,2,1980-11-19,2,0,1,0
Vladimir Petrović,5,5,1982-06-24,1,4,0,2
Ştefan Sameş,2,1,1978-10-25,2,0,0,0
Damir Desnica,1,1,1978-10-25,0,1,0,0
Einar Jan Aas,1,1,1978-10-25,0,1,0,0
Peter O'Sullivan,1,1,1978-10-25,1,0,0,0
Ian Edwards,4,1,1978-10-25,4,0,0,0
Mickey Thomas,2,2,1984-11-14,2,0,0,0
Brian Flynn,5,5,1982-12-15,2,3,0,1
Christos Ardizoglou,1,1,1978-10-28,1,0,0,0
Alberto Fonseca,2,2,1978-11-29,1,1,0,0
Gerd Kische,1,1,1978-11-15,1,0,0,0
Roman Ogaza,3,2,1979-10-10,3,0,0,1
Billy Caskey,1,1,1978-11-29,0,1,0,0
Vicente del Bosque,1,1,1978-12-13,1,0,0,0
David Watson,3,3,1979-11-22,2,1,0,0
Jean Petit,1,1,1979-02-25,1,0,0,0
Albert Emon,1,1,1979-02-25,1,0,0,0
Jean-François Larios,3,2,1980-10-11,1,2,0,2
Ernest Spiteri-Gonzi,3,3,1982-06-05,1,2,0,0
Fatih Terim,2,2,1980-09-24,2,0,0,1
René Vandereycken,2,2,1980-06-22,2,0,0,2
Kees Kist,4,4,1980-06-17,3,1,0,1
John Metgod,3,3,1981-10-14,2,1,0,0
Jan Peters,1,1,1979-03-28,1,0,0,0
Zlatko Vujović,18,13,1989-09-06,11,7,0,0
František Štambachr,2,2,1979-05-01,1,1,0,0
Lutz Lindemann,2,2,1979-05-05,1,1,0,0
Herbert Zimmermann,2,2,1979-12-22,1,1,0,0
Klaus Fischer,15,11,1982-07-08,11,4,0,0
Ionel Augustin,1,1,1979-05-13,0,1,0,0
Sotiris Kaiafas,2,2,1980-03-26,2,0,0,1
György Tatar,2,2,1979-10-17,1,1,0,0
Ramaz Shengelia,6,5,1982-06-22,5,1,0,0
Herbert Hermann,1,1,1979-05-22,1,0,0,0
Gianpetro Zappa,2,2,1981-10-10,1,1,0,0
Peter Nicholas,1,1,1979-06-02,0,1,0,0
Peter Barnes,1,1,1979-06-06,0,1,0,0
Preben Elkjær,26,18,1987-10-14,19,7,0,0
John Robertson,8,7,1990-10-17,7,1,0,4
Tore Cervin,1,1,1979-06-07,1,0,0,0
Janus Guðlaugsson,2,2,1980-09-24,1,1,0,0
Raimondo Ponte,1,1,1979-06-09,0,1,0,0
Heinz Hermann,4,4,1991-09-11,2,2,0,0
Aleksandr Khapsalis,1,1,1979-07-04,0,1,0,0
Carlos Ángel López,1,1,1979-07-18,0,1,0,0
Jesús Reynaldo,3,2,1981-02-15,3,0,0,0
Hugo Coscia,1,1,1979-08-02,0,1,0,0
Tita,5,4,1983-09-01,5,0,0,0
Jorge Gáspari,1,1,1979-08-08,1,0,0,0
Diego Maradona,15,10,1994-06-21,12,3,0,1
Rodolfo Carvajal,1,1,1979-08-08,1,0,0,0
Jorge Peredo,4,3,1979-09-05,3,1,0,0
Arnoldo Iguarán,14,10,1991-07-17,8,6,0,0
"Alex ""Didí"" Valverde",1,1,1979-08-22,1,0,0,0
José Gabriel Chaparro,1,1,1979-08-22,1,0,0,0
Jaime Morón,1,1,1979-08-22,1,0,0,0
Sócrates,10,9,1986-06-16,5,5,0,3
Roberto Osvaldo Díaz,1,1,1979-08-23,1,0,0,0
Leonardo Véliz,1,1,1979-08-29,1,0,0,0
Carlos Rivas,4,3,1981-06-14,4,0,0,1
Patricio Yáñez,4,4,1989-08-27,3,1,0,0
Hugo Talavera,2,2,1979-10-24,1,1,0,0
Carlos Torres Garcés,1,1,1979-08-29,1,0,0,1
Alicio Solalinde,1,1,1979-08-29,0,1,0,0
Carlos Caszely,7,5,1985-03-17,5,2,0,0
Mario Tenorio,1,1,1979-09-05,1,0,0,0
Jorge Luis Alarcón,1,1,1979-09-05,1,0,0,0
Waldemar Victorino,4,4,1981-09-13,2,2,0,2
Rutger Backe,1,1,1979-09-05,1,0,0,0
Patrick Battiston,2,2,1984-10-13,0,2,0,0
Pål Jacobsen,2,2,1984-10-17,2,0,0,0
Jean Janssens,1,1,1979-09-12,0,1,0,0
Eugenio Morel,5,4,1981-05-31,3,2,0,0
Alberto Bica,1,1,1979-09-16,1,0,0,0
Fausto Klinger,1,1,1979-09-16,0,1,0,0
Henryk Wieczorek,1,1,1979-09-26,1,0,0,0
Rubén Paz,3,3,1989-07-12,2,1,0,0
Ján Kozák,7,7,2009-06-06,3,4,0,0
Ladislav Vízek,10,8,1985-10-16,7,3,0,1
Jan Svensson,2,2,1981-06-24,1,1,0,0
Umberto Barberis,4,4,1984-10-17,2,2,0,0
Rüdiger Schnuphase,4,4,1981-10-10,3,1,0,2
Hans-Jörg Pfister,2,2,1980-11-19,0,2,0,0
Manfred Kaltz,6,5,1981-11-22,3,3,0,2
Karlheinz Förster,2,2,1984-12-16,1,1,0,0
Alan Curtis,2,2,1981-10-14,1,1,0,0
László Fekete,2,1,1979-10-17,2,0,0,0
Wojciech Rudy,1,1,1979-10-17,0,1,0,0
Huub Stevens,1,1,1979-10-17,1,0,0,0
Tony Woodcock,11,8,1984-11-14,3,8,0,0
Victor Moreland,1,1,1979-10-17,1,0,0,1
Jimmy Nicholl,2,2,1980-10-15,1,1,1,0
Roberto Mosquera,1,1,1979-10-17,1,0,0,0
Mustafa Denizli,1,1,1979-10-28,0,1,0,0
Emanuel Farrugia,1,1,1979-10-28,1,0,0,0
Paulo Roberto Falcão,4,4,1982-07-05,3,1,0,0
Milciades Morel,3,3,1983-10-13,2,1,0,0
Julio César Romero,10,9,1986-06-07,6,4,0,0
Sergey Andreyev,5,4,1982-10-13,4,1,0,0
Yuri Gavrilov,5,5,1985-04-17,3,2,0,0
Tuomo Hakala,1,1,1979-10-31,0,1,0,0
Blaž Slišković,1,1,1979-10-31,1,0,0,0
Marcel Răducanu,3,3,1980-10-15,2,1,0,0
Georg Hammer,1,1,1979-11-01,0,1,0,0
Artur Correia,1,1,1979-11-01,1,0,0,0
Zlatko Kranjčar,3,2,1982-12-15,3,0,0,0
Dušan Savić,2,2,1982-10-13,1,1,0,0
Éric Pécout,1,1,1979-11-17,1,0,0,0
Gilles Rampillon,1,1,1979-11-17,1,0,0,0
Gheorghe Mulţescu,1,1,1979-11-18,1,0,0,0
Eddy Voordeckers,2,2,1984-10-17,2,0,0,0
Reinaldo Gomes,1,1,1979-11-21,1,0,0,0
Erhan Önal,1,1,1979-11-21,1,0,0,0
Glenn Hoddle,4,4,1985-09-11,3,1,0,0
Fivos Vrahimis,3,3,1982-05-01,1,2,0,0
Enrique Saura,2,2,1982-06-20,1,1,0,0
Erwin Vandenbergh,15,15,1991-02-27,8,7,0,1
Danny Moulis,3,3,1980-03-01,2,1,0,0
Ian Hunter,5,2,1980-02-26,3,2,0,0
Paul Kay,4,2,1980-03-01,2,2,0,0
Eddie Krncevic,7,4,1981-04-25,2,5,0,0
Alfred Wabealo,2,1,1980-02-25,0,2,0,0
Arno Bertogna,1,1,1980-02-26,1,0,0,0
Vic Bozanic,2,2,1980-03-01,2,0,0,0
Peter Sharne,5,2,1981-07-26,4,1,0,0
Mouagi,1,1,1980-02-26,0,1,0,0
Torea,1,1,1980-02-26,0,1,0,0
Dewan Chand,2,1,1980-02-27,2,0,0,0
Meli Vuilabasa,4,3,1981-08-10,3,1,0,0
Klaus Allofs,10,6,1986-06-08,6,4,0,0
John Holland,2,2,1981-11-11,2,0,2,0
Walter Kelsch,1,1,1980-02-27,1,0,0,0
Michael Groom,1,1,1980-02-29,1,0,0,0
Mark Armstrong,3,1,1980-02-29,3,0,0,0
Bill de Graaf,2,1,1980-02-29,2,0,0,0
E. Karitea,1,1,1980-02-29,0,1,0,0
Andre Wabealo,1,1,1980-03-01,0,1,0,0
Mohamed Salim,1,1,1980-03-01,0,1,0,0
Jacob Xowie,1,1,1980-03-01,1,0,0,0
Ani Gome,1,1,1980-03-08,0,1,0,0
Muda Lawal,3,3,1984-03-18,2,1,0,0
Ifeanyi Onyedika,1,1,1980-03-08,1,0,0,0
Juma Mkambi,1,1,1980-03-08,0,1,0,0
Moussa Camara,1,1,1980-03-09,1,0,0,0
Mussad Nur,1,1,1980-03-12,1,0,0,0
Thuwein Waziri,2,2,1980-03-15,0,2,0,0
Lakhdar Belloumi,12,11,1988-03-26,8,4,0,0
Okey Isima,3,3,1985-07-06,3,0,1,0
Tedj Bensaoula,9,8,1985-07-28,7,2,0,0
Ibrahima Diawara,1,1,1980-03-16,0,1,0,0
Seydouba Bangoura,2,2,1980-12-21,1,1,0,0
Khalid Labied,4,3,1984-07-15,1,3,0,0
Ramadan El Sayed,1,1,1980-03-19,0,1,0,0
Salah Assad,5,4,1982-06-24,5,0,0,1
Hocine Benmiloudi,1,1,1980-03-19,1,0,0,0
Felix Owolabi,2,2,1981-10-30,1,1,0,0
Paul McGee,2,1,1980-03-26,0,2,0,0
Mark Lawrenson,5,4,1987-02-18,3,2,0,0
Nikos Pantziaras,2,2,1985-02-27,2,0,1,0
Steve Archibald,2,2,1982-06-15,2,0,0,0
Fernando Gomes,9,7,1988-11-16,4,5,0,0
Abubaker Bani,2,2,1985-03-08,2,0,0,0
Rashid Mohammed Rashid,1,1,1980-05-08,1,0,0,0
Assan Sarr,1,1,1980-05-08,0,1,0,0
Akie Noah,1,1,1980-05-31,1,0,0,0
Pele Kaimana,1,1,1980-06-01,1,0,0,0
Ian Walsh,3,2,1980-10-15,1,2,0,0
David Giles,2,2,1980-11-19,1,1,0,0
Plamen Markov,1,1,1980-06-04,0,1,0,0
Kostadin Kostadinov,3,3,1985-09-25,1,2,0,0
Ray Wilkins,1,1,1980-06-12,0,1,0,0
Jan Ceulemans,15,15,1991-02-27,8,7,0,0
Ali Fergani,3,3,1984-03-05,3,0,0,0
Rabah Madjer,14,13,1990-03-02,11,3,0,1
Sentu Johnson,1,1,1980-06-13,0,1,0,0
Nikos Anastopoulos,13,10,1987-01-14,8,5,0,1
Eric Gerets,2,2,1986-10-14,1,1,0,0
Marco Tardelli,3,3,1982-07-11,3,0,0,0
Sten-Ove Ramberg,1,1,1980-06-18,1,0,0,0
Gidi Damti,2,2,1981-10-28,1,1,0,0
Ladislav Jurkemik,2,2,1983-04-16,1,1,0,0
Horst Hrubesch,3,2,1982-06-25,1,2,0,0
Mory Koné,1,1,1980-06-22,1,0,0,0
Sele Leboela,1,1,1980-06-22,0,1,0,0
Naby Laye Camara,1,1,1980-06-22,1,0,0,1
Amara Touré,2,2,1980-07-06,1,1,0,0
Mohamed Timoumi,4,4,1989-06-25,2,2,0,0
Emmanuel Kundé,6,5,1990-07-01,6,0,0,3
Théophile Abega,4,3,1984-03-18,4,0,0,0
Elly Adero,1,1,1980-07-05,1,0,0,0
Sammy Owino,2,1,1980-07-05,2,0,0,1
Thuwein Ali,3,2,1980-07-19,2,1,0,0
Teboho Masia,1,1,1980-07-06,1,0,0,0
Leotis Boateng,1,1,1980-07-12,1,0,0,0
Emmanuel Osigwe,2,2,1982-03-10,1,1,0,0
Gil Guiambe,2,1,1980-07-13,0,2,0,0
Kiyika Tokodi,2,1,1980-07-13,2,0,0,2
Muteba N'Daye,3,2,1980-07-27,2,1,0,0
Masengo Ilunga,1,1,1980-07-13,1,0,0,0
Peter Tino,3,2,1984-10-13,3,0,0,0
Mohammed Adolf Rishard,1,1,1980-07-19,1,0,0,0
Stock Dandize,1,1,1980-07-20,1,0,0,0
Ayel Mayélé,2,2,1980-12-21,1,1,0,0
Francisco Rui Marcos,1,1,1980-07-27,1,0,0,1
Ismail Mohammed Sharif,2,2,1989-01-06,1,1,0,0
Sefedin Braho,1,1,1980-09-03,1,0,0,0
Millan Baçi,1,1,1980-09-03,1,0,0,0
Árni Sveinsson,1,1,1980-09-03,1,0,0,0
Terry McDermott,3,2,1981-05-30,2,1,0,0
Simon Tahamata,1,1,1980-09-10,0,1,0,0
Gordon Strachan,3,3,1991-05-01,0,3,0,1
Saad Al-Houti,2,2,1980-09-30,2,0,0,0
Ahmed Chombi,2,2,1980-09-24,0,2,0,0
Choi Soon-ho,12,8,1989-05-27,7,5,0,1
Zulkifli Hamzah,2,2,1980-09-18,1,1,0,0
Choi Jae-pil,2,1,1980-09-16,2,0,0,0
Kazi Salahuddin,1,1,1980-09-16,0,1,0,1
Kim Jong-man,1,1,1980-09-16,1,0,0,0
Ashraf Uddin Ahmed Chunnu,3,3,1985-04-02,2,1,0,0
Ghanem Al-Hajri,1,1,1980-09-17,0,1,0,0
Li Fubao,1,1,1980-09-18,0,1,0,0
Kim Bok-man,1,1,1980-09-18,1,0,0,0
Hwang Sang-hoi,2,2,1980-09-24,1,1,0,0
Jamal Keshek,2,2,1980-09-23,1,1,0,0
Lee Jung-il,1,1,1980-09-19,0,1,0,0
Hamid Alidousti,3,3,1984-12-01,2,1,0,0
Chen Jingang,3,3,1981-11-12,1,2,0,0
Xu Yonglai,4,2,1980-09-25,4,0,0,0
Abdah Alif,1,1,1980-09-20,0,1,0,0
Tukamin Bahari,2,2,1980-09-23,1,1,0,0
Hwang Seok-keun,1,1,1980-09-21,0,1,0,0
Abdolreza Barzegari,2,1,1980-09-22,0,2,0,0
Pak Jong-hun,2,2,1980-09-28,0,2,0,1
Åge Hareide,4,4,1983-09-07,3,1,0,0
Chung Hae-won,6,4,1989-05-23,4,2,0,0
Albert Guðmundsson,7,4,2024-03-26,2,5,0,2
Teitur Þórðarson,1,1,1980-09-24,0,1,0,0
Shen Xiangfu,4,2,1981-10-18,4,0,0,0
Kim Gwan-Mo,1,1,1980-09-26,0,1,0,0
Kim Gwang-Un,1,1,1980-09-26,0,1,0,0
Jawdat Suleiman,1,1,1980-09-26,1,0,0,0
Dragan Pantelić,2,2,1981-04-29,2,0,0,2
Zoran Vujović,1,1,1980-09-27,1,0,0,0
Hossein Faraki,3,2,1980-09-29,2,1,0,0
Jacques Zimako,2,2,1980-10-28,1,1,0,0
Fulvio Collovati,2,2,1981-12-05,1,1,0,0
Grégoire M'Bida,4,4,1982-06-23,3,1,0,0
Dinos Kouis,5,5,1981-11-14,2,3,0,0
Noel Brotherston,1,1,1980-10-15,1,0,0,0
Albert Cluytens,1,1,1980-10-15,0,1,0,0
Khoren Oganesian,3,2,1982-07-01,2,1,0,0
Georgi Slavkov,4,3,1981-10-14,3,1,0,0
Svein Mathisen,1,1,1980-10-29,0,1,0,0
Antonio Cabrini,3,3,1983-12-22,3,0,0,1
Bruno Conti,3,3,1982-06-18,3,0,0,0
Michel Kira,1,1,1980-11-16,1,0,0,0
Imowa Malgbanga,2,2,1980-12-21,1,1,0,0
Mohamed Boussati,1,1,1980-11-16,1,0,0,0
Ahmed Limane,1,1,1980-11-16,1,0,0,0
David Muchineripi,1,1,1980-11-16,1,0,0,0
Michael Robinson,4,4,1983-09-21,2,2,0,0
Chris Hughton,1,1,1980-11-19,1,0,0,0
Emmanuel Musonda,1,1,1980-11-30,1,0,0,0
Tsvetan Yonchev,1,1,1980-12-03,1,0,0,0
Gaetano Scirea,1,1,1980-12-06,0,1,0,0
Mohammed Salim,1,1,1980-12-06,0,1,0,0
Włodzimierz Smolarek,13,11,1987-05-17,7,6,0,2
Leszek Lipka,1,1,1980-12-07,0,1,0,0
Djogou Akoulassi,1,1,1980-12-14,0,1,0,0
John Chiedozie,2,2,1981-04-12,0,2,0,0
Christian M'Wokozhi,1,1,1980-12-20,0,1,0,0
M'Peti Suzeti,1,1,1980-12-21,1,0,0,0
Kuliwa Tshikalu,1,1,1980-12-21,0,1,1,0
Abdou Bin Amidou,1,1,1980-12-21,0,1,0,0
Li Yong-Sob,3,3,1980-12-28,1,2,0,0
Li Chang-Ha,2,2,1981-01-04,2,0,0,0
Kim Yong-Nam,3,3,1981-01-04,3,0,0,0
Kazushi Kimura,7,7,1985-10-26,4,3,0,0
Gu Guangming,6,6,1984-12-11,3,3,0,0
Zuo Shusheng,6,5,1985-02-26,4,2,0,0
Rong Zhixing,3,3,1981-10-18,3,0,0,0
Choi York Yee,1,1,1980-12-24,1,0,0,0
Thasmbiayah Pathmanathan,1,1,1980-12-24,0,1,0,0
Li Yong-Man,1,1,1980-12-28,0,1,0,0
Wan Chi Keung,4,3,1985-09-22,2,2,0,0
Wu Kwok Hung,1,1,1980-12-28,1,0,0,0
Hideki Maeda,1,1,1980-12-28,1,0,0,1
Haruhisa Hasegawa,1,1,1980-12-28,1,0,0,0
Abu Obeida Adam,1,1,1980-12-28,1,0,0,0
Bernard Akue Adovi,1,1,1980-12-28,0,1,0,0
Saibi Eklou Dodji,1,1,1980-12-28,1,0,0,0
Mamane Ali,1,1,1980-12-28,0,1,0,0
Huang Xiangdong,5,4,1982-01-10,2,3,0,0
Chen Xirong,1,1,1981-01-04,0,1,0,0
Georgios Kostikos,3,3,1983-05-15,1,2,0,1
Gerard Plessers,1,1,1981-02-18,1,0,0,0
Stefanos Lysandrou,1,1,1981-02-18,0,1,0,0
Hugo Hovenkamp,2,2,1982-12-19,1,1,0,0
Cees Schapendonk,1,1,1981-02-22,1,0,0,0
Pedro Acosta,3,3,1989-08-20,3,0,1,1
Hussein Saeed,7,6,1989-02-10,3,4,0,0
Fouad Bushegir,1,1,1981-03-19,0,1,0,0
Amin Dabo,1,1,1981-03-21,1,0,0,0
Khalid Salman,4,3,1988-12-09,3,1,0,2
Saud Jassem,2,1,1981-03-24,2,0,0,0
Hadi Ahmed,1,1,1981-03-25,1,0,0,0
Adnan Dirjal,1,1,1981-03-25,1,0,0,0
Arnold Mühren,3,3,1987-04-29,3,0,0,1
Billy Hamilton,4,3,1983-09-21,1,3,0,0
John Wark,5,4,1983-03-30,5,0,0,0
Carl Harris,1,1,1981-03-25,0,1,0,0
Khalfan Ibrahim,9,8,2015-01-11,5,4,0,2
Shait Ahmed Jehad,2,2,1981-03-30,0,2,0,0
Shaye Al Nafeesah,1,1,1981-03-28,1,0,0,0
Leovegildo Lins da Gama Júnior,2,2,1982-07-02,1,1,0,0
Nazar Ashraf,1,1,1981-03-30,1,0,0,0
Adel Khudhair,1,1,1981-03-30,1,0,0,0
Yousef Aboloya,1,1,1981-03-31,1,0,0,0
Bernd Schuster,2,1,1981-04-01,0,2,0,0
Emanuel Fabri,2,2,1982-06-05,2,0,0,0
Monduone N'Kama,1,1,1981-04-12,1,0,0,0
Ibrahima Sory Touré,1,1,1981-04-12,1,0,0,1
Henry Nwosu,2,2,1984-03-05,1,1,0,0
Petr Janečka,8,6,1986-10-15,6,2,0,0
James Wong Chye Fook,1,1,1981-04-21,0,1,0,0
Hong Sung-Ho,1,1,1981-04-21,1,0,0,0
Lee Kang-Jo,1,1,1981-04-21,1,0,0,0
Mohammed Karam,1,1,1981-04-22,1,0,0,0
Piyapong Pue-on,11,6,1997-03-02,5,6,0,1
Oh Seok-Jae,1,1,1981-04-24,1,0,0,0
Lee Tae-ho,9,8,1989-06-03,4,5,0,2
Mahboub Juma'a,2,1,1981-04-25,2,0,0,0
Nassir Al-Ghanem,2,2,1981-04-29,2,0,0,0
Grant Turner,10,7,1985-10-12,8,2,0,0
Ken Boden,1,1,1981-04-25,0,1,0,0
Steve Wooddin,9,9,1982-06-15,5,4,0,0
Tshilumba Mukendi,1,1,1981-04-26,0,1,0,0
Abdelaziz Daidi,1,1,1981-04-26,1,0,0,0
Sompit Suwannapluoh,1,1,1981-04-27,0,1,0,0
Ibrahim Din,2,1,1981-04-27,2,0,0,0
Khan Thatat Songwuti,1,1,1981-04-27,0,1,0,0
David Provan,1,1,1981-04-28,1,0,0,0
Moshe Sinai,1,1,1981-04-28,0,1,0,0
Sándor Müller,1,1,1981-04-28,0,1,0,1
Kees van Kooten,4,3,1982-12-19,1,3,0,0
Gérard Soler,3,2,1982-06-16,2,1,0,0
Bernd Krauss,1,1,1981-04-29,1,0,1,0
Edhem Šljivo,1,1,1981-04-29,1,0,0,0
Nourredine Kourichi,1,1,1981-05-01,1,0,0,0
Alain Nurenberg,1,1,1981-05-01,1,0,0,0
Andrzej Buncol,2,2,1982-06-22,2,0,0,0
Orly Klinger,1,1,1981-05-17,1,0,0,0
Alan Edward Davidson,1,1,1981-05-20,1,0,0,0
Hallvar Thoresen,5,5,1984-10-10,3,2,0,2
László Kiss,8,4,1983-04-17,6,2,0,0
Adrian Elrick,1,1,1981-05-23,1,0,0,0
Hans-Peter Briegel,1,1,1981-05-24,0,1,0,0
Magnús Bergs,2,2,1984-09-12,1,1,0,0
Þorsteinn Bjarnason,1,1,1981-05-27,1,0,1,0
Alfred Scheiwiler,1,1,1981-05-30,1,0,0,0
Abou Seydou,1,1,1981-05-31,1,0,0,0
Miguel María Michelagnoli,1,1,1981-05-31,1,0,0,0
Wilson Nieves,1,1,1981-05-31,0,1,0,0
Aurel Ţicleanu,1,1,1981-06-03,1,0,0,0
Ratu Jone,3,2,1981-08-10,2,1,0,0
Imre Garaba,1,1,1981-06-06,1,0,0,0
Tony Henderson,1,1,1981-06-10,1,0,0,0
Gary Byrne,1,1,1981-06-10,1,0,0,1
Duh Deng-Sheng,2,1,1981-06-10,0,2,0,0
Hadi Ismanto,1,1,1981-06-15,1,0,0,0
Gernot Jurtin,1,1,1981-06-17,1,0,0,0
Ari Valvee,3,3,1984-05-27,2,1,0,0
Vidar Davidsen,1,1,1981-06-17,1,0,0,0
Miguel Ángel Neira,2,2,1982-06-24,1,1,0,1
Gabriel Mendes,1,1,1981-06-24,1,0,1,0
Deng Chyan,1,1,1981-06-28,1,0,0,0
Jyn Tson,1,1,1981-06-28,1,0,0,0
Hernán Darío Herrera,5,5,1985-06-30,3,2,0,1
Guillermo La Rosa,3,3,1982-06-22,0,3,0,0
Gary Cole,9,2,1981-08-14,7,2,0,1
Pedro Sarmiento,1,1,1981-08-09,0,1,0,0
Julio Morales,2,1,1981-08-09,2,0,0,1
Budi Johannis,1,1,1981-08-10,1,0,0,0
Upendran Choy,1,1,1981-08-10,1,0,0,0
Herry Risdianto,2,2,1981-08-30,2,0,0,0
John Morris Williams,1,1,1981-08-10,0,1,0,0
Dave Mitchell,8,4,1985-11-03,7,1,0,0
Duncan Cole,1,1,1981-08-16,1,0,0,0
Keith Mackay,1,1,1981-08-16,1,0,0,0
Gerónimo Barbadillo,3,3,1985-06-30,2,1,0,0
Julio César Uribe,3,3,1985-06-02,1,2,0,1
Muhedin Targaj,3,3,1983-06-08,2,1,0,2
Leo Houtsonen,1,1,1981-09-02,1,0,0,0
Keijo Kousa,2,2,1982-09-08,2,0,0,0
Alexandre Czerniatynski,3,3,1992-09-02,2,1,0,0
Dai Davies,1,1,1981-09-09,1,0,1,0
Verner Lička,1,1,1981-09-09,1,0,0,0
Lárus Guðmundsson,1,1,1981-09-09,1,0,0,0
Atli Eðvaldsson,7,7,1990-09-05,5,2,0,0
Bryan Robson,14,10,1989-03-08,6,8,0,0
Hannu Turunen,1,1,1981-09-23,0,1,0,0
Wolfgang Dremmler,2,2,1983-04-23,1,1,0,0
Pétur Ormslev,2,2,1987-09-09,2,0,0,0
Aleksandre Chivadze,2,2,1982-06-22,2,0,0,0
Anatoliy Demyanenko,4,4,1985-04-17,3,1,0,0
Ricki Herbert,2,2,1981-11-28,2,0,0,0
Djamel Zidane,3,3,1986-06-03,2,1,0,0
Ilie Balaci,1,1,1981-10-10,1,0,0,0
Robert Lüthi,1,1,1981-10-10,0,1,0,0
Stoycho Mladenov,4,4,1985-04-06,2,2,0,0
Pierre Littbarski,10,9,1990-06-19,5,5,0,0
Felix Magath,2,2,1985-03-27,1,1,0,0
Thomas Larsson,1,1,1981-10-14,0,1,0,0
Minervino Pietra,1,1,1981-10-14,1,0,0,0
Tony Persson,1,1,1981-10-14,0,1,0,0
Philippe Mahut,1,1,1981-10-14,1,0,1,0
Bruno Bellone,2,2,1984-06-27,1,1,0,0
Robbie James,3,3,1983-12-14,2,1,0,0
Benny Tabak,3,1,1981-10-28,3,0,0,0
Ricardo Castro,2,2,1981-11-15,2,0,0,0
Manuel Manzo,1,1,1981-11-01,1,0,0,0
Mike Stojanović,2,2,1981-11-06,2,0,0,0
David Buezo,2,2,1981-11-08,2,0,0,0
Jorge Elvir Urquia,1,1,1981-11-03,1,0,0,0
Eduardo Laing,4,4,1985-03-10,3,1,0,0
José Roberto Figueroa,7,5,1985-09-08,6,1,0,2
Gerald Romulas,1,1,1981-11-06,0,1,0,0
Ever Hernández,2,2,1985-02-24,1,1,0,0
Anthony Costly,1,1,1981-11-08,1,0,0,0
Andreas Krause,1,1,1981-11-11,1,0,0,0
Jürgen Heun,1,1,1981-11-11,1,0,0,0
Daniel Cadet,1,1,1981-11-11,1,0,0,0
Carlos Orlando Caballero,1,1,1981-11-12,1,0,0,0
Ian Bridge,2,2,1981-11-15,0,2,0,0
Ahmed Al Nifawi,1,1,1981-11-12,1,0,0,0
Majed Abdullah,11,9,1993-05-18,9,2,0,0
Frantz Mathieu,1,1,1981-11-15,0,1,1,0
Ramón Núñez,5,4,2008-09-10,2,3,0,0
Jean-Pierre Tokoto,1,1,1981-11-15,0,1,0,0
Andrzej Iwan,1,1,1981-11-15,1,0,0,0
Stefan Majewski,2,2,1982-07-10,2,0,0,0
Dariusz Dziekanowski,9,7,1990-11-14,6,3,0,0
Paul Sturrock,2,2,1982-10-13,1,1,0,0
Vitaly Daraselia,1,1,1981-11-18,1,0,0,0
Cai Jinbiao,1,1,1981-11-19,1,0,0,0
Wes McLeod,1,1,1981-11-21,0,1,0,0
Jorge Luis Rodríguez,1,1,1981-11-21,1,0,0,0
Bob Iarusci,1,1,1981-11-21,0,1,0,0
Predrag Pašić,1,1,1981-11-21,1,0,0,0
Billy McClure,1,1,1981-11-28,1,0,0,1
Ibrahim Aoudou,2,2,1984-03-07,2,0,0,1
Mustapha Yaghcha,1,1,1981-11-29,0,1,0,1
Rostislav Vojáček,1,1,1981-11-29,1,0,0,0
Bernard Genghini,4,4,1986-06-28,3,1,0,0
Wynton Rufer,9,6,1997-06-18,5,4,0,0
Sami Al-Hashash,1,1,1981-12-14,1,0,0,0
Kamel Gabsi,1,1,1982-03-05,0,1,0,0
Abdel Razak Jaranah,1,1,1982-03-05,1,0,0,0
Fawzi Al-Issawi,1,1,1982-03-05,1,0,0,0
Opoku Nti,4,4,1985-04-21,2,2,0,0
Chaabane Merzekane,1,1,1982-03-07,1,0,0,0
Stephen Keshi,8,7,1992-01-12,2,6,0,1
Ademola Adeshina,2,2,1984-10-20,1,1,0,0
Kamel Seddik,1,1,1982-03-09,1,0,1,0
Faraj Al-Bor'osi,1,1,1982-03-09,1,0,0,0
Geofrey Munshya,2,2,1982-03-18,0,2,0,0
John Ebow Essien,1,1,1982-03-12,1,0,0,0
Peter Kaumba,3,3,1982-03-18,0,3,0,0
Aaron Njovu,2,2,1985-04-07,1,1,0,0
Peter Fregene,1,1,1982-03-13,0,1,1,0
Ali Al-Beshari,4,3,1985-03-08,4,0,0,0
Florea Văetuș,1,1,1982-05-01,1,0,0,0
Rodion Cămătaru,8,6,1990-09-12,3,5,0,0
Marteinn Geirsson,1,1,1982-06-05,0,1,0,1
Andriy Bal,1,1,1982-06-14,0,1,0,0
Éder Aleixo de Assis,4,4,1983-10-13,3,1,0,0
Gábor Pölöskei,3,3,1983-03-27,1,2,0,0
Lázár Szentes,2,2,1983-04-17,2,0,0,0
Héctor Zelaya,1,1,1982-06-16,0,1,0,0
Roberto López Ufarte,1,1,1982-06-16,1,0,0,1
David Narey,1,1,1982-06-18,0,1,0,0
Oscar,3,3,2014-07-08,3,0,0,0
Rubén Toribio Díaz,1,1,1982-06-18,0,1,0,0
Ludo Coeck,3,3,1983-04-27,3,0,0,0
Sergei Pavlovich Baltacha,2,2,1982-10-13,2,0,0,0
Jozef Barmoš,1,1,1982-06-20,1,0,1,0
Uwe Reinders,1,1,1982-06-20,1,0,0,0
Gustavo Moscoso,1,1,1982-06-20,0,1,0,0
Ivan Gudelj,2,2,1985-03-27,1,1,0,0
Abdullah Al-Buloushi,2,2,1984-12-09,1,1,0,0
Maxime Bossis,1,1,1982-06-21,1,0,0,0
József Varga,1,1,1982-06-22,0,1,0,0
Włodzimierz Ciołek,1,1,1982-06-22,1,0,0,0
Graeme Souness,1,1,1982-06-22,0,1,0,0
Serginho Chulapa,2,2,1982-07-02,1,1,0,0
Juan Carlos Letelier,10,7,1989-08-27,7,3,0,0
Reinhold Hintermaier,1,1,1982-07-01,1,0,0,0
Ramón Díaz,1,1,1982-07-02,1,0,0,0
Jesús María Zamora,1,1,1982-07-02,1,0,0,0
Alain Giresse,5,4,1985-10-30,4,1,0,0
René Girard,1,1,1982-07-10,0,1,0,0
Janusz Kupcewicz,2,2,1982-09-08,1,1,0,0
Alain Couriol,1,1,1982-07-10,0,1,0,0
Alessandro Altobelli,14,11,1988-06-17,9,5,0,2
Dick Schoenaker,6,4,1985-02-27,3,3,0,0
Ioan Andone,1,1,1982-09-08,1,0,0,0
Michael Klein,2,2,1987-10-28,1,1,0,0
Max Hagmayr,1,1,1982-09-22,1,0,0,0
Felix Gasselich,2,2,1983-09-21,1,1,0,0
Agustin Kola,2,2,1984-10-31,1,1,1,0
Heribert Weber,1,1,1982-09-22,1,0,0,0
Karl Brauneder,1,1,1982-09-22,1,0,0,0
Jesper Olsen,5,5,1986-06-18,5,0,0,2
António Luís Alves Ribeiro Oliveira,2,2,1983-09-21,1,1,0,0
Ruud Gullit,15,13,1992-12-16,7,8,0,0
Ian Rush,18,15,1993-10-13,13,5,0,0
Heinz Lüdi,1,1,1982-10-06,1,0,1,0
Mats Jingblad,1,1,1982-10-06,0,1,0,0
Ulf Eriksson,1,1,1982-10-06,0,1,0,0
Paweł Król,1,1,1982-10-10,0,1,0,0
Boycho Velichkov,2,2,1984-12-05,2,0,0,0
Plamen Nikolov,1,1,1982-10-27,1,0,0,0
Juan Carlos Pedraza,1,1,1982-10-27,1,0,0,0
Arif Kocabıyık,1,1,1982-10-27,1,0,0,0
Marcel Di Domenico,1,1,1982-11-10,1,0,0,0
Klaus Berggreen,4,3,1985-10-16,1,3,0,0
Dan Corneliusson,6,6,1985-10-16,4,2,0,0
Jiří Sloup,1,1,1982-11-13,0,1,0,0
Ján Kapko,1,1,1982-11-13,1,0,1,0
Pavel Chaloupka,1,1,1982-11-13,0,1,0,0
Toni Polster,29,19,1998-06-11,16,13,0,5
Nenad Stojković,1,1,1982-11-17,0,1,0,0
Sammy Lee,2,2,1983-10-12,0,2,0,0
Ian Stewart,2,2,1983-04-27,2,0,0,0
Ashley Grimes,1,1,1982-11-17,1,0,0,0
Antonio Maceda,6,5,1984-06-24,2,4,0,0
Víctor Muñoz,1,1,1982-11-17,0,1,0,0
Andy Egli,2,2,1983-03-30,1,1,0,0
Marcel Bossi,1,1,1982-12-15,1,0,1,0
Steve Coppell,1,1,1982-12-15,1,0,0,0
Luther Blissett,3,1,1982-12-15,3,0,0,0
Mark Chamberlain,1,1,1982-12-15,1,0,0,0
Zvezdan Cvetković,1,1,1982-12-15,1,0,0,0
Zvonko Živković,1,1,1982-12-15,1,0,0,0
Miodrag Ješić,1,1,1982-12-15,1,0,0,0
Joey Jones,1,1,1982-12-15,0,1,0,0
Edo Ophof,1,1,1982-12-19,0,1,0,1
Takis Mavris,1,1,1983-02-12,1,0,0,0
Nikos Patikkis,1,1,1983-02-12,0,1,1,0
Juan Antonio Señor,4,4,1986-06-22,3,1,0,1
Fanis Theofanous,1,1,1983-03-27,1,0,0,0
Jeannot Reiter,2,2,1983-04-17,1,1,0,0
József Póczik,3,1,1983-03-27,0,3,0,0
Romain Schreiner,1,1,1983-03-27,1,0,0,0
Péter Hannich,1,1,1983-03-27,0,1,0,0
Rudi Völler,26,19,1994-07-02,17,9,0,0
John McClelland,1,1,1983-03-30,1,0,0,0
Hasan Şengün,2,2,1983-10-26,0,2,0,0
Charlie Nicholas,3,3,1984-10-17,3,0,0,0
Václav Daněk,5,3,1990-11-14,5,0,0,0
Zdeněk Prokeš,1,1,1983-04-16,1,0,0,0
Gyula Hajszán,2,2,1983-05-15,2,0,0,0
Théo Malget,2,2,1989-11-15,0,2,0,0
Győző Burcsa,1,1,1983-04-17,1,0,0,0
Pawel Janas,1,1,1983-04-17,0,1,1,0
Søren Busk,1,1,1983-04-27,1,0,0,0
Peter Withe,1,1,1983-04-27,1,0,0,0
Fyodor Cherenkov,3,2,1985-10-16,3,0,0,0
Sergey Rodionov,2,2,1986-06-02,2,0,0,0
Nikolay Larionov,1,1,1983-04-27,1,0,0,0
Hipólito Rincón,7,4,1985-09-25,7,0,0,0
Jeremy Charles,1,1,1983-04-27,1,0,0,0
Metin Tekin,2,2,1985-11-13,1,1,0,0
Raşit Çetiner,1,1,1983-05-11,1,0,1,0
Lakis Papaioannou,2,2,1986-12-03,0,2,0,0
Carmel Busuttil,10,8,1993-03-24,6,4,0,1
Francisco José Carrasco,4,4,1987-04-01,1,3,0,1
Rafael Gordillo,3,3,1988-06-11,1,2,0,0
Robert Prytz,6,4,1985-11-17,3,3,0,2
Glenn Hysén,2,2,1986-11-16,1,1,0,0
Andreas Ravelli,2,2,1985-10-16,2,0,1,0
Roman Wójcicki,2,2,1987-05-17,0,2,1,0
Håkan Sandberg,1,1,1983-05-29,1,0,0,0
Glenn Strömberg,6,5,1990-06-16,2,4,0,0
Jorge Burruchaga,7,6,1990-06-13,4,3,0,1
Galo Fidean Vásquez,1,1,1983-08-10,1,0,0,0
José Jacinto Vega,1,1,1983-08-10,1,0,0,0
Alex Valderrama,2,2,1983-08-31,1,1,0,0
Franco Navarro,6,5,1989-07-05,3,3,0,0
Erwin Romero,1,1,1983-08-21,1,0,0,0
Ricardo Gareca,2,2,1985-06-30,2,0,0,0
Eduardo Malásquez,2,2,1983-10-20,0,2,0,1
Miguel Augusto Prince,3,3,1985-06-02,3,0,0,0
Fernando Fiorillo,1,1,1983-08-28,1,0,0,0
Juan Caballero,2,2,1983-09-04,1,1,0,0
Nolberto Molina,1,1,1983-08-31,1,0,0,1
José Milton Melgar,5,4,1993-08-22,4,1,0,1
Silvio Rojas,2,2,1985-05-26,1,1,0,0
Renato Gaúcho,2,2,1991-07-19,2,0,0,0
Eduardo Mario Acevedo,1,1,1983-09-01,1,0,0,0
Juan Carlos Orellana,1,1,1983-09-01,0,1,0,0
Germán Leguía,1,1,1983-09-04,1,0,0,0
David Paniagua,1,1,1983-09-04,0,1,0,0
Wilmar Cabrera,2,2,1983-10-20,2,0,0,0
Arsenio Luzardo,1,1,1983-09-04,1,0,0,0
Lupo Quiñónez,1,1,1983-09-07,0,1,0,0
Víctor Rogelio Ramos,1,1,1983-09-07,1,0,0,0
Hans Maldonado,2,2,1985-03-03,1,1,0,1
Ronald Koeman,8,8,1993-10-13,4,4,0,4
Peter Houtman,5,5,1985-11-20,4,1,0,0
Nasko Sirakov,14,14,1994-06-30,8,6,0,0
Oscar Arriaza,1,1,1983-09-08,1,0,0,0
Rodolfo Dubó,2,2,1983-09-11,2,0,0,0
Jorge Orlando Aravena Plaza,5,3,1985-11-03,4,1,0,0
Rubén Espinoza,1,1,1983-09-08,1,0,0,0
Alberto Santelli,1,1,1983-09-18,0,1,0,0
Pedro Febles,2,2,1985-06-16,1,1,0,0
Carlos Aguilera,5,5,1997-11-16,2,3,0,0
Gary Waddock,2,2,1983-10-12,1,1,0,0
Mickey Walsh,2,2,1984-09-12,1,1,0,0
Norman Whiteside,7,6,1989-09-06,5,2,0,0
Carlos Manuel,6,6,1986-06-03,3,3,0,0
Jukka Ikäläinen,1,1,1983-09-21,1,0,1,0
José Luís,1,1,1983-09-21,1,0,0,0
Michael Laudrup,19,15,1998-06-24,14,5,0,3
Hans Richter,1,1,1983-10-12,1,0,0,0
Rainer Ernst,9,7,1989-09-06,4,5,0,1
Marco van Basten,18,12,1991-04-17,6,12,0,2
Selçuk Yula,3,2,1983-11-16,3,0,0,1
Thomas Sunesson,3,2,1984-05-23,2,1,0,0
Uli Stielike,1,1,1983-10-26,1,0,0,0
Sándor Kiss,1,1,1983-10-26,1,0,0,0
Enzo Francescoli,10,10,1995-07-09,5,5,0,3
Víctor Diogo,1,1,1983-10-27,1,0,0,0
Jorginho Putinatti,1,1,1983-11-04,1,0,0,0
Marco Schällibaum,1,1,1983-11-09,1,0,0,0
Jean-Paul Brigger,3,3,1986-11-15,2,1,0,1
Alain Geiger,2,2,1989-10-11,1,1,1,0
Rusi Gochev,2,2,1985-11-16,1,1,0,0
Petr Rada,2,1,1983-11-16,2,0,0,1
Ronald Kreer,2,2,1985-09-11,2,0,0,0
Eamonn Bannon,1,1,1983-11-16,0,1,0,0
Terry Butcher,1,1,1983-11-16,0,1,0,0
Kevin O'Callaghan,1,1,1983-11-16,1,0,0,0
Kevin Sheedy,4,4,1992-09-09,3,1,0,0
İlyas Tüfekçi,2,2,1984-10-31,2,0,0,1
Ernst Baumeister,1,1,1983-11-16,0,1,0,0
Genc Tomorri,1,1,1983-11-20,0,1,0,0
Gerhard Strack,1,1,1983-11-20,1,0,0,0
Ion Geolgău,2,2,1984-09-12,0,2,0,0
Milan Luhový,3,3,1990-06-10,1,2,0,0
József Kardos,2,2,1984-09-26,1,1,0,0
Dimitris Saravakos,8,8,1994-09-07,5,3,0,0
Mehmed Baždarević,3,3,1990-11-14,0,3,0,0
Gerald Vanenburg,1,1,1983-12-17,1,0,0,0
Ben Wijnstekers,1,1,1983-12-17,1,0,0,0
Frank Rijkaard,4,3,1992-06-22,4,0,0,0
Michael Degiorgio,2,2,1985-10-12,0,2,0,0
Manuel Sarabia,2,2,1985-06-12,1,1,0,0
Bozhidar Iskrenov,2,2,1989-10-11,1,1,0,0
Ljubomir Radanović,2,2,1987-12-16,1,1,0,0
Marios Tsingis,1,1,1983-12-22,0,1,0,1
Taher Abouzeid,7,5,1986-03-17,4,3,0,0
Tia Koffi,1,1,1984-03-04,1,0,0,0
Youssouf Falikou Fofana,2,2,1992-01-13,1,1,0,0
Michel Goba,1,1,1984-03-04,1,0,0,0
Nasser Bouiche,2,2,1985-04-19,2,0,0,0
Shibuzor Ehilegbu,1,1,1984-03-05,0,1,0,0
Bonaventure Djonkep,3,3,1989-01-08,2,1,0,0
Rafiou Moutairou,1,1,1984-03-07,0,1,0,0
Djamel Menad,12,9,1990-03-12,9,3,0,0
Harry Waya,2,2,1984-07-28,2,0,0,1
Clifton Msiya,1,1,1984-03-08,1,0,0,0
Clement Temile,3,2,1984-11-04,0,3,0,0
Seth Amphadu,1,1,1984-03-11,1,0,0,0
Emad Suleiman,3,3,1985-04-05,2,1,0,0
Ali Bala,1,1,1984-03-14,0,1,0,0
Magdi Abdelghani,2,2,1990-06-12,0,2,0,2
Hocine Yahi,2,2,1985-10-18,2,0,0,0
Rene N'Djeya,1,1,1984-03-18,1,0,0,0
Ernest Ebongué,3,3,1993-01-10,1,2,0,0
Martin Gisinger,1,1,1984-05-02,0,1,0,0
Paschalis Christoforou,1,1,1984-05-02,1,0,0,0
Ingemar Erlandsson,1,1,1984-05-23,1,0,0,1
Georges Grün,5,5,1995-09-06,2,3,0,0
John Lauridsen,1,1,1984-06-16,1,0,0,0
Luis Fernández,4,4,1991-10-12,3,1,0,1
Marcel Coraș,2,2,1985-11-13,0,2,0,0
António Sousa,1,1,1984-06-17,1,0,0,0
Kenneth Brylle Larsen,1,1,1984-06-19,1,0,0,0
Miloš Šestić,2,2,1984-10-20,0,2,0,0
Dragan Stojković,11,9,1999-09-05,4,7,0,2
Jean-François Domergue,2,1,1984-06-23,2,0,0,0
Mustapha Merry,4,3,1985-10-06,3,1,0,1
Ivo Raimundo Traça,1,1,1984-07-01,1,0,0,0
Ricky Phuka,1,1,1984-07-15,0,1,0,0
Saad Dahane,2,2,1985-04-07,2,0,0,2
Abdou Karim Sèye,1,1,1984-07-15,1,0,0,0
Frank Sinalo,2,1,1984-07-28,2,0,0,0
Bernard Leclézio,1,1,1984-07-28,1,0,1,0
Fanny Hangunyu,1,1,1984-07-29,1,0,0,0
Lucky Msiska,2,2,1989-01-22,2,0,0,0
Kalusha Bwalya,19,16,2004-09-04,11,8,0,2
Godfrey Katerega,1,1,1984-08-25,1,0,0,0
Alaa Mayhoub,1,1,1984-08-28,1,0,0,0
Gino Iorgulescu,2,2,1985-11-13,1,1,1,0
Gheorghe Hagi,27,24,1999-09-08,17,10,0,4
André Egli,3,3,1987-04-15,2,1,0,1
Antal Nagy,1,1,1984-09-26,1,0,0,0
Márton Esterházy,3,3,1986-06-06,2,1,0,0
Hamada Sedki,1,1,1984-09-30,1,0,1,0
Hennadiy Lytovchenko,6,6,1989-10-08,3,3,0,0
Joe Masiga,3,3,1985-04-20,1,2,0,0
Mulugeta Kebede,2,2,1984-10-28,1,1,0,0
Sam Tabu,1,1,1984-10-13,1,0,0,0
Yannick Stopyra,6,5,1987-04-29,2,4,0,0
Mohamed Abdallah,1,1,1984-10-13,0,1,0,0
Diamantino Miranda,3,3,1986-06-11,3,0,0,0
Nico Claesen,11,7,1987-04-01,5,6,0,1
Bedri Omuri,3,3,1985-10-30,1,2,0,0
Enzo Scifo,14,12,1995-06-07,6,8,0,2
Mark Hateley,4,3,1985-05-22,2,2,0,0
Kenny Sansom,1,1,1984-10-17,1,0,0,0
Uwe Rahn,3,2,1985-03-27,3,0,0,0
Wim Kieft,7,6,1990-06-12,5,2,0,0
Lajos Détári,8,7,1993-10-27,5,3,0,1
Tasos Mitropoulos,5,5,1993-05-23,3,2,0,0
Paul McStay,7,6,1992-06-18,5,2,0,0
Emilio Butragueño,15,9,1990-12-19,9,6,0,1
Michael Glowatzky,1,1,1984-10-20,1,0,0,0
Fadil Vokrri,4,3,1987-10-14,2,2,0,0
Humphrey Edobor,3,2,1988-03-14,2,1,0,0
Abdoulaye Traoré,17,12,1994-04-03,13,4,0,1
Kouassi N'Dri,2,2,1986-03-07,2,0,0,0
Oumar Ben Salah,6,5,1993-04-16,5,1,0,0
Bassam Jeridi,6,4,1988-08-05,5,1,0,0
Mohamed Gasri,2,2,1984-11-13,1,1,0,0
Gebremedhin Haile,1,1,1984-10-28,1,0,0,0
Dagne Tesfaye,1,1,1984-10-28,1,0,0,0
Sammy Ayoyi,1,1,1984-10-28,0,1,0,0
Sammy Onyango,1,1,1984-10-28,0,1,0,0
Karel Jarolím,1,1,1984-10-31,1,0,0,0
Jan Berger,1,1,1984-10-31,1,0,0,1
Andrzej Pałasz,1,1,1984-10-31,1,0,0,0
Ari Hjelm,7,7,1995-06-11,4,3,0,0
Mika Lipponen,5,5,1989-10-04,2,3,0,0
Baboucar Sowe,1,1,1984-11-04,1,0,0,0
Joël Tiéhi,14,10,1998-02-16,9,5,0,1
Cheikh Ndour,1,1,1984-11-04,1,0,0,0
Bai Malleh Wadda,1,1,1984-11-04,1,0,0,0
Abdelkader Rakbaoui,2,2,1985-10-06,2,0,0,0
Michel Valke,1,1,1984-11-14,1,0,1,0
John O'Neill,1,1,1984-11-14,1,0,0,0
Torbjörn Nilsson,1,1,1984-11-14,0,1,0,0
Mo Johnston,10,8,1990-06-16,7,3,0,1
Andoni Goikoetxea,1,1,1984-11-14,0,1,0,0
John Barnes,8,6,1993-04-28,4,4,0,0
Viv Anderson,2,2,1986-11-12,1,1,0,0
Mark Hughes,11,9,1996-08-31,7,4,0,0
Kostas Foti,1,1,1984-11-17,1,0,0,0
Antal Róth,1,1,1984-11-17,0,1,0,0
Ralf Minge,5,3,1987-06-03,2,3,0,0
Shahrokh Bayani,3,3,1984-12-13,1,2,0,2
Nasser Mohammadkhani,3,3,1984-12-16,2,1,0,0
Mubarak Anber,1,1,1984-12-01,0,1,1,0
Malik Awab,1,1,1984-12-02,1,0,0,0
Razali Saad,3,3,1993-04-26,3,0,0,0
Zia Arabshahi,1,1,1984-12-03,0,1,0,0
Ibrahim Al-Rumaihi,1,1,1984-12-03,1,0,1,0
Saleh Khalifa Al-Dosari,1,1,1984-12-04,0,1,0,0
Adnan Al Talyani,18,16,1997-12-17,13,5,0,0
Fahad Khamees,5,5,1993-05-03,4,1,0,0
Jia Xiuquan,5,5,1989-07-29,3,2,0,0
Zhao Dayu,8,5,1985-05-12,5,3,0,0
Radwan Al-Sheikh Hassan,2,2,1985-04-19,2,0,0,0
Philippe Anziani,1,1,1984-12-08,1,0,0,0
Ali Zaid,1,1,1984-12-08,1,0,0,0
Mohammed Abduljawad,1,1,1984-12-08,0,1,0,0
Fahad Khamis Mubarak,1,1,1984-12-08,0,1,0,0
Lin Lefeng,2,2,1985-02-20,0,2,0,0
Walid Abu Al-Sel,5,5,1989-03-25,1,4,0,1
Issam Mahrous,1,1,1984-12-09,1,0,1,0
Yang Zhaohui,3,2,1985-05-12,3,0,0,0
Mohaisen Al-Jam'an,3,2,1989-03-15,3,0,0,0
Shahin Bayani,1,1,1984-12-13,1,0,1,0
Li Huayun,1,1,1984-12-14,0,1,0,0
Muayad Al-Haddad,1,1,1984-12-16,0,1,0,0
Raymond Xuereb,1,1,1984-12-16,1,0,0,0
Shaye Al-Nafisah,1,1,1984-12-16,1,0,0,0
Mirel Josa,1,1,1984-12-22,1,0,0,0
Arben Minga,1,1,1984-12-22,1,0,0,0
Au-yeong Pak Kuan,1,1,1985-01-19,1,0,0,0
Yu Song-chol,1,1,1985-01-19,0,1,0,0
Alsény Diaby,1,1,1985-02-10,1,0,0,0
Leonard Farrugia,2,2,1985-11-17,2,0,0,0
Meng Kam Jong,1,1,1985-02-17,1,0,0,0
Alberto Carvalhal,2,2,1985-04-13,1,1,0,0
Ng Chi Kit,1,1,1985-02-20,0,1,1,0
Lin Qiang,1,1,1985-02-20,0,1,0,0
Mak King-Fun,4,1,1985-02-23,4,0,0,0
Lai Wing-Cheung,2,2,1985-04-06,1,1,0,0
Lee Wai-Shan,1,1,1985-02-23,1,0,0,0
Yahya Madon,1,1,1985-02-23,1,0,0,0
Koichi Hashiratani,1,1,1985-02-23,0,1,0,0
Hisashi Kato,1,1,1985-02-23,0,1,0,0
Mauricio Alfaro,1,1,1985-02-24,1,0,0,0
Wilfredo Huezo,1,1,1985-02-24,1,0,0,0
Hakim Braham,1,1,1985-02-24,1,0,0,0
Lotfi Hsoumi,1,1,1985-02-24,1,0,0,0
Li Hui,3,3,1985-05-19,3,0,0,0
Liu Haiguang,5,3,1989-07-15,3,2,0,0
José María Rivas,3,2,1985-03-10,3,0,0,0
Kostas Antoniou,2,2,1986-12-03,1,1,0,0
Panayiotis Marangos,1,1,1985-02-27,0,1,0,0
Erwin Koeman,2,2,1989-11-15,2,0,0,0
Paco Clos,1,1,1985-02-27,1,0,0,0
Rupak Ray Sharma,1,1,1985-03-02,0,1,1,0
Rinaldo Entingh,1,1,1985-03-03,0,1,0,0
Kenneth Stjeward,1,1,1985-03-06,0,1,0,0
Abubaker Ben Brahim,1,1,1985-03-08,1,0,0,0
Ibrahim Al-Maadani,1,1,1985-03-08,1,0,0,0
Roberto Bailey,1,1,1985-03-10,0,1,0,0
Dollah Salleh,7,6,1989-06-07,6,1,0,1
Hamilton Cuvi,2,2,1987-07-04,0,2,0,0
Venancio Ramos,2,2,1985-04-07,2,0,0,0
Dede Sulaiman,4,4,1985-07-30,3,1,0,0
Issam Said Saleh,1,1,1985-03-15,1,0,0,0
Héctor Puebla,1,1,1985-03-17,1,0,0,0
Fernando Baldeón,2,1,1985-03-17,0,2,0,0
Alejandro Hisis,2,2,1985-10-27,2,0,0,0
Jorge Aravena,6,4,1989-08-06,3,3,0,0
Bambang Nurdiansyah,4,3,1985-04-02,3,1,0,0
Krishanu Dey,2,2,1985-04-09,1,1,0,0
Hiromi Hara,4,4,1985-09-22,3,1,0,0
Marwan Medrati,1,1,1985-03-22,1,0,0,0
Thanis Areesngarkul,2,2,1992-10-29,1,1,0,0
Vitoon Kijmongkolsak,1,1,1985-03-23,1,0,0,0
Sakdarin,1,1,1985-03-23,1,0,0,0
Hugo Eduardo Rubio,6,6,1991-07-14,6,0,0,0
Rateb Al-Dawud,2,2,1989-02-10,1,1,0,0
Jamal Abu Abed,2,2,1993-06-16,1,1,0,0
Wamidh Munir,1,1,1985-03-29,0,1,0,0
Ahmed Radhi,18,15,1997-05-23,13,5,0,0
Herry Kiswanto,3,2,1989-06-25,2,1,0,0
Ibrahim Farhan,2,1,1985-03-29,0,2,0,0
Ibrahim Al-Hardan,2,2,1985-04-12,1,1,0,0
Yousif Al-Sobaei,1,1,1985-03-29,0,1,0,0
Abubakar Al-Mass,1,1,1985-03-29,1,0,0,0
Sisir Ghosh,1,1,1985-03-30,0,1,0,0
Bikash Panji,2,2,1985-04-12,1,1,0,0
Mario Saralegui,1,1,1985-03-31,0,1,0,0
Zainal Abidin Hassan,5,3,1997-03-31,4,1,0,0
Yunus Alif,1,1,1985-03-31,1,0,0,0
Kaiser Hamid,2,2,1993-05-07,2,0,0,1
Elias Hossain,1,1,1985-04-05,1,0,0,0
Salah Al-Hasawi,5,3,1989-01-13,3,2,0,0
Jamal Yaqoub,1,1,1985-04-05,1,0,0,0
Ahmed Issa Al-Mohannadi,1,1,1985-04-05,1,0,0,0
Mohammed Khalifa Al-Ammari,1,1,1985-04-05,1,0,0,0
Zainudin Kassim,1,1,1985-04-06,1,0,0,0
Narender Thapa,1,1,1985-04-06,1,0,0,0
Fatai Amoo,1,1,1985-04-06,0,1,0,0
Rashidi Yekini,21,16,1994-06-21,15,6,0,1
Kim Suk-won,1,1,1985-04-06,1,0,0,0
Chung Jong-Soo,1,1,1985-04-06,1,0,0,0
Mustafa El Haddaoui,2,2,1988-03-16,2,0,0,0
José Batista,1,1,1985-04-07,1,0,0,0
Michael Chabala,4,2,1986-03-08,3,1,0,0
André Kana-Biyik,7,6,1992-01-12,2,5,0,0
Narasek Boongeang,1,1,1985-04-09,0,1,0,0
Wagdan Mahmoud Shadli,3,3,1993-05-24,1,2,0,0
Rahman Hisham Abdullah,1,1,1985-04-12,1,0,0,0
Adnan Ali Deif,1,1,1985-04-12,1,0,0,0
Tariq Abdullah Kassim,1,1,1985-04-12,0,1,0,0
Adnan Ahmed Al-Sabbou,1,1,1985-04-12,0,1,0,0
Ashish Bhadra,1,1,1985-04-12,0,1,0,0
Camillo Gonsalves,1,1,1985-04-12,1,0,0,0
Ali Mohammed Al-Saadah,1,1,1985-04-12,1,0,0,0
Adel Malulla,1,1,1985-04-12,1,0,0,0
Ahmed Rahim,1,1,1985-04-13,1,0,0,0
Daniel Pinto,2,2,1993-05-03,1,1,0,0
Igor Vrablic,3,3,1985-09-14,2,1,0,0
Mike Sweeney,1,1,1985-04-13,1,0,0,0
József Kiprich,11,8,1995-03-29,5,6,0,2
Faouzi Mansouri,1,1,1985-04-19,1,0,0,0
Osvaldo Fernando Saturnino de Oliveira,1,1,1985-04-19,0,1,0,0
Eduardo Machado,1,1,1985-04-19,0,1,0,0
Khalil Allawi,2,2,1985-11-29,2,0,0,0
Mahmoud Al-Sayed,2,1,1985-04-19,2,0,0,0
Dale Mitchell,10,8,1992-11-08,6,4,0,0
Julio Gómez Rendón,1,1,1985-04-20,0,1,0,0
Dahiru Sadi,1,1,1985-04-20,1,0,0,0
Yisa Sofoluwe,1,1,1985-04-20,1,0,0,0
Jones Chilengi,2,2,1986-03-14,1,1,1,0
Louis-Paul M'Fédé,4,3,1989-10-08,4,0,0,1
Herilia Rafanodina,1,1,1985-04-21,1,0,0,0
Franklin Williams,1,1,1985-04-24,1,0,0,0
Miguel Lacey,1,1,1985-04-24,1,0,0,0
Nilton Nóbrega,1,1,1985-04-24,1,0,0,0
Carlos Eduardo Estrada,1,1,1985-04-26,0,1,0,0
Abdulnaser Abbas,1,1,1985-04-26,1,0,0,0
Nevick De Noon,1,1,1985-04-28,0,1,0,0
Jorge Manuel Ulate,1,1,1985-04-28,1,0,0,0
Cheung Ka-Ping,1,1,1985-04-28,0,1,0,0
Thomas Berthold,1,1,1985-04-30,0,1,0,0
Lothar Matthäus,15,14,1999-07-28,10,5,0,5
Matthias Herget,2,2,1985-09-25,0,2,0,0
Stanislav Griga,2,2,1989-05-09,2,0,0,0
Oleh Protasov,13,11,1991-11-13,9,4,0,0
Georgi Kondratiev,3,2,1985-10-30,3,0,0,0
Byron Pérez,1,1,1985-05-05,1,0,0,0
Karim Mohammed Allawi,1,1,1985-05-05,1,0,0,0
Peter Hrstic,1,1,1985-05-07,1,0,0,0
Gerald Willfurth,1,1,1985-05-07,1,0,0,0
Wang Huiliang,1,1,1985-05-12,1,0,0,0
Rob de Wit,2,2,1985-11-20,1,1,0,0
Raúl Chacón,3,3,1989-06-17,2,1,0,1
Selvin Galindo,1,1,1985-05-15,1,0,0,0
Juan Manuel Funes,4,4,2000-06-18,4,0,0,0
Alfredo Solórzano,1,1,1985-05-15,1,0,0,0
Adrian Fonrose,1,1,1985-05-15,0,1,0,0
Chico Borja,1,1,1985-05-15,1,0,0,0
Mark Peterson,1,1,1985-05-15,1,0,0,0
Robby Langers,6,6,1996-10-08,5,1,0,0
Takashi Mizunuma,3,3,1989-06-04,3,0,0,0
Akihiro Nishimura,2,1,1985-05-18,2,0,0,0
Cheung Chi Tak,1,1,1985-05-19,0,1,0,0
Ku Kam Fai,1,1,1985-05-19,0,1,0,0
Marek Ostrowski,1,1,1985-05-19,0,1,0,0
Park Chang-Sun,2,2,1986-06-02,1,1,0,0
Cho Min-Kook,3,3,1989-06-05,2,1,0,0
Paul Caligiuri,3,3,1990-06-10,2,1,0,0
Jari Rantanen,2,2,1985-09-25,2,0,0,0
Yun Jong-su,3,3,1993-04-09,2,1,0,0
Han Hyong-Il,3,3,1989-07-09,3,0,0,0
Jorge Amado Nunes,1,1,1985-05-26,0,1,0,0
Óscar Ramírez,3,3,1992-12-05,2,1,0,0
"John Kerr, Jr.",1,1,1985-05-26,0,1,0,0
Orlando Torres,1,1,1985-05-26,1,0,0,0
Herbert Marquez,1,1,1985-05-26,1,0,0,0
Jim Bett,1,1,1985-05-28,0,1,0,0
Evaristo Coronado,3,3,1989-05-28,1,2,0,0
Plamen Getov,3,2,1986-06-05,2,1,0,0
Milko Djurovski,1,1,1985-06-01,0,1,0,0
Walter Casagrande,2,2,1985-06-16,0,2,0,0
Miguel Ángel Noro,1,1,1985-06-02,0,1,1,0
Pedro Pasculli,4,3,1986-06-16,2,2,0,0
Sergey Gotsmanov,1,1,1985-06-05,0,1,0,0
Lasse Larsson,1,1,1985-06-05,1,0,0,0
Miguel Ángel Russo,1,1,1985-06-09,1,0,0,0
Néstor Clausen,1,1,1985-06-09,1,0,0,0
Alfredo Mendoza,7,6,1993-09-05,3,4,0,0
Justo Jacquet,1,1,1985-06-09,1,0,0,0
Teitur Thordarson,1,1,1985-06-12,1,0,0,0
Marcos Alonso Peña,1,1,1985-06-12,0,1,0,0
Jorge Valdano,5,4,1986-06-29,5,0,0,0
Jorge Hirano,5,5,1991-07-14,2,3,0,0
Douglas Cadeño,1,1,1985-06-23,1,0,0,0
Bernardo Añor,1,1,1985-06-23,1,0,0,0
Careca,14,9,1990-06-10,12,2,0,1
Juan Carlos Sánchez,1,1,1985-06-30,0,1,0,0
Manuel Asisclo Cordoba,1,1,1985-06-30,1,0,0,0
Byun Byung-joo,4,3,1988-12-11,3,1,0,0
Kim Joo-sung,5,5,1989-10-20,2,3,0,0
Reda Al-Senussi,1,1,1985-07-26,1,0,0,0
Ayad Al-Qadi,1,1,1985-07-26,1,0,0,1
Aziz Bouderbala,3,3,1989-01-22,2,1,0,0
Alvaro Solano,1,1,1985-08-11,1,0,0,0
Porfirio Armando Betancourt,3,3,1985-09-14,1,2,0,0
Johnny Williams,2,2,1985-08-17,1,1,0,0
Paul James,1,1,1985-08-17,1,0,0,0
José Touré,3,3,1987-09-09,2,1,0,0
George Pakos,2,2,1985-09-14,1,1,0,0
Dorin Mateuț,6,6,1991-11-13,5,1,0,0
Rifaat Turk,3,1,1985-09-03,3,0,0,0
Zahi Armeli,5,5,1985-11-10,4,1,0,0
Ebrahim Isa,1,1,1985-09-06,1,0,0,0
Nizar Mahrous,6,6,1993-07-04,3,3,0,0
Alexandre Guimarães,1,1,1985-09-08,0,1,0,0
Avi Cohen,2,2,1985-10-20,1,1,0,0
Eli Ohana,8,5,1997-04-30,7,1,0,1
Davie Cooper,4,3,1986-11-12,3,1,0,2
Abdul Kader Kardaghli,1,1,1985-09-20,1,0,0,0
Haris Mohammed,1,1,1985-09-20,0,1,0,0
Vladimír Hruška,1,1,1985-09-25,1,0,0,0
Guy Hellers,3,3,1995-06-07,1,2,1,0
Gudmundur Thorbjornsson,1,1,1985-09-25,0,1,0,0
Mats Magnusson,3,3,1989-10-08,2,1,0,0
Karim Saddam,1,1,1985-09-27,1,0,0,0
Andreas Thom,11,7,1989-10-08,5,6,0,0
Haris Škoro,1,1,1985-09-28,1,0,0,0
Declan Edge,1,1,1985-10-05,1,0,0,0
Colin Walker,4,3,1985-10-26,4,0,0,1
Chen Sing-an,1,1,1985-10-05,0,1,0,0
Mohamed Kaci-Saïd,1,1,1985-10-06,0,1,0,0
Allan Boath,1,1,1985-10-12,1,0,0,0
Frederico Rosa,3,3,1989-04-26,1,2,1,0
José Rafael,1,1,1985-10-12,1,0,0,0
Chris Waddle,4,4,1989-04-26,3,1,0,0
Gary Lineker,22,13,1991-11-13,17,5,0,3
Tom Sundby,3,3,1987-10-14,1,2,0,0
Jimmy Quinn,9,8,1995-10-11,7,2,0,1
Abdel Razak Al-Farjani,1,1,1985-10-18,1,0,0,0
David Ratcliffe,1,1,1985-10-20,1,0,0,0
Robbie Dunn,2,1,1985-10-23,2,0,0,1
Chun Keui Chiang,1,1,1985-10-23,1,0,1,0
Graham Arnold,8,7,1997-07-06,7,1,0,0
Jung Yong-Hwan,1,1,1985-10-26,0,1,0,0
Malcolm Dunford,4,4,1989-04-09,3,1,0,0
Žarko Odžakov,3,1,1985-10-27,3,0,0,0
Oscar Crino,2,2,1989-03-12,2,0,0,0
Ian Gray,2,2,1992-09-26,2,0,0,0
Ramón Hicks,1,1,1985-10-27,1,0,0,0
Roberto Cabañas,6,5,1993-06-18,6,0,0,0
Giorgos Skartados,1,1,1985-10-30,0,1,0,0
Buenaventura Ferreira,3,2,1989-07-07,2,1,0,0
Sergio Angulo,1,1,1985-11-03,1,0,0,0
Nissim Cohen,1,1,1985-11-10,1,0,0,0
Moshe Selecter,1,1,1985-11-10,1,0,0,0
Rogelio Delgado,1,1,1985-11-10,1,0,0,0
Lizardo Garrido,1,1,1985-11-10,1,0,1,0
John Sivebæk,1,1,1985-11-13,0,1,0,0
Christian Matthey,1,1,1985-11-13,1,0,0,0
Ștefan Iovan,3,2,1986-09-10,2,1,0,0
Uwe Zötzsche,1,1,1985-11-16,1,0,0,1
Matthias Liebers,1,1,1985-11-16,1,0,0,0
Vladimiro Schettina,1,1,1985-11-17,0,1,0,0
Jorge Muñoz Luna,1,1,1985-11-17,1,0,0,0
Andreas Brehme,6,6,1990-07-08,5,1,0,1
Josef Novák,1,1,1985-11-17,0,1,0,0
Vladislav Lauda,1,1,1985-11-17,0,1,0,0
Frank McAvennie,1,1,1985-11-20,1,0,0,0
Shaker Mahmoud,1,1,1985-11-29,1,0,0,0
Thierno Youm,1,1,1986-03-07,0,1,0,0
Shawky Gharieb,1,1,1986-03-10,1,0,0,0
Gamal Abdelhamid,3,2,1988-03-17,3,0,0,0
Pape Fall,1,1,1986-03-10,0,1,0,0
Jules Bocandé,3,3,1992-01-16,2,1,0,0
Abdelkrim Merry,3,3,1988-03-13,1,2,0,1
Karim Maroc,1,1,1986-03-14,1,0,0,0
Lucien Kassi-Kouadio,3,2,1992-10-10,3,0,0,1
Abdelfettah Rhiati,2,2,1989-01-08,1,1,0,0
Mohammed Sahil,1,1,1986-03-20,0,1,0,0
Jean-Pierre Papin,20,17,1994-12-13,10,10,0,4
Oscar Ruggeri,2,2,1993-06-20,2,0,0,0
Pavlo Yakovenko,1,1,1986-06-02,1,0,0,0
Sergei Aleinikov,4,4,1991-05-29,2,2,0,0
Igor Belanov,8,6,1987-10-28,7,1,0,3
Ivan Yaremchuk,1,1,1986-06-02,1,0,0,0
László Dajka,1,1,1986-06-02,1,0,1,0
Fernando Quirarte,2,2,1986-06-11,2,0,0,0
Antonio Alzamendi,5,5,1989-08-27,1,4,0,0
Vasyl Rats,3,3,1988-06-12,0,3,0,0
Kim Jong-Boo,1,1,1986-06-05,1,0,0,0
Luis Flores,4,4,1993-05-02,3,1,0,0
Julio Salinas,14,9,1994-12-17,4,10,0,0
Colin Clarke,10,8,1992-09-09,6,4,0,1
Jean Tigana,1,1,1986-06-09,0,1,0,0
Oleksandr Zavarov,5,5,1990-06-18,3,2,0,0
Cho Kwang-Rae,1,1,1986-06-10,0,1,1,0
Daniel Veyt,1,1,1986-06-11,0,1,0,0
Abderrazak Khairi,2,1,1986-06-11,0,2,0,0
Ramón Calderé,3,2,1987-04-29,0,3,0,0
Eloy,1,1,1986-06-12,0,1,0,0
Josimar,2,2,1986-06-16,1,1,0,0
John Eriksen,1,1,1986-06-13,1,0,0,0
Manuel Negrete Arias,1,1,1986-06-15,1,0,0,0
Raúl Servín,1,1,1986-06-15,1,0,0,0
Stéphane Demol,1,1,1986-06-15,0,1,0,0
Edino Nazareth Filho,1,1,1986-06-16,1,0,0,0
Andoni Goikoetxea Olaskoaga,1,1,1986-06-18,0,1,0,1
Peter Beardsley,6,5,1990-10-17,5,1,0,0
Jean-Marc Ferreri,1,1,1986-06-28,1,0,0,0
Manuel Amoros,1,1,1986-06-28,1,0,0,1
José Luis Brown,1,1,1986-06-29,1,0,0,0
Neil Slatter,1,1,1986-09-10,0,1,0,0
Marius Lăcătuș,7,6,1995-10-11,4,3,0,2
Arnór Guðjohnsen,6,6,1997-10-11,5,1,0,0
Tengiz Sulakvelidze,1,1,1986-09-24,0,1,0,0
Johnny Ekström,9,7,1990-06-20,4,5,0,0
José Coelho,1,1,1986-10-12,1,0,0,0
Andreas Ogris,5,5,1995-06-11,3,2,0,0
Manfred Linzmaier,2,2,1987-04-01,2,0,0,0
Ivo Knoflíček,3,3,1987-11-11,2,1,0,0
Karel Kula,1,1,1986-10-15,1,0,0,0
Jens Jørn Bertelsen,1,1,1986-10-29,1,0,0,0
Ulf Kirsten,16,12,1999-06-04,9,7,0,0
Vagiz Khidiyatullin,1,1,1986-10-29,1,0,0,0
Georges Bregy,9,7,1994-06-18,6,3,0,2
Dejan Savićević,14,10,1999-09-05,10,4,0,1
Gary Mabbutt,1,1,1986-11-12,1,0,0,0
Imre Boda,3,3,1989-04-12,1,2,0,1
Míchel,17,13,1992-04-22,10,7,1,7
Roberto Donadoni,4,3,1993-10-13,4,0,0,0
Martin Weber,1,1,1986-11-15,0,1,0,0
Stig Fredriksson,1,1,1986-11-16,0,1,0,0
Pier Janssen,1,1,1986-11-19,1,0,0,0
Lachezar Tanev,5,4,1987-09-23,3,2,0,1
Shkëlqim Muça,1,1,1986-12-03,1,0,0,0
Juan Carlos Arteche,1,1,1986-12-03,0,1,0,0
Joaquín,3,3,2005-02-09,2,1,0,0
Evagoras Christofi,1,1,1986-12-03,1,0,0,0
Giorgos Savvidis,1,1,1986-12-03,1,0,0,0
Kostas Batsinilas,1,1,1986-12-03,0,1,0,0
Riccardo Ferri,1,1,1986-12-06,0,1,0,0
John Bosman,15,7,1997-04-30,9,6,0,0
Pavlos Savva,1,1,1987-01-14,0,1,0,0
Andreas Bonovas,1,1,1987-01-14,1,0,0,0
Salvatore Bagni,1,1,1987-01-24,1,0,0,0
Giuseppe Bergomi,1,1,1987-01-24,1,0,0,0
Gianluca Vialli,8,7,1992-12-19,7,1,0,0
Victor Pițurcă,2,2,1987-04-29,2,0,0,0
Sokol Kushta,9,8,1995-11-15,6,3,0,2
Adrian Bumbescu,1,1,1987-03-25,1,0,0,0
Jorge Plácido,2,1,1987-03-29,2,0,0,0
Dennis Mizzi,1,1,1987-03-29,0,1,0,0
Eloy Olaya,2,1,1987-04-01,0,2,0,0
Steve Hodge,1,1,1987-04-01,0,1,0,0
Glyn Hodges,1,1,1987-04-01,1,0,0,0
David Phillips,1,1,1987-04-01,1,0,0,0
Andy Jones,1,1,1987-04-01,1,0,0,0
Jan Mølby,2,2,1987-06-03,1,1,0,0
Carmelo Micciche,1,1,1987-04-29,1,0,0,0
Nicolae Ungureanu,1,1,1987-04-29,1,0,0,0
Ayan Sadakov,2,2,1988-11-02,0,2,0,0
Hristo Kolev,3,3,1988-10-19,2,1,0,0
Dariusz Marciniak,1,1,1987-05-17,0,1,0,0
István Vincze,4,4,1995-06-11,2,2,0,0
Zoltán Péter,1,1,1987-05-17,1,0,0,0
Tamás Preszeller,1,1,1987-05-17,1,0,0,0
Georgi Yordanov,1,1,1987-05-20,1,0,0,0
Tony Galvin,1,1,1987-05-28,0,1,0,0
Ronnie Whelan,3,3,1989-10-11,2,1,0,0
Ivan Hašek,5,5,1993-06-16,0,5,0,0
Thomas Doll,3,3,1991-10-16,1,2,0,0
Matthias Döschner,1,1,1987-06-03,0,1,0,0
Peter Larsson,3,3,1989-10-25,1,2,0,1
Per Edmund Mordt,1,1,1987-06-16,1,0,0,0
Jørn Andersen,2,2,1987-09-09,1,1,0,0
André Halter,1,1,1987-06-17,1,0,0,0
Luis Reyna,1,1,1987-06-27,0,1,0,0
Edú Marangón,1,1,1987-06-28,1,0,0,0
Zdenko Morovic,1,1,1987-06-28,1,0,1,0
Nelson Luís Kerchner,1,1,1987-06-28,1,0,0,0
Romário,33,23,2001-04-25,23,10,0,4
Jorge Contreras,2,2,1991-07-08,1,1,0,1
Sergio Salgado,1,1,1987-06-30,0,1,0,0
Claudio Caniggia,12,11,1994-06-25,8,4,0,0
Ivo Basay,5,3,1995-07-14,5,0,0,0
Eugenio La Rosa,3,2,1991-07-12,3,0,0,0
Bernardo Redín,3,3,1990-06-23,0,3,0,1
Fernando Astengo,2,2,1989-07-08,1,1,0,0
Jaime Vera,3,3,1991-07-14,3,0,0,0
Gabriel Jaime Gómez Jaramillo,1,1,1987-07-11,0,1,0,0
Juan Jairo Galeano,1,1,1987-07-11,0,1,0,0
Pablo Bengoechea,4,4,1996-12-15,2,2,0,0
Ismo Lius,1,1,1987-09-09,1,0,0,0
Petri Tiainen,1,1,1987-09-09,1,0,0,0
Armin Krings,1,1,1987-09-09,0,1,0,0
Paul McGrath,7,7,1995-09-06,4,3,0,0
Oleksiy Mykhaylychenko,6,6,1991-05-29,3,3,0,0
György Bognár,4,4,1991-05-01,1,3,0,1
Ryszard Tarasiewicz,5,4,1991-04-17,3,2,0,0
Marek Leśniak,5,4,1993-11-17,2,3,0,0
Ferenc Mészáros,2,2,1987-10-14,1,1,0,0
Neil Webb,2,2,1989-06-03,2,0,0,0
Philippe Fargeon,1,1,1987-10-14,1,0,0,0
Kevin Moran,2,2,1989-05-28,2,0,0,0
Ally McCoist,13,12,1996-06-18,10,3,0,0
Manuel Sanchís Hontiyuelo,1,1,1987-10-14,1,0,0,0
Faruk Hadžibegić,4,4,1989-10-11,3,1,0,3
Jan Kristian Fjærestad,1,1,1987-10-28,0,1,0,0
Ronald Spelbos,1,1,1987-10-28,1,0,0,0
John van 't Schip,1,1,1987-10-28,1,0,0,0
Marc Degryse,14,13,1996-08-31,10,4,0,0
Peter Crève,1,1,1987-11-11,1,0,0,0
Gary Mackay,1,1,1987-11-11,0,1,0,0
Michal Bílek,7,6,1990-06-15,5,2,0,3
Tony Adams,2,2,1988-06-18,1,1,0,0
Srečko Katanec,5,5,1990-10-31,3,2,0,0
Hans-Peter Zwicker,1,1,1987-11-15,0,1,0,0
José Mari Bakero,7,5,1993-02-24,6,1,0,0
Francisco Llorente Gento,1,1,1987-11-18,1,0,0,0
Giuseppe Giannini,2,2,1990-06-14,2,0,0,0
Luigi De Agostini,2,2,1988-06-17,2,0,0,0
Hans Gillhaus,2,1,1987-12-16,0,2,0,0
Yusuf Altıntaş,1,1,1987-12-16,1,0,0,0
Feyyaz Uçar,7,7,1993-04-28,3,4,0,1
Vita Lutonadio,1,1,1988-03-13,0,1,0,0
Ndubuisi Okosieme,1,1,1988-03-14,0,1,0,0
Eugène Kabongo,6,4,1992-10-11,3,3,0,0
Samuel Okwaraji,1,1,1988-03-17,0,1,0,0
Ayman Younes,1,1,1988-03-17,1,0,0,0
Abdelkader Ferhaoui,1,1,1988-03-19,1,0,0,0
Abdelrazak Belgharbi,1,1,1988-03-23,0,1,1,0
Rachid Maâtar,1,1,1988-03-23,1,0,0,0
Cyrille Makanaky,1,1,1988-03-23,0,1,0,0
Hassan Nader,2,2,1994-06-29,2,0,0,0
Steve Penney,1,1,1988-05-21,1,0,0,0
Ezzewdin Bezan,1,1,1988-06-03,1,0,0,0
Fawzi El-Aisawi,1,1,1988-06-03,1,0,0,1
Ayad El-Ghadi,1,1,1988-06-03,1,0,0,0
Roberto Mancini,4,3,1993-09-22,2,2,0,0
Flemming Povlsen,12,11,1994-09-07,7,5,0,0
Ray Houghton,6,6,1997-11-15,3,3,0,0
Jürgen Klinsmann,30,25,1998-06-29,19,11,0,2
Olaf Thon,1,1,1988-06-14,1,0,0,0
Viktor Pasulko,1,1,1988-06-18,0,1,0,0
Gabriel Gnimassou,1,1,1988-07-03,1,0,0,0
Jules Kadeba,1,1,1988-07-03,1,0,0,0
Sundayin Moriri,2,2,1988-07-30,1,1,0,0
Gilbert Chirwa,1,1,1988-07-30,1,0,0,0
Peterkins Kayira,3,3,1989-06-24,3,0,0,0
Lawrence Waya,1,1,1988-07-30,1,0,0,0
Nabil Maâloul,2,2,1989-06-25,2,0,0,1
Jameleddine Limam,5,4,1997-08-17,4,1,0,0
Kais Yâakoubi,1,1,1988-08-05,1,0,0,0
Abdoulaye Emmerson,2,1,1988-08-21,2,0,0,0
Camara Toure,1,1,1988-08-21,1,0,0,0
George Weah,7,7,2002-01-19,5,2,0,0
James Debbah,4,4,1996-06-23,3,1,0,1
Karl-Heinz Riedle,8,7,1994-06-27,3,5,0,0
Sigurður Grétarsson,1,1,1988-08-31,1,0,0,0
Jan Åge Fjørtoft,7,7,1995-06-07,5,2,0,0
Alain Sutter,4,4,1994-06-22,1,3,0,0
Kubilay Türkyilmaz,26,18,2001-09-05,15,11,0,8
Beat Sutter,1,1,1988-09-21,0,1,0,0
Guðmundur Torfason,1,1,1988-10-12,0,1,0,0
Ünal Karaman,1,1,1988-10-12,1,0,0,0
Jozef Chovanec,2,2,1992-09-02,0,2,1,0
Patrick Vervoort,3,3,1990-06-21,2,1,0,0
Krzysztof Warzycha,3,3,1996-11-10,2,1,0,1
Kari Ukkonen,2,2,1991-10-09,1,1,0,0
Dean Saunders,15,14,1999-09-04,8,7,0,1
Aki Lahtinen,1,1,1988-10-19,1,0,1,0
Mixu Paatelainen,13,9,1999-06-05,9,4,0,0
Daniel Xuereb,1,1,1988-10-22,0,1,0,0
Pambos Pittas,4,4,1996-12-14,4,0,0,3
Andreas Herzog,17,13,2002-09-07,13,4,0,5
Tanju Çolak,4,3,1989-04-12,2,2,0,0
Gøran Sørloth,8,6,1992-09-23,5,3,0,0
Kjetil Osvold,2,2,1989-05-21,1,1,0,0
Lars Elstrup,3,3,1992-06-17,2,1,0,0
Ioan Sabău,3,3,1990-12-05,3,0,0,0
Ylli Shehu,1,1,1988-11-05,1,0,0,0
Hans Holmqvist,1,1,1988-11-05,0,1,0,0
Osama Idris,1,1,1988-11-11,1,0,0,0
José Vieira Dias Paulino do Carmo,1,1,1988-11-11,0,1,0,0
Mavango Kiala,1,1,1988-11-11,0,1,0,0
Manolo,5,4,1989-11-15,4,1,0,0
Christian Perez,1,1,1988-11-19,0,1,0,0
Predrag Spasić,1,1,1988-11-19,1,0,0,0
Franck Sauzée,6,5,1993-10-13,4,2,0,0
Ravuame Madigi,1,1,1988-11-26,1,0,0,0
Oğuz Çetin,2,2,1997-08-20,2,0,0,0
Karim Bavi,3,3,1989-02-27,0,3,0,0
Farshad Pious,6,5,1992-10-30,4,2,0,0
Saleh Al-Mutlaq,1,1,1988-12-02,0,1,0,0
Mohamed Al-Suwaiyed Shehrani,1,1,1988-12-02,0,1,0,0
Charlie Yankos,4,3,1989-03-19,3,1,0,1
Warren Spink,1,1,1988-12-03,1,0,0,0
Paul Trimboli,11,8,2002-07-10,10,1,0,0
Loten Dalai,1,1,1988-12-03,0,1,0,0
Gao Sheng,1,1,1988-12-04,1,0,0,0
Xie Yuxin,4,3,1992-11-06,2,2,0,0
Muhsin Musabah,1,1,1988-12-05,1,0,1,0
Hassan Mohamed,1,1,1988-12-05,0,1,0,0
Zhang Xiaowen,2,2,1989-07-15,1,1,0,0
Hwang Sun-hong,17,14,2002-06-04,13,4,0,0
Walid Al-Nasser,2,2,1989-03-15,1,1,0,0
Fayad Mahmoud,1,1,1988-12-09,0,1,0,1
Yousuf Jazea'a,1,1,1988-12-09,1,0,0,0
Ma Lin,8,6,1989-10-28,1,7,0,0
Adel Abbas Hussain,1,1,1988-12-10,1,0,0,1
Mansour Basha Mohamed,1,1,1988-12-10,1,0,0,0
Abdulaziz Mohamed,3,3,1989-02-10,2,1,0,0
Billy Wright,6,5,1992-06-07,6,0,0,0
Darren McClennan,8,4,1992-07-01,6,2,0,0
Noel Barkley,1,1,1988-12-11,1,0,0,0
Danny Halligan,3,3,1992-06-27,2,1,0,1
Fahad Al-Bishi,7,6,1992-11-06,5,2,0,2
Adel Khamis,3,2,1997-10-24,2,1,0,0
Mai Chao,5,4,1989-10-12,3,2,0,2
Garry Lund,1,1,1988-12-15,0,1,1,0
Anton Rogan,1,1,1988-12-21,1,0,1,0
Alan McDonald,3,3,1993-02-17,1,2,1,0
Mohamed Ala'a,1,1,1989-01-06,1,0,0,0
Mohamed El-Akad,1,1,1989-01-06,1,0,0,0
Mohamed Ali Hamoud,1,1,1989-01-06,1,0,0,0
Abdulaziz Al-Hajeri,1,1,1989-01-06,0,1,0,0
Mahmoud Yaseen Al-Soufi,6,5,1989-10-28,5,1,0,0
Singo McDonald,1,1,1989-01-07,0,1,0,0
Peter Dawo,1,1,1989-01-07,1,0,0,0
Wole Odegbami,1,1,1989-01-07,1,0,0,0
Osvaldo de Oliveira,2,2,1989-01-22,1,1,0,0
N'Kiambi Mapuata,2,1,1989-01-08,2,0,0,0
Nkiere Wawa,1,1,1989-01-08,1,0,0,0
Sékou Bamba,2,2,1989-08-13,2,0,0,0
Habib Jafar,3,3,2001-04-14,2,1,0,0
Fahad Yousef Al-Sovayed,1,1,1989-01-13,1,0,0,0
Zuhair Bakheet,7,6,2001-08-17,4,3,0,0
Mohamed Al-Diabaz,2,1,1989-01-20,2,0,0,0
Abdul Razaq Ibrahim,3,2,1989-02-10,2,1,0,0
Khalid Ismaïl,4,4,1992-11-08,1,3,0,0
Abdulrahman Mohamed,1,1,1989-01-20,1,0,0,0
Abdel Rasoul Hesham,3,3,1989-08-26,2,1,0,0
Paulino Vieira Dias,1,1,1989-01-22,1,0,0,0
Michael Obiku,1,1,1989-01-22,0,1,0,0
François Omam-Biyik,11,10,1996-01-24,6,5,0,1
Régis Manon,1,1,1989-01-22,1,0,0,0
Emile Mbouh,2,2,1989-08-13,1,1,0,0
Txiki Begiristain,5,4,1994-07-02,4,1,0,1
Lasaad Abdelli,1,1,1989-01-22,1,0,0,0
Witson Nyirenda,1,1,1989-01-22,1,0,0,0
Derby Makinka,2,2,1989-06-11,2,0,0,0
Natiq Hashim,1,1,1989-01-27,1,0,0,0
Nasser Khaleefa,1,1,1989-01-27,0,1,0,0
Khaled Awad,2,2,1989-02-10,1,1,0,0
Ali Al-Hadyah,2,1,1989-01-27,2,0,0,0
Jumah Salem Joher,1,1,1989-02-03,1,0,0,0
Christos Kolliandris,2,2,1989-05-21,1,1,0,0
Yiannos Ioannou,4,3,1997-09-07,2,2,0,0
Richard Gough,3,2,1991-11-13,1,2,0,0
Genar Andrinúa,1,1,1989-02-08,0,1,0,0
Saleh Eid Al-Mehaizaa,1,1,1989-02-10,0,1,0,0
Adel Mubarak Khamis,1,1,1989-02-10,0,1,0,0
Ali Sharafat,1,1,1989-02-10,1,0,0,0
Vítor Paneira,3,3,1991-02-20,3,0,0,1
Marc Van Der Linden,7,3,1989-09-06,2,5,0,0
Wang Baoshan,2,2,1989-03-04,1,1,0,0
Sirous Ghayeghran,2,2,1992-10-30,0,2,0,0
Mohsen Garousi,3,3,1989-07-22,2,1,0,0
Mohammad Hassan Ansarifard,1,1,1989-02-27,0,1,0,0
Sheikh Mohammad Aslam,1,1,1989-02-27,1,0,0,0
Tang Yaodong,2,2,1989-10-17,1,1,0,0
Ronny Rosenthal,7,7,1995-04-25,3,4,0,0
Khandoker Wasim Iqbal,1,1,1989-03-08,1,0,0,0
Sabbir,2,2,1993-05-05,2,0,0,0
Badal Das,1,1,1989-03-08,1,0,0,0
Prasert Changmool,1,1,1989-03-08,0,1,0,0
Mohammad Jakalan,1,1,1989-03-15,0,1,0,0
Yousuf Al-Thunayan,8,7,1998-06-24,7,1,0,1
Abdul Latif Helou,4,3,1993-07-02,2,2,0,0
Samad Marfavi,1,1,1989-03-17,1,0,0,0
Ahmed Jamil Madani,3,3,1993-10-22,1,2,0,0
Róger Flores,2,2,1990-06-20,1,1,0,0
Julio Rodas,4,3,1996-12-08,2,2,0,0
Nir Klinger,1,1,1989-04-09,0,1,0,0
Rıdvan Dilmen,3,2,1989-10-25,2,1,0,0
Gilberto Rhoden,1,1,1989-04-16,1,0,0,0
Brian Laudrup,16,15,1998-07-03,9,7,0,0
Paul Gascoigne,8,7,1997-09-10,6,2,0,0
Michael O'Neill,4,3,1995-11-15,2,2,0,0
João Domingos Pinto,4,4,1994-12-18,4,0,0,0
Dario Zuffi,1,1,1989-04-26,0,1,0,0
Igor Dobrovolski,6,6,1995-06-07,4,2,0,3
Floros Nicolaou,1,1,1989-04-26,0,1,0,0
Tab Ramos,3,3,2000-08-16,3,0,0,0
Roger Ljung,2,2,1994-06-19,1,1,0,0
Niclas Nyhlén,1,1,1989-05-07,1,0,0,0
Tomáš Skuhravý,13,9,1995-09-06,9,4,0,1
Steve Trittschuh,1,1,1989-05-13,1,0,0,0
Hutson Charles,3,3,1992-07-05,1,2,0,0
Kostas Mavridis,1,1,1989-05-17,0,1,0,0
Jan Bartram,2,2,1990-10-17,1,1,0,1
Kent Nielsen,2,2,1989-10-11,2,0,0,0
Kim Vilfort,11,10,1995-10-11,8,3,0,0
Henrik Andersen,1,1,1989-05-17,1,0,0,0
Gheorghe Popescu,13,8,2001-10-06,8,5,0,1
Rune Bratseth,2,2,1989-09-05,2,0,0,0
Azizol Abu Haniffah,4,3,1993-05-18,3,1,0,0
Chung Yong-Hwan,1,1,1989-05-25,1,0,0,0
Choi Sang-Kuk,2,1,1989-05-25,2,0,0,0
Kim Yong-Se,4,3,1989-06-07,2,2,0,0
Lee Young-jin,1,1,1989-05-25,1,0,0,0
Noh Soo-Jin,3,2,1989-06-07,1,2,0,0
Kim Kwang-min,4,4,1993-10-15,1,3,0,1
Tak Yong-Bin,1,1,1989-05-27,0,1,0,0
Leslie Santos,1,1,1989-05-27,1,0,0,1
Hussein Ahmad Satter,2,1,1989-05-27,2,0,0,0
Tay Peng Kee,1,1,1989-05-27,1,0,0,0
Philibert Jones,2,2,1989-09-03,2,0,0,0
Lee Hak-Jong,1,1,1989-06-03,0,1,0,0
Park Kyung-Hoon,1,1,1989-06-03,0,1,0,0
Lim Teong Kim,1,1,1989-06-03,0,1,0,0
Arj Changatamilman,1,1,1989-06-03,1,0,0,0
Salim Moin,2,2,1989-06-05,2,0,0,0
Tim Bredbury,2,2,1989-07-02,1,1,0,0
Mustamu Yessy,1,1,1989-06-04,0,1,0,0
Oh Yong-Nam,1,1,1989-06-04,1,0,1,0
Tony Cascarino,13,10,1997-10-11,8,5,0,0
Hwangbo Kwan,5,5,1993-06-07,2,3,0,0
Darimosuvito Tokijan,4,1,1989-06-05,4,0,0,0
Darimosuvito Devaraj,2,1,1989-06-05,2,0,0,0
Kurapiah Gunalan,1,1,1989-06-07,1,0,0,0
Samson Siasia,6,6,1995-01-06,2,4,0,0
Joseph Maluka,2,1,1989-06-11,2,0,0,0
Juan Cayasso,6,5,1993-07-18,4,2,0,0
Takumi Horiike,2,2,1993-04-28,1,1,0,0
Osamu Maeda,1,1,1989-06-11,1,0,0,0
Katsuyoshi Shinto,1,1,1989-06-11,1,0,0,0
Kenta Hasegawa,1,1,1989-06-11,1,0,0,0
Hisashi Kurosaki,1,1,1989-06-11,1,0,0,0
Bruce Murray,6,5,1992-10-19,5,1,0,0
Eric Eichmann,1,1,1989-06-17,1,0,0,0
Paulo António Alves,10,8,2000-04-23,8,2,0,1
Jaime Rodriguez,1,1,1989-06-25,1,0,0,0
Carlos Hidalgo,1,1,1989-06-25,0,1,0,0
Leonidas Flores,3,2,1991-06-29,1,2,0,0
José Maria Rivas,1,1,1989-06-25,1,0,0,0
Nicaise Ondeno,1,1,1989-06-25,1,0,0,0
Michel Minko,1,1,1989-06-25,1,0,0,0
Nang Yan Leung,2,1,1989-06-25,0,2,0,0
Mustaqim,1,1,1989-06-25,1,0,0,0
Kim Pung-Il,3,3,1989-10-20,3,0,0,0
Ri Hyok-chon,2,2,1989-07-02,2,0,0,0
Charly Musonda,2,2,1993-01-20,2,0,0,1
Stanley Ndunduma,1,1,1989-06-25,1,0,0,0
Bebeto,19,14,1998-07-03,13,6,0,0
Geovani Faria da Silva,1,1,1989-07-01,1,0,0,1
Baltazar Maria de Morais Júnior,1,1,1989-07-01,1,0,0,0
Carlos Maldonado,4,3,1989-07-05,2,2,0,0
Adolfino Cañete,2,1,1989-07-01,2,0,0,0
Gustavo Neffa,4,4,1991-07-10,3,1,0,0
José del Solar,12,11,2001-07-12,5,7,3,3
Juan Reynoso Guzmán,4,4,1996-11-10,3,1,0,0
Chu Gyong-Sik,3,3,1989-10-20,3,0,0,0
Ermen Benítez,1,1,1989-07-02,0,1,0,0
René Higuita,2,2,1995-07-13,1,1,1,1
Antony de Ávila,7,7,1997-08-20,4,3,0,0
Santiago Ostolaza,3,2,1993-06-16,3,0,0,0
Rubén Sosa,11,9,1993-09-05,5,6,0,0
Juvenal Olmos,2,2,1989-07-10,1,1,0,0
Jaime Patricio Ramírez,1,1,1989-07-08,0,1,0,0
Jaime Pizarro,1,1,1989-07-08,0,1,0,1
Óscar Reyes,1,1,1989-07-08,0,1,0,0
Inyong Lolumbuman,1,1,1989-07-09,0,1,0,0
Ney Avilés,6,5,1993-06-26,3,3,0,0
Pastor Fernández,1,1,1989-07-16,1,0,0,0
Sayed Ali Eftekhari,1,1,1989-07-22,1,0,0,0
Leonson Lewis,5,4,1992-05-31,4,1,0,0
Branco,5,5,1994-07-09,1,4,0,1
Ildemaro Fernández,1,1,1989-08-06,1,0,0,0
Iván Zamorano,25,18,2000-08-15,19,6,0,5
George Onyango,1,1,1989-08-12,1,0,0,0
Guy Roger Nzamba,5,4,1993-01-17,3,2,0,0
Hugo González,1,1,1989-08-13,0,1,1,0
Jean-Pierre Guede Akenon,1,1,1989-08-13,1,0,0,1
Yao Lambert Amani,1,1,1989-08-13,1,0,0,0
William Ramallo,1,1,1989-08-20,1,0,0,0
Paulo Silas,1,1,1989-08-20,1,0,0,0
Kerry Jamerson,3,3,1992-05-31,2,1,0,0
Heimo Pfeifenberger,6,6,1997-09-10,5,1,0,0
Ragnar Margeirsson,1,1,1989-08-23,0,1,0,0
Manfred Zsak,1,1,1989-08-23,1,0,0,0
Ibrahim Hassan,2,2,1996-11-08,2,0,0,0
Joel Minko,1,1,1989-08-27,1,0,0,0
Kuyangana Makukula,1,1,1989-08-27,0,1,0,0
Mohamed Madih,1,1,1989-08-27,1,0,0,0
Javier Ferreira,2,2,1989-09-10,2,0,0,0
José Luis Chilavert,8,8,2001-10-07,5,3,0,5
Mohamed Ali Mahjoubi,3,3,1993-01-31,3,0,0,0
Álvaro Peña,2,2,1993-07-25,2,0,0,0
Matthias Sammer,6,5,1996-06-23,4,2,0,0
Kálmán Kovács,4,3,1992-09-09,1,3,0,0
Gordon Durie,5,5,1997-10-11,2,3,0,0
Gary Gillespie,1,1,1989-09-06,1,0,1,0
Raúl Avilés,2,2,1989-09-24,1,1,0,0
Tito Montaño,1,1,1989-09-10,0,1,0,0
Andrés Aurelio González,1,1,1989-09-10,1,0,0,0
Erwin Sánchez,13,11,2000-04-26,9,4,0,1
Rubén Darío Hernández,1,1,1989-09-17,1,0,0,0
Hugo Pérez,2,2,1991-07-03,1,1,0,1
Paulo Futre,5,5,1993-11-10,2,3,0,1
Rui Águas,9,8,1993-11-10,3,6,0,0
Álex Aguinaga,15,14,2002-01-22,8,7,0,1
Pietro Marsetti,1,1,1989-09-24,1,0,0,0
Andreas Möller,9,7,1998-06-15,9,0,0,0
Klas Ingesson,4,4,1994-09-07,1,3,0,1
Leif Engqvist,1,1,1989-10-08,1,0,0,0
Trifon Ivanov,5,5,1997-09-10,2,3,0,0
Kalin Bankov,1,1,1989-10-11,1,0,0,0
Hristo Stoichkov,28,24,1999-03-31,17,11,0,13
Didier Deschamps,2,2,1989-11-18,2,0,0,0
Eric Cantona,10,8,1993-11-17,8,2,0,1
Jean-Philippe Durand,1,1,1989-10-11,1,0,0,0
Attila Pintér,2,1,1989-10-11,2,0,0,0
Rui Barros,3,2,1993-04-28,2,1,0,0
Adrian Knup,15,10,1995-08-16,6,9,0,1
Graeme Rutjes,1,1,1989-10-11,0,1,0,0
Mark Bowen,2,2,1992-09-09,2,0,0,0
Albeiro Usuriaga,1,1,1989-10-15,1,0,0,0
Mohammed Al-Suwaiti,1,1,1989-10-16,0,1,0,0
Khaleel Mubarak,2,2,1989-10-24,1,1,0,0
Mansour Sulaiti,1,1,1989-10-24,0,1,0,0
Bruno Versavel,3,3,1995-06-07,1,2,0,0
Ľubomír Moravčík,6,6,1998-09-05,3,3,0,0
Vujadin Stanojković,1,1,1989-10-28,0,1,0,0
Darko Pančev,13,7,1991-05-16,11,2,0,0
Fahad Al-Musaibeah,1,1,1989-10-28,1,0,0,0
Saado Al-Suwaiti,1,1,1989-10-28,1,0,0,0
Jacek Ziober,1,1,1989-11-15,0,1,0,0
Malcolm Allen,1,1,1989-11-15,0,1,0,0
Thomas Häßler,8,7,1997-09-10,4,4,0,0
Nikos Nioplias,1,1,1989-11-15,1,0,0,0
John Aldridge,17,10,1995-10-11,10,7,0,4
Gavril Balint,8,5,1992-05-20,6,2,0,0
Erland Johnsen,1,1,1989-11-15,0,1,0,0
Juan Francisco Rodríguez Herrera,1,1,1989-11-15,1,0,0,0
Fernando Gómez Colomer,1,1,1989-11-15,1,0,0,0
Christophe Bonvin,1,1,1989-11-15,1,0,0,0
Hossam Hassan,20,13,2006-02-03,11,9,0,2
Laurent Blanc,9,8,2000-06-11,6,3,0,0
Emmanuel Okocha,1,1,1990-03-02,0,1,0,0
Djamel Amani,3,3,1990-03-12,3,0,0,0
Serge Maguy,1,1,1990-03-02,1,0,0,0
Adel Abdelrahman,1,1,1990-03-02,0,1,0,0
Webster Chikabala,2,2,1990-03-15,0,2,0,0
Tahar Chérif El-Ouazzani,1,1,1990-03-05,1,0,0,0
Chérif Oudjani,2,2,1990-03-16,2,0,0,0
Mamadou Diallo,5,5,2009-06-21,3,2,0,0
Moussa N'Dao,1,1,1990-03-06,0,1,0,0
Linos Makwaza,1,1,1990-03-06,1,0,0,0
Moussa Saïb,2,2,1998-02-11,1,1,0,1
Emmanuel Maboang,4,3,1993-10-10,4,0,0,0
Abdelhakim Serrar,1,1,1990-03-12,0,1,1,0
Uche Okechukwu,1,1,1990-03-12,1,0,0,0
Salvatore Schillaci,7,7,1991-06-05,6,1,0,1
Tomas Brolin,12,10,1995-06-01,10,2,0,3
Davor Jozić,2,2,1990-06-14,1,1,0,0
Michel De Wolf,1,1,1990-06-12,1,0,0,0
Pedro Troglio,1,1,1990-06-13,1,0,0,0
Uwe Bein,2,2,1990-10-31,1,1,0,0
Müller,5,5,1993-08-29,5,0,0,0
Stuart McCall,1,1,1990-06-16,0,1,0,0
Lei Clijsters,1,1,1990-06-17,1,0,0,0
Pedro Monzón,1,1,1990-06-18,1,0,0,0
Andrei Zygmantovich,1,1,1990-06-18,0,1,0,0
Gerhard Rodax,1,1,1990-06-19,1,0,0,0
Freddy Rincón,11,10,1996-11-10,3,8,0,0
Roberto Baggio,17,14,1998-06-23,9,8,0,4
Ali Thani Jumaa,2,2,1993-04-08,0,2,0,0
Robert Prosinečki,10,9,2001-09-05,5,5,0,1
Hernán Medford,12,12,2002-01-18,5,7,0,1
Alberto Górriz,1,1,1990-06-21,0,1,0,0
Mark Wright,1,1,1990-06-21,1,0,0,0
Niall Quinn,14,12,2001-10-06,10,4,0,0
Daniel Fonseca,5,5,1995-07-16,4,1,0,0
Rónald González Brenes,3,3,1997-06-13,1,2,1,0
Luboš Kubík,4,4,1996-09-18,3,1,0,0
Aldo Serena,3,2,1990-12-22,1,2,0,0
David Platt,12,9,1993-04-28,7,5,0,0
Eugène Ekéké,1,1,1990-07-01,1,0,0,0
Torkil Nielsen,1,1,1990-09-12,1,0,0,0
Andrei Kanchelskis,5,5,1996-11-10,3,2,0,0
Oleh Kuznetsov,1,1,1990-09-12,1,0,0,0
Marc Hottiger,4,4,1995-04-26,4,0,0,0
Thomas Bickel,4,4,1994-12-14,3,1,0,0
Allan Mørkøre,1,1,1990-10-10,0,1,0,0
Carlos Muñoz Cobo,4,3,1990-12-19,3,1,0,0
Sigurður Jónsson,3,3,1997-08-20,1,2,0,0
László Disztl,1,1,1990-10-17,1,0,0,0
David O'Leary,1,1,1990-10-17,1,0,0,0
Nikolay Todorov,3,2,1990-11-14,1,2,0,0
Gary McAllister,3,3,1997-06-08,2,1,0,2
Nikos Tsiantakis,1,1,1990-10-31,1,0,0,0
Vassilis Karapialis,1,1,1990-10-31,1,0,0,0
Stefanos Borbokis,3,3,1991-10-30,3,0,0,0
Emil Lőrincz,2,1,1990-10-31,2,0,0,0
Panayiotis Xiourouppas,2,2,1993-04-25,1,1,0,0
Angelos Tsolakis,1,1,1990-10-31,0,1,0,0
Jean-Paul Girres,1,1,1990-10-31,1,0,0,0
Lars Bohinen,5,5,1994-11-16,2,3,0,0
Sverre Brandhaug,1,1,1990-11-14,0,1,0,0
Roberto Fernández Bonillo,1,1,1990-11-14,0,1,0,0
Robert Jarni,2,2,1998-07-04,0,2,0,0
Stéphane Chapuisat,17,15,2002-09-08,10,7,0,0
Frédéric Chassot,1,1,1990-11-14,0,1,0,0
Basile Boli,1,1,1990-11-17,0,1,0,0
Dennis Bergkamp,27,22,1998-07-04,15,12,0,1
Hubert Suda,2,2,1998-10-10,2,0,0,1
Erik Holmgren,2,2,1991-06-05,1,1,0,0
Florin Răducioiu,21,13,1996-06-18,7,14,0,2
Ioan Lupescu,4,3,1992-05-20,4,0,0,0
Pavel Badea,1,1,1990-12-05,1,0,0,0
Dan Petrescu,8,8,1998-06-22,6,2,0,0
Aron Winter,4,4,1997-04-30,2,2,0,0
Guillermo Amor,4,4,1997-09-24,2,2,0,0
Fernando Hierro,26,25,2002-06-07,20,6,1,10
Pietro Vierchowod,2,2,1993-03-24,1,1,0,0
Attilio Lombardo,2,2,1995-03-29,0,2,0,0
Stelios Manolas,1,1,1991-01-23,1,0,0,0
Panagiotis Tsalouchidis,7,6,1995-10-11,1,6,0,0
José Leal,1,1,1991-02-20,1,0,0,0
Charles Scerri,1,1,1991-02-20,1,0,1,0
Jorge Cadete,5,4,1995-11-15,5,0,0,0
Lee Dixon,1,1,1991-03-27,1,0,0,0
Valdes Pasolini,1,1,1991-03-27,1,0,0,1
Ivan Matteoni,1,1,1991-03-27,0,1,1,0
John Collins,10,9,1999-10-05,5,5,0,2
Emil Kostadinov,20,15,1998-06-24,10,10,0,0
Dragiša Binić,1,1,1991-03-27,1,0,0,0
Colin Hill,1,1,1991-03-27,0,1,0,0
Hysen Zmijani,3,3,1994-11-16,2,1,1,0
József Szalma,1,1,1991-04-03,0,1,0,0
Roman Kosecki,4,4,1995-06-07,3,1,0,0
Pavel Kuka,13,11,2001-06-06,8,5,0,0
Kári Reynheim,1,1,1991-05-01,0,1,0,0
Pål Lydersen,1,1,1991-05-01,1,0,0,1
Tore André Dahlum,2,2,1991-06-05,2,0,0,0
Dennis Wise,1,1,1991-05-01,0,1,0,0
Bent Christensen Arensøe,6,4,1991-10-09,2,4,0,0
Petri Järvinen,2,2,1992-11-14,1,1,0,0
Jari Litmanen,18,16,2010-11-17,8,10,0,4
Ilija Najdoski,1,1,1991-05-16,1,0,0,0
Zoran Vulić,1,1,1991-05-16,1,0,0,0
Zvonimir Boban,9,7,1998-10-14,9,0,0,0
Davor Šuker,32,26,2001-06-02,15,17,0,6
Michael Streiter,1,1,1991-05-22,1,0,0,0
Arnold Wetl,3,3,1999-03-27,2,1,1,0
Lyuboslav Penev,9,7,1997-08-20,7,2,1,0
Eduard Abazi,1,1,1991-05-26,1,0,0,0
Aleksandr Mostovoi,7,7,2003-09-10,5,2,0,1
Igor Korneev,1,1,1991-05-29,1,0,0,0
Ernst Ogris,1,1,1991-06-05,0,1,0,0
Frank de Boer,8,7,2003-11-19,6,2,0,1
Christophe Ohrel,6,6,1995-10-11,4,2,0,0
Eduardo Bennett,12,9,1996-11-17,9,3,0,5
Juan Carlos Espinoza,1,1,1991-06-28,0,1,0,0
Luis Enrique Cálix,3,2,1991-06-30,0,3,0,0
Eugenio Dolmo Flores,3,3,1992-11-08,1,2,0,0
Benjamín Galindo,13,10,1997-11-09,11,2,0,6
Luís Roberto Alves,21,14,1997-10-05,18,3,0,1
Roderick Reid,3,3,1992-11-08,2,1,0,0
Carlos Hermosillo,18,12,1997-11-09,15,3,0,0
Róger Gómez,1,1,1991-06-29,1,0,0,0
Marcelo Balboa,4,4,1996-01-18,3,1,1,0
José Manuel de la Torre,3,3,1992-11-22,2,1,0,0
Jamie Lowery,1,1,1991-06-30,1,0,0,0
Marco Antonio Anariba,3,3,1993-05-09,0,3,0,1
Gilberto Yearwood,1,1,1991-06-30,0,1,0,0
Alvin Thomas,1,1,1991-07-01,1,0,0,0
Brian Quinn,1,1,1991-07-01,1,0,0,0
Eric Wynalda,19,17,2000-02-12,17,2,0,3
Hector Wright,6,5,1993-07-22,4,2,0,1
Colin Miller,3,3,1992-11-08,1,2,0,0
John Limniatis,1,1,1991-07-02,0,1,0,0
Luis Espel,1,1,1991-07-03,0,1,0,0
Peter Vermes,2,2,1991-07-05,2,0,0,0
Juan Carlos Arguedas,3,2,1992-08-23,2,1,0,0
Claudio Jara,1,1,1991-07-03,0,1,0,0
Héctor Marchena,1,1,1991-07-03,1,0,1,0
John Doyle,1,1,1991-07-05,1,0,0,0
Luis Monzón,4,3,1993-06-21,4,0,0,1
Berthy Suárez,3,3,1997-09-10,2,1,0,0
Ramón Víctor Castro,1,1,1991-07-07,0,1,0,0
Gonzalo Farfán,1,1,1991-07-07,1,0,0,0
Gabriel Batistuta,37,27,2002-06-02,28,9,0,7
Flavio Maestri,5,5,2004-07-12,3,2,0,0
Neto,1,1,1991-07-09,0,1,0,1
Peter Méndez,3,3,1991-07-15,0,3,0,1
Carlos Guirland,1,1,1991-07-10,1,0,0,0
Vidal Sanabria,1,1,1991-07-10,1,0,0,0
João Paulo,2,2,1991-07-17,1,1,0,0
Diego Simeone,8,8,1999-07-01,6,2,0,0
Leonardo Astrada,1,1,1991-07-12,1,0,0,0
José Cardozo,18,15,2005-03-30,11,7,0,2
Robert Cavallo,1,1,1991-07-12,1,0,1,0
Erwin Ramírez,1,1,1991-07-13,0,1,0,1
Diego Latorre,1,1,1991-07-14,1,0,0,0
Alfonso Yáñez,1,1,1991-07-14,0,1,0,1
Néstor Craviotto,2,2,1993-02-24,1,1,1,0
Claudio García,1,1,1991-07-14,1,0,0,0
Fabián Estay,3,3,2000-08-15,3,0,0,0
Mazinho Oliveira,2,2,1991-07-21,1,1,0,0
Carlos Muñoz,3,3,1993-08-08,2,1,0,0
Márcio Santos,1,1,1991-07-15,1,0,0,0
Luís Henrique,2,2,1991-07-21,1,1,0,0
Darío Franco,2,1,1991-07-17,2,0,0,0
Václav Němeček,5,5,1995-04-26,3,2,0,1
Kevin Wilson,4,4,1993-04-28,2,2,0,0
César Brito,1,1,1991-09-11,1,0,0,0
Kim Christofte,1,1,1991-09-25,0,1,0,1
Frank Pingel,5,4,1993-09-08,3,2,0,0
Þorvaldur Örlygsson,2,2,1992-06-03,1,1,0,0
Eyjólfur Sverrisson,9,8,2001-09-01,6,3,0,0
Igor Shalimov,4,4,1995-09-06,1,3,0,1
Peter Artner,1,1,1991-10-09,0,1,1,0
Abelardo Fernández,2,2,1991-11-13,2,0,0,0
Zlatko Yankov,2,2,1993-04-28,2,0,0,0
Nikolay Iliev,1,1,1991-10-16,1,0,0,0
Ľudovít Lancz,1,1,1991-10-16,1,0,0,0
Alan Smith,1,1,1991-10-16,1,0,0,0
Vladimir Jugović,3,3,1997-10-11,0,3,0,0
Paul Bodin,2,2,1991-11-13,1,1,0,2
Richard Witschge,1,1,1991-10-16,1,0,0,0
Iain Dowie,11,10,1998-11-18,7,4,0,3
Kingsley Black,1,1,1991-10-16,1,0,0,0
Leo Lainer,1,1,1991-10-16,0,1,0,0
Piotr Czachowski,1,1,1991-10-16,1,0,0,0
Andy Townsend,4,4,1996-08-31,1,3,0,0
Jan Furtok,2,2,1993-04-28,2,0,0,0
Jan Urban,1,1,1991-10-16,1,0,0,0
Vladan Lukić,1,1,1991-11-13,0,1,0,0
Sergei Yuran,5,5,1997-10-11,4,1,0,0
Gerry Taggart,4,4,1996-11-09,1,3,0,0
Mini Jakobsen,4,4,1995-04-26,2,2,0,0
Ruggiero Rizzitelli,1,1,1991-11-13,1,0,0,0
Roman Szewczyk,1,1,1991-11-13,1,0,0,0
John Byrne,2,1,1991-11-13,0,2,0,0
Rıza Çalımbay,1,1,1991-11-13,1,0,0,1
Urmas Kirs,3,3,1998-06-04,2,1,1,0
Stanislovas Vitkovskis,1,1,1991-11-15,1,0,0,0
Tomas Ramelis,4,4,1999-09-08,2,2,0,0
Valdas Urbonas,1,1,1991-11-15,1,0,0,1
Darius Magdišauskas,1,1,1991-11-15,1,0,0,0
Dzintars Sproģis,1,1,1991-11-16,0,1,0,0
Igors Troickis,1,1,1991-11-16,0,1,0,0
Vitalijs Teplovs,2,2,1992-07-12,1,1,0,0
Aurelijus Skarbalius,3,3,1995-05-20,1,2,0,0
Adrian Popescu,1,1,1991-11-20,0,1,0,0
Amara Simba,1,1,1991-11-20,1,0,0,0
João Vieira Pinto,18,12,2001-10-06,12,6,0,0
Danny Blind,1,1,1991-12-04,0,1,0,0
Guido Buchwald,1,1,1991-12-18,1,0,0,0
Stefan Sultana,2,2,1997-04-30,2,0,0,0
Petros Marinakis,1,1,1991-12-22,0,1,0,0
Ben Badi,1,1,1992-01-13,0,1,0,0
Said Rokbi,1,1,1992-01-14,1,0,0,0
Andre Kona N'Gole,1,1,1992-01-14,0,1,0,0
Mickey Weche,1,1,1992-01-14,0,1,0,1
Abedi Pele,8,8,1996-11-10,3,5,0,0
Tueba Menayane,1,1,1992-01-16,0,1,0,0
Souleyman Sané,5,4,1993-07-17,4,1,0,0
Victor Diagne,1,1,1992-01-16,1,0,0,0
Pierre Tchibota,2,2,1992-01-20,0,2,0,0
Nacer Bouiche,1,1,1992-01-17,1,0,0,0
Tony Yeboah,4,4,1996-01-28,2,2,0,0
Anthony Yeboah,1,1,1992-01-20,1,0,0,0
Donald-Olivier Sié,4,4,2000-01-31,2,2,0,0
Mutiu Adepoju,5,5,1998-06-13,2,3,0,0
Prince Polley,1,1,1992-01-23,0,1,0,0
Friday Ekpo,1,1,1992-01-25,0,1,0,0
Marcos Lugris,2,2,1996-05-04,1,1,0,1
Ramiro Borja,1,1,1992-03-21,0,1,0,0
Dinardo Rodríguez,4,4,1996-03-31,2,2,0,1
Earl Jean,5,4,2004-03-28,3,2,0,0
Franco Paonessa,1,1,1992-03-29,1,0,0,0
Curtis Joseph,2,2,1992-08-30,2,0,0,0
Rodney Jack,10,6,2004-09-10,8,2,0,0
Alphonsus Brown,1,1,1992-03-29,1,0,0,0
Russell Latapy,12,10,2008-10-15,9,3,0,0
Tyrone White,1,1,1992-04-19,1,0,0,0
Quentin Clarke,3,3,2004-02-18,1,2,0,0
Giovanni Regales,1,1,1992-04-19,1,0,0,0
Marc Wilmots,18,14,2002-06-14,9,9,0,2
Antonhy Stanton,1,1,1992-04-24,1,0,0,0
Stanley Simson,1,1,1992-04-24,0,1,0,0
Marciano Leyman,1,1,1992-04-24,0,1,0,0
Derrick Edwards,6,3,1996-03-31,4,2,0,0
Shaun Goater,10,7,2000-03-05,3,7,0,1
Arminas Narbekovas,2,2,1996-10-09,1,1,0,0
Robertas Fridrikas,2,2,1992-10-28,1,1,0,0
Constantin Pană,1,1,1992-05-06,1,0,0,0
Panagiotis Sofianopoulos,1,1,1992-05-13,1,0,0,0
Krasimir Balakov,11,11,2002-10-16,6,5,0,4
Andre Espinoza,1,1,1992-05-23,0,1,0,0
Ricardo Hyde,1,1,1992-05-23,1,0,0,0
Linnal Wilson,1,1,1992-05-23,1,0,0,0
Charlie Eliazar,2,1,1992-05-25,2,0,0,0
Eric Godlieb,1,1,1992-05-25,1,0,0,0
Kevin Archer,1,1,1992-05-25,0,1,0,0
Marvin Faustin,1,1,1992-05-31,1,0,0,0
Edmond Abazi,1,1,1992-06-03,1,0,0,0
Philippe Albert,4,4,1994-07-02,1,3,0,0
Hörður Björgvin Magnússon,2,2,2017-06-11,1,1,0,0
Jan Eriksson,3,3,1993-05-19,3,0,0,0
Kenneth Thompson,1,1,1992-06-14,0,1,0,0
Paul Cann,1,1,1992-06-14,0,1,0,0
Kentoine Jennings,2,2,1992-10-25,1,1,0,0
Stefan Effenberg,1,1,1992-06-15,0,1,0,0
Andreas Sotiriou,6,6,1994-11-16,4,2,0,0
Nikodimos Papavasiliou,3,3,1997-10-11,1,2,0,0
Henrik Larsen,4,3,1992-11-18,0,4,0,0
Rob Witschge,3,2,1993-02-24,3,0,0,0
Brian McClair,2,2,1993-06-02,2,0,0,0
Kennet Andersson,16,13,1999-10-09,7,9,0,2
Charles Vatú,1,1,1992-06-27,1,0,0,0
Rodger Gray,1,1,1992-06-27,0,1,0,0
Tony Laus,3,1,1992-07-01,3,0,0,0
Michael McGarry,2,1,1992-07-01,2,0,0,0
Robert Ironside,1,1,1992-07-01,1,0,0,0
Luke Ivor,1,1,1992-07-04,0,1,0,0
Peter Isaacs,1,1,1992-07-05,0,1,0,0
Winston Anglin,1,1,1992-07-05,0,1,0,0
Ainārs Linards,5,4,1993-06-02,4,1,0,0
Indro Olumets,2,2,1992-07-11,1,1,0,0
Vaidotas Šlekys,3,3,1996-10-05,2,1,0,0
Duddley Hatei,1,1,1992-07-11,1,0,0,0
Eric Etaeta,1,1,1992-07-11,0,1,0,0
Virginijus Baltušnikas,6,4,1998-10-14,2,4,0,0
Jurijs Popkovs,1,1,1992-07-12,1,0,0,0
Miguel Estrada,1,1,1992-07-19,0,1,0,0
Carlos Castro Borja,5,4,2000-07-23,4,1,0,1
Óscar Ulloa,6,5,1993-05-09,2,4,0,0
Mauricio Cienfuegos,5,5,2000-07-16,5,0,0,0
César Rostrán,1,1,1992-07-23,0,1,0,0
César Obando,5,5,1993-04-04,4,1,0,1
Nicolás Suazo,8,5,1996-11-17,5,3,0,0
Eimantas Poderis,2,2,1995-05-20,0,2,0,0
Andrėjus Tereškinas,2,2,1994-07-31,1,1,0,1
Ciriaco Sforza,5,5,1996-10-06,3,2,0,0
Paul Davis,6,6,1996-04-21,3,3,0,0
Brian Haynes,1,1,1992-08-16,0,1,0,0
Víctor René Mendieta Ocampo,5,5,1996-12-15,3,2,0,3
Austin Berry,3,3,1998-02-04,2,1,0,1
Javier Astúa,4,2,1992-12-13,4,0,0,0
Joseph Francis,1,1,1992-08-30,0,1,0,0
Francis Dupont,1,1,1992-08-30,1,0,0,0
Miroslav Kadlec,2,2,1995-03-29,2,0,0,0
Carl Veart,6,6,1998-10-02,4,2,0,0
Hollies Vato,2,2,1992-10-09,1,1,0,0
Tom McCulloch,1,1,1992-09-04,0,1,0,0
Jim Magilton,2,2,1993-06-02,1,1,0,0
Kjetil Rekdal,15,12,1998-10-14,11,4,0,6
Gunnar Halle,3,1,1992-09-09,3,0,0,0
Roger Nilsen,2,1,1992-09-09,2,0,0,0
Erik Mykland,1,1,1992-09-09,1,0,0,0
Clayton Blackmore,1,1,1992-09-09,1,0,0,0
Damian Mori,25,11,2002-07-12,23,2,0,0
Paul Wade,3,3,1995-11-15,2,1,0,1
Bakalevu Moceimereke,3,1,1992-09-12,3,0,0,0
Mehmet Durakovic,3,3,1993-08-15,3,0,0,0
Peter Dubovský,14,12,1998-10-10,10,4,0,4
Tomasz Wałdoch,1,1,1992-09-23,1,0,0,0
Aytec Genc,1,1,1992-09-26,1,0,0,0
Charles Ashley,1,1,1992-09-26,0,1,0,0
Greg Brown,1,1,1992-09-26,1,0,0,0
Kaliova Bulinaceva,1,1,1992-09-26,0,1,0,0
Radike Nawasu,2,1,1992-09-26,0,2,0,0
Jostein Flo,5,5,1997-08-20,2,3,0,0
Martin Dahlin,16,14,1997-06-08,8,8,0,0
Stefan Pettersson,1,1,1992-10-07,1,0,0,0
Abdelhafid Tasfaout,10,9,2001-05-04,7,3,0,0
Mourad Meziane,2,2,1993-02-26,2,0,0,0
Albert Niyonkuru,1,1,1992-10-09,0,1,0,1
Reynald Temarii,1,1,1992-10-09,1,0,0,1
Jean-Loup Rousseau,7,6,2000-06-22,6,1,0,1
Maheanum Gatien,2,1,1992-10-09,2,0,0,0
Batram Suri,10,10,2004-10-09,4,6,0,1
Adam Ndlovu,5,5,2004-02-03,2,3,0,0
Richard Daddy Owubokiri,1,1,1992-10-10,1,0,0,0
Rasheed Yekini,3,2,1992-12-20,2,1,0,0
Kelvin Sebwe,6,6,2002-01-25,3,3,0,1
Jonathan Sogbie,1,1,1992-10-11,0,1,0,0
Roger Lukaku,3,2,1996-01-25,2,1,0,1
Antonio Sardina,1,1,1992-10-11,0,1,0,0
Pierre-Emerick Aubameyang,13,11,2021-11-12,11,2,0,5
Jean-Paul,2,2,1992-12-20,2,0,0,0
Harry Elyse Randrianaivo,2,1,1992-10-11,2,0,0,0
Mohammed Chaouch,6,4,1994-06-25,5,1,0,0
Youssef Fertout,5,5,1998-02-13,3,2,0,0
Mohammed Lashaf,1,1,1992-10-11,1,0,0,0
Mohamed Samadi,1,1,1992-10-11,1,0,0,0
Faouzi Rouissi,3,3,1994-03-30,3,0,0,2
Ayedi Hamrouni,3,2,1993-01-31,3,0,0,0
Euloge Sacramento,1,1,1992-10-11,0,1,0,0
Adel Sellimi,8,6,2000-01-23,3,5,0,3
Johnson Bwalya,5,5,1997-04-27,4,1,0,0
Kelvin Mutale,4,3,1993-02-27,2,2,0,0
Rudi Smidts,1,1,1992-10-14,1,0,0,0
Stefano Eranio,2,2,1993-10-13,2,0,0,0
Marek Koźmiński,1,1,1992-10-14,0,1,0,0
Wojciech Kowalczyk,3,3,1995-04-25,1,2,0,0
Peter van Vossen,6,4,1993-04-28,3,3,0,1
Khaled Massad,14,13,1997-11-06,9,5,0,3
Ricardo Altamirano,1,1,1992-10-16,1,0,0,0
Alberto Acosta,1,1,1992-10-16,1,0,0,0
Kyle Lightbourne,2,2,2000-03-05,1,1,0,0
Emmanuel Tiki,1,1,1992-10-18,1,0,0,0
Alphonse Tchami,11,8,1998-02-15,6,5,0,0
Olivier Djappa,1,1,1992-10-18,1,0,0,0
Joseph Mbarga,1,1,1992-10-18,1,0,0,0
Jean-Pierre Fiala,1,1,1992-10-18,1,0,0,0
Cobi Jones,6,6,2004-09-08,3,3,0,0
Leonardo Rodríguez,2,2,1993-06-27,0,2,0,0
Saeed Al-Owairan,11,8,1994-06-29,7,4,0,0
Rachid Daoudi,3,3,1993-07-17,0,3,0,0
Amani Habimana,1,1,1992-10-25,1,0,0,0
Turbie Terblanche,1,1,1992-10-25,1,0,0,0
Moses Chikwalakwala,2,1,1992-10-25,0,2,0,0
Phil Masinga,7,7,2001-02-25,5,2,0,0
Ayman Mansour,2,2,1994-03-28,1,1,0,0
Tadjou Salou,2,2,1996-11-10,2,0,0,1
Hany Ramzy,2,2,2000-02-01,1,1,0,0
Anton Polster,2,2,1993-04-14,2,0,0,0
Itzik Zohar,5,3,1997-03-31,0,5,0,0
Peter Stöger,9,6,1997-10-11,8,1,0,0
Dmitri Radchenko,6,6,1995-11-15,4,2,0,0
Hakan Şükür,39,27,2007-06-02,26,13,0,2
Nicola Bacciocchi,1,1,1992-10-28,0,1,0,0
Orhan Çıkırıkçı,1,1,1992-10-28,1,0,0,0
Hami Mandıralı,2,2,1997-09-10,1,1,0,0
Mahmoud Soufi,8,7,1996-09-27,8,0,0,0
Li Bing,7,6,2001-05-20,3,4,0,0
Mubarak Mustafa,11,9,2004-06-09,8,3,0,2
Julio Palacios Lozano,1,1,1992-11-01,1,0,0,0
Guillermo Rivera,6,4,2000-07-23,5,1,0,0
Masashi Nakayama,9,9,1998-06-26,6,3,0,0
Khalifa Al-Sulaiti,1,1,1992-11-02,0,1,0,0
Peng Weiguo,5,3,1997-05-04,2,3,0,0
Kazuyoshi Miura,30,15,1997-09-07,23,7,0,1
Khamees Saad Mubarak,8,6,1997-09-12,6,2,0,0
Masahiro Fukuda,4,3,1993-04-30,3,1,0,0
Tsuyoshi Kitazawa,1,1,1992-11-06,1,0,0,0
Li Xiao,1,1,1992-11-06,0,1,0,0
Hao Haidong,16,16,2004-07-30,9,7,0,0
Luis Diego Arnáez,3,3,1997-05-04,2,1,0,0
Richardson Smith,4,4,1993-05-02,2,2,1,1
Neil Paynter,1,1,1992-11-08,0,1,0,0
Takuya Takagi,16,10,1997-11-08,8,8,0,0
Claudio Suárez,2,2,1992-11-22,1,1,0,0
Francisco Uribe,7,4,1992-12-13,4,3,0,0
Oļegs Aleksejenko,1,1,1992-11-11,0,1,0,0
Ilir Kepa,1,1,1992-11-11,1,0,0,0
Anders Limpar,1,1,1992-11-11,0,1,0,0
Tal Banin,5,5,1999-03-28,4,1,0,3
Ilie Dumitrescu,8,6,1997-08-20,7,1,0,0
Alex Bunbury,12,10,1997-10-12,9,3,0,0
Sammy Swan,1,1,1992-11-15,0,1,0,0
Geoff Aunger,3,3,1996-08-30,3,0,0,0
Lorenzo Staelens,6,5,1997-10-11,4,2,0,2
Alan Shearer,21,17,2000-06-20,15,6,0,5
Stuart Pearce,2,2,1993-09-08,2,0,0,0
Milton Meléndez,3,2,1992-12-06,1,2,0,0
Luis García Postigo,18,13,1997-10-05,12,6,0,2
Juan Flores Madariaga,5,4,1993-05-02,3,2,0,0
Antonio Zelaya,1,1,1992-11-28,1,0,0,0
Richard Smith,3,2,1997-11-16,3,0,0,0
Ovidiu Hanganu,1,1,1992-11-29,0,1,0,0
Raúl Díaz Arce,20,16,2000-07-23,14,6,0,2
Marcelino Bernal,4,2,1994-06-28,3,1,0,0
Pep Guardiola,4,4,1997-02-12,3,1,0,1
Alfonso Pérez,10,6,2000-06-21,5,5,0,0
Papa Yakhya Lette,1,1,1992-12-19,0,1,0,0
François Amégasse,1,1,1992-12-19,1,0,0,0
Valery Ondo,1,1,1992-12-19,1,0,0,0
Giuseppe Signori,3,3,1993-04-14,2,1,0,0
Martin Gregory,1,1,1992-12-19,1,0,0,0
Edibily Lunyamila,1,1,1992-12-19,1,0,0,0
Felicien Minde,1,1,1992-12-19,1,0,0,0
Soumaila Yattaga,1,1,1992-12-20,0,1,0,0
Mengitsu Hussien,1,1,1992-12-20,1,0,0,0
Comlan Lambert Sossa,1,1,1992-12-20,0,1,0,0
Milyon Beguashaw,1,1,1992-12-20,1,0,0,0
Asnake Tenkir,1,1,1992-12-20,1,0,0,0
Kwame Ayew,4,4,2001-05-05,3,1,0,0
Fodé Camara,5,5,1997-08-16,5,0,0,1
Souleymane Oularé,6,5,1998-02-11,2,4,0,0
Titi Camara,11,9,2004-02-01,5,6,0,0
Etienne Rado Rasoanaivo,3,3,2000-06-17,2,1,0,0
Abdelmajid Bouyboud,2,2,1993-07-17,0,2,0,0
Peter Ndlovu,14,12,2005-06-19,6,8,0,1
Agent Sawu,7,7,1996-06-02,4,3,0,0
Ahmed El-Kass,5,4,1996-01-24,3,2,0,0
Jose Neves,1,1,1993-01-10,1,0,0,0
Okita Katschi,1,1,1993-01-10,1,0,0,1
Mumba Mwila,1,1,1993-01-16,0,1,0,0
Charles Jumanne,1,1,1993-01-16,1,0,0,0
Albert Bwalya,1,1,1993-01-16,0,1,0,0
Ziad Tlemçani,3,3,1998-02-16,2,1,0,0
Lotfi Rouissi,2,1,1993-01-17,0,2,0,0
Taoufik Herichi,3,2,1997-04-06,0,3,0,0
Arnaldo Owanga,1,1,1993-01-17,1,0,0,0
Frederic Remi,1,1,1993-01-17,0,1,0,0
Henry McKop,1,1,1993-01-17,0,1,0,0
Salissou Ali,1,1,1993-01-17,1,0,0,0
Wisdom Mumba Chansa,1,1,1993-01-20,1,0,0,0
Kenan Simambe,1,1,1993-01-20,1,0,0,0
Alagame Seck,2,1,1993-01-30,2,0,0,0
Henrique Tembe,1,1,1993-01-30,0,1,0,0
Moussa Badiane,2,2,1993-02-27,2,0,0,0
Mamadou Diarra,1,1,1993-01-30,1,0,0,0
Harold Legodi,1,1,1993-01-31,0,1,0,0
Yasser Ezzat,1,1,1993-01-31,1,0,0,0
Tahar El Khalej,1,1,1993-01-31,1,0,0,0
Lahcen Abrami,1,1,1993-01-31,1,0,0,1
Abdelkabir Mezyane,1,1,1993-01-31,1,0,0,0
António Neto,1,1,1993-01-31,0,1,0,0
Mal Donaghy,1,1,1993-02-17,0,1,0,0
Altin Rraklli,6,6,2003-03-29,5,1,0,0
Carlton Palmer,1,1,1993-02-17,1,0,0,0
Les Ferdinand,4,4,1996-11-09,2,2,0,0
Vasilis Dimitriadis,1,1,1993-02-17,1,0,0,1
Alain Roche,1,1,1993-02-17,0,1,0,0
Pat Nevin,4,3,1995-11-15,4,0,0,1
Marc Overmars,11,8,2003-06-07,6,5,0,0
Pierluigi Casiraghi,7,6,1997-11-15,4,3,0,0
Fernando Couto,4,4,1996-11-09,4,0,0,0
Dino Baggio,6,6,1994-11-16,5,1,0,0
Cristóbal Parralo,1,1,1993-02-24,1,0,0,0
Thomas Christiansen,1,1,1993-02-24,1,0,0,0
Adolfo Aldana,1,1,1993-02-24,1,0,0,0
Charles Akonnor,5,5,2000-07-09,4,1,0,0
Mohamed Brahimi,1,1,1993-02-26,1,0,0,0
Henry Motego,2,2,1996-06-02,2,0,0,1
Patrick Nachok,1,1,1993-02-27,1,0,0,0
Edema Fuludu,1,1,1993-02-27,1,0,0,0
Finidi George,4,4,2000-02-03,2,2,0,0
Timothy Mwitwa,1,1,1993-02-27,1,0,0,0
Etienne Olivier Rasoanaivo,1,1,1993-02-27,0,1,0,0
Youssouf Arouna,1,1,1993-02-28,1,0,0,0
Moussa Yahaya,2,1,1993-02-28,2,0,0,0
Itumeleng Duiker,1,1,1993-02-28,0,1,0,0
Paolo Maldini,5,5,1999-06-05,5,0,0,0
John van den Brom,1,1,1993-03-24,1,0,0,0
Claudio Canti,1,1,1993-03-24,1,0,1,0
John de Wolf,2,1,1993-03-24,2,0,0,0
Ronald de Boer,11,10,2000-06-16,6,5,0,1
Stratos Apostolakis,5,5,1996-09-01,3,2,1,2
Steve Staunton,4,4,1999-09-08,1,3,0,0
José Orlando Semedo,1,1,1993-03-31,0,1,0,0
Ryan Giggs,11,10,2007-03-28,7,4,0,0
Alberto García Aspe,10,9,2001-09-05,5,5,0,5
William Renderos Iraheta,3,3,1997-09-14,3,0,0,0
John Catliff,4,4,1993-05-02,2,2,0,2
Choe Yong-Son,5,3,1993-04-26,3,2,0,0
Ryu Song-Gun,6,5,1993-10-18,3,3,0,0
Fahad Al Kuwari,3,3,1993-04-26,1,2,0,1
Singgih Pitono,1,1,1993-04-09,0,1,0,0
Ignacio Ambríz,4,4,1993-07-25,4,0,0,0
V. Sundramoorthy,4,4,1993-05-02,1,3,0,0
Cho In-Chol,2,2,1993-05-02,2,0,0,0
Choi Won-nam,4,4,1993-10-25,2,2,0,0
Yousef Khalaf,1,1,1993-04-11,1,0,0,0
Sultan Bakhit Al-Kuwari,1,1,1993-04-11,1,0,0,0
Kiatisuk Senamuang,15,10,2004-06-09,11,4,0,0
Robby Darwis,1,1,1993-04-13,1,0,1,0
Rizvi Karim Rumi,2,2,1993-04-30,1,1,0,0
Abdulrazaq Ibrahim Balooshi,6,5,1993-05-07,6,0,0,1
Lư Đình Tuấn,1,1,1993-04-13,1,0,0,0
Fandi Ahmad,4,4,1993-05-02,2,2,0,0
Steven Tan,1,1,1993-04-13,0,1,0,1
Phan Thanh Hùng,1,1,1993-04-13,1,0,0,0
Dietmar Kühbauer,3,3,1995-04-26,3,0,0,0
Mark Strudal,2,2,1994-10-12,2,0,0,0
Viačeslavas Sukristovas,1,1,1993-04-14,1,0,0,0
Stasys Baranauskas,1,1,1993-04-14,1,0,0,0
Sulejman Demollari,1,1,1993-04-14,0,1,0,0
Sergei Kiriakov,7,6,1995-11-15,1,6,0,0
Vasili Kulkov,5,4,1995-11-15,1,4,0,0
Tetsuji Hashiratani,2,2,1993-04-18,2,0,0,0
Khalil Al-Malki,7,5,1993-05-02,2,5,0,0
Hà Vương Ngầu Nại,1,1,1993-04-16,1,0,0,0
Mohamed Sylla,1,1,1993-04-18,0,1,0,0
Jacob Ewane,1,1,1993-04-18,1,0,0,0
Alex Pineda Chacón,3,3,2000-03-04,2,1,0,0
Domenic Mobilio,3,3,1993-07-31,2,1,0,0
Dangelo Bautista,1,1,1993-04-18,1,0,1,0
Mohd Rafi Ali,2,2,1993-04-28,1,1,0,0
Ramón Ramírez,11,10,2000-09-03,7,4,0,0
Songserm Maperm,2,2,1993-04-30,1,1,0,0
Mamun Joarder,3,2,1993-05-07,2,1,0,0
Sudirman,3,3,1997-06-01,3,0,0,1
Zamel Al Kuwari,3,3,1996-09-27,1,2,0,0
Yong Jin-Li,1,1,1993-04-24,0,1,0,0
Uni Arge,6,5,2000-09-03,5,1,0,0
Rayed Al-Boloushi,1,1,1993-04-26,0,1,0,0
Radoslav Látal,2,2,1993-06-02,2,0,0,0
Pang Gwang-Chol,1,1,1993-04-28,0,1,0,0
Rahmad Darmawan,1,1,1993-04-28,1,0,0,0
Igor Kolyvanov,9,8,1997-10-11,4,5,0,0
Ismail Rashid Ismail,1,1,1993-04-28,1,0,0,0
Mitsunori Yoshida,1,1,1993-04-30,0,1,0,0
Nguyen Hong Son,1,1,1993-04-30,0,1,0,0
Putut Widjanarko,1,1,1993-04-30,1,0,0,0
Sami Al-Jaber,21,16,2006-06-14,15,6,0,3
Abdullah Al-Dosari,2,2,1997-03-27,1,1,0,0
Fahad Al-Mehallel,10,9,1997-10-11,7,3,0,0
Ayman Al Husaini,1,1,1993-05-01,0,1,0,0
Azman Adnan,7,4,1997-03-16,5,2,0,0
Sékou Dramé,1,1,1993-05-02,1,0,0,0
Ahmed Ouattara,3,3,1998-02-11,2,1,0,0
Kim Kyong-il,2,2,1993-10-15,2,0,0,0
Alexander Saununu,1,1,1993-05-02,0,1,0,0
Ali Marwi,6,3,1993-05-16,2,4,0,0
Hamed Al-Saleh,5,3,1997-06-22,1,4,0,0
Jasem Al-Huwaidi,21,16,2001-02-24,11,10,0,0
Basel Abdul Rahim,1,1,1993-05-03,0,1,0,1
Abdul Mubin Mokhtar,3,2,1993-05-05,3,0,0,0
Nasir Khamees Mubarak,1,1,1993-05-03,1,0,0,0
Mohamed Ahmed,2,2,2015-09-03,2,0,0,0
Pongthorn Thiubthong,1,1,1993-05-05,0,1,0,0
A. Elangovan,1,1,1993-05-05,1,0,0,0
Ruy Ramos,1,1,1993-05-05,0,1,0,0
Masami Ihara,3,2,1997-11-08,1,2,0,0
Cheung Kam Wa,2,2,1993-05-09,1,1,0,0
Juma Marzouq,1,1,1993-05-07,0,1,0,0
Au Wai Lun,3,3,1997-03-30,2,1,0,0
Babkin Melikian,2,2,1997-05-24,1,1,0,0
Jamal Taha,1,1,1993-05-07,1,0,0,0
Tejinder Kumar,1,1,1993-05-07,0,1,0,0
V. P. Sathyan,2,2,1993-05-15,0,2,0,1
Masaaki Sawanobori,1,1,1993-05-07,0,1,0,0
Francisco Javier Cruz,1,1,1993-05-09,0,1,0,0
Tam Siu Wai,1,1,1993-05-09,0,1,0,0
Rafi Joulfagi,2,2,1993-06-11,1,1,0,0
Fadi Alloush,1,1,1993-05-09,1,0,0,1
Loh Wai Chi,1,1,1993-05-11,0,1,0,0
Bhupinder Thakur,3,3,1993-06-13,2,1,0,0
Lee Kin Wo,3,3,1997-03-30,2,1,0,0
Ha Seok-ju,11,11,1998-06-13,6,5,0,0
Ronen Harazi,10,8,1996-09-01,7,3,0,0
Kristian Laferla,2,2,1994-09-06,0,2,0,0
Marko Rajamäki,1,1,1993-05-13,1,0,0,0
Michael Zisser,1,1,1993-05-13,0,1,0,0
Hong Myung-bo,4,4,1994-06-27,0,4,0,2
Choi Moon-Sik,5,5,1997-03-02,1,4,0,0
Abdullah Wabran,3,3,1997-06-05,3,0,0,0
Hamzah Idris Falatah,3,1,1993-05-14,3,0,0,0
Mansour Al-Muainea,1,1,1993-05-14,1,0,0,0
Khamis Eid Rafe Thani,3,3,1993-06-11,2,1,0,0
Ali Saad,1,1,1993-05-15,1,0,0,0
Seo Jung-won,4,4,1997-09-28,0,4,0,0
Wail Al Habashi,1,1,1993-05-16,1,0,0,0
Hamoud Al-Shemmari,1,1,1993-05-16,1,0,0,0
Fayez Al-Felaij,1,1,1993-05-16,1,0,0,0
Paramasivan Ravindran,2,1,1993-05-18,0,2,0,0
Kevin Gallacher,9,7,2000-10-11,5,4,0,0
Scott Booth,5,5,1995-11-15,4,1,0,0
Hlynur Birgisson,1,1,1993-05-20,1,0,1,0
Subhi Al-Gnimaz,3,2,1993-06-20,1,2,0,0
Gao Hongbo,6,4,1993-06-16,4,2,0,0
Cai Sheng,4,2,1993-05-26,0,4,0,0
Jeris Tadrus,4,3,1997-04-19,3,1,0,0
Munthir Khalaf,2,2,1993-05-28,0,2,0,0
Tahir Agha,1,1,1993-05-24,0,1,0,0
Omar Mubarak,2,1,1993-05-24,2,0,0,0
Ahmed Bareed,1,1,1993-05-24,1,0,0,0
Mohamed Hassan Abdullah,2,2,1993-06-14,1,1,0,0
Wu Qunli,1,1,1993-05-26,0,1,0,0
Laith Hussein,12,9,2001-08-17,9,3,0,0
Asam Duraiban,1,1,1993-05-26,1,0,0,0
Alaa Kadhim,8,5,1993-10-22,1,7,0,0
Mahdi Kadhim,1,1,1993-05-26,0,1,0,0
Saad Qais,6,4,1993-06-18,3,3,0,0
Naeem Saddam,2,2,1993-06-16,1,1,0,0
Saleh Rabiah Ben,1,1,1993-05-28,1,0,0,0
Dariusz Adamczuk,1,1,1993-05-29,1,0,0,0
Ian Wright,7,3,1997-09-10,2,5,0,0
Mohammad Muharam,3,2,1993-06-20,2,1,0,0
Abdul Farooq,1,1,1993-05-30,0,1,0,0
Hisham Abdul-Munam,1,1,1993-05-30,1,0,0,0
Petr Vrabec,1,1,1993-06-02,1,0,0,0
Peter Møller,4,3,2005-03-26,3,1,0,0
Julen Guerrero,10,5,1999-09-08,5,5,0,0
Øyvind Leonhardsen,6,6,1999-09-08,3,3,0,0
Sergei Bragin,2,2,1993-07-04,1,1,0,0
Pär Zetterberg,4,4,1997-10-11,2,2,0,1
Stefan Landberg,1,1,1993-06-02,1,0,0,0
Jung Jae-Kwon,1,1,1993-06-05,1,0,0,0
Noh Jung-yoon,2,2,2000-10-13,2,0,0,0
Aurelio Vidmar,10,8,2001-04-16,9,1,0,1
Ned Zelić,3,3,1997-07-06,3,0,0,0
Eric Young,1,1,1993-06-06,0,1,0,0
Khamis Mubarak,2,1,1993-06-07,0,2,0,0
Youssef Farhat,1,1,1993-06-09,0,1,0,0
Wael Nazha,2,2,1997-04-13,1,1,0,0
it:Lee Ki-Bum,3,1,1993-06-09,3,0,0,0
Kim Tae-Young,2,1,1993-06-09,2,0,0,0
Park Jung-bae,2,2,1993-10-16,1,1,0,0
Adel Abdulrahman Marzouq,1,1,1993-06-11,1,0,0,0
Samir Mubarak,1,1,1993-06-11,1,0,0,0
Hassan Ayoub,1,1,1993-06-11,0,1,0,0
Sharaf Mahfood,1,1,1993-06-12,1,0,0,0
Aref Al-Shewaier,1,1,1993-06-12,0,1,0,0
I. M. Vijayan,4,3,2001-05-20,1,3,0,0
Wong Chi Keung,1,1,1993-06-13,1,0,0,0
Kang Chul,1,1,1993-06-13,1,0,0,0
Park Nam-Yeol,1,1,1993-06-13,1,0,0,0
Gu Sang-Bum,1,1,1993-06-13,1,0,0,0
Ahmed Abdul Karim Al-Brid,2,1,1993-06-14,0,2,0,0
Raúl Noriega,2,2,1993-09-19,2,0,0,0
Ángel Fernández,4,3,2001-10-06,3,1,0,0
Eduardo Hurtado,10,7,2000-06-29,10,0,0,0
José Luis Dolgetta,6,5,1995-07-12,0,6,0,0
Adolfo Valencia,6,6,1994-06-22,3,3,0,0
Víctor Aristizábal,12,9,2001-11-14,8,4,0,3
Marek Poštulka,2,1,1993-06-16,0,2,0,0
Xu Hong,2,2,1993-06-20,2,0,0,0
Radhi Shenaishil,1,1,1993-06-18,1,0,0,0
Ahmed Daham,1,1,1993-06-18,1,0,0,0
António Nogueira,1,1,1993-06-19,1,0,0,0
Rui Costa,17,14,2004-06-24,8,9,0,4
Marcelo Saralegui,6,5,1997-11-16,5,1,0,0
Stalin Rivas,1,1,1993-06-19,0,1,0,0
Fernando Kanapkis,4,3,1993-08-29,3,1,0,0
David Patiño,2,2,1993-06-27,0,2,0,0
Akram Emmanuel,1,1,1993-06-20,0,1,0,0
Zhao Faqing,1,1,1993-06-20,1,0,0,0
Marco Etcheverry,11,10,1997-07-20,9,2,0,1
Orlando Maturana,1,1,1993-06-20,1,0,0,1
Ahmad Al-Bashir,1,1,1993-06-20,0,1,0,0
José Luis Sierra,3,3,1999-07-03,2,1,0,0
Richard Zambrano,2,1,1993-06-21,0,2,0,0
Chris Henderson,2,2,1997-11-16,2,0,0,0
Alexi Lalas,3,3,1995-07-14,2,1,0,0
Dominic Kinnear,1,1,1993-06-22,1,0,0,0
Miguel Echenausi,1,1,1993-06-22,0,1,0,0
Mohammad Afash,7,5,2001-05-18,6,1,0,1
Mohamad Moustafa Kadir,3,3,1993-07-07,2,1,0,2
Edmundo,3,3,1995-07-17,3,0,0,0
Hamid Estili,8,5,2000-10-12,1,7,0,0
Ali Asghar Modir Roosta,7,4,1997-10-17,6,1,0,0
Ali Daei,49,34,2005-08-17,26,23,0,8
Luis Carlos Perea,1,1,1993-06-26,1,0,0,0
Mario César Ramírez,1,1,1993-06-26,1,0,1,0
Yousuf Saleh Al-Alawi,2,2,1993-07-07,1,1,0,0
Yunis Aman Al-Naseeb,1,1,1993-06-27,1,0,0,0
Chen Fu-Yuan,1,1,1993-06-27,0,1,0,0
Vitālijs Astafjevs,11,10,2009-09-09,5,6,0,0
Aleksejs Sarando,1,1,1993-07-02,0,1,0,0
Hamid Derakhshan,3,3,1993-07-07,0,3,0,0
Jamal Kazem,1,1,1993-07-02,1,0,0,0
Munaf Ramadan,1,1,1993-07-02,1,0,0,0
Ali Cheikh Dib,3,3,1997-06-09,1,2,0,1
Chen Jiunn-ming,1,1,1993-07-02,0,1,0,0
Jay-Jay Okocha,11,10,2005-06-18,8,3,0,2
Daniel Amokachi,10,8,1997-04-05,7,3,0,0
Sergei Zamorski,1,1,1993-07-04,1,0,0,0
Viktoras Olšanskis,1,1,1993-07-04,0,1,0,0
Hamdan Abdulla Al-Moamari,1,1,1993-07-04,0,1,0,0
Majid Namjoo-Motlagh,1,1,1993-07-04,0,1,0,1
Mehdi Abtahi,1,1,1993-07-04,0,1,0,0
Mohammed Abdul Noor,2,1,1993-07-07,0,2,0,0
Rashid Al-Wahaibi,2,1,1993-07-07,0,2,0,0
Mattar Al-Mukhaini,1,1,1993-07-07,0,1,0,0
Yeh Ching-Tueng,1,1,1993-07-07,1,0,0,0
Nabil Al-Siyabi,1,1,1993-07-07,0,1,0,0
Giovanni Gayle,1,1,1993-07-10,1,0,0,0
Jesús Julio,1,1,1993-07-10,0,1,0,0
Nick Dasovic,3,3,1996-10-13,2,1,1,0
Roy Myers,3,3,1998-02-04,1,2,0,0
Juan Hernández,1,1,1993-07-11,1,0,0,0
Devon Jarrett,2,2,1993-07-25,1,1,0,0
Walter Boyd,6,5,1996-10-16,3,3,0,0
Percival Piggott,1,1,1993-07-14,0,1,0,0
Thomas Dooley,2,2,1996-11-10,2,0,0,0
Georges Gertrude,1,1,1993-07-15,0,1,0,0
Thierry Fondelot,1,1,1993-07-15,0,1,0,0
Javier Delgado,2,2,1996-11-10,2,0,1,0
Thierry Tinmar,1,1,1993-07-18,0,1,0,1
David Embé,2,2,1994-06-19,1,1,0,0
Jorge Rodríguez,7,6,2004-08-18,6,1,0,2
Octavio Mora,3,2,1993-07-22,3,0,0,0
Luis Miguel Salvador,5,2,1993-07-22,5,0,0,0
Oswaldo Palencia,1,1,1993-07-18,1,0,0,0
Luis Ramallo,7,5,1993-09-19,2,5,0,0
Luis Cristaldo,4,4,2004-09-05,1,3,0,0
Cle Kooiman,1,1,1993-07-22,1,0,0,0
Floyd Guthrie,1,1,1993-07-25,0,1,0,0
Desmond Armstrong,1,1,1993-07-25,1,0,1,0
Guillermo Cantu,1,1,1993-07-25,1,0,0,0
José Oscar Herrera,1,1,1993-07-25,0,1,0,0
Mark Watson,3,3,2000-02-24,1,2,0,0
Raí,4,4,1994-06-20,2,2,0,2
Cláudio Ibrahim Vaz Leal,2,2,1993-08-29,1,1,0,0
Juan Enrique García,3,3,2000-11-15,3,0,0,0
Cléber Chalá,4,4,2001-07-11,4,0,0,0
Ramón Medina Bello,4,3,1993-08-22,1,3,0,0
Estanislao Struway,1,1,1993-08-08,1,0,0,0
Fernando Redondo,1,1,1993-08-08,0,1,0,0
Frank Farina,1,1,1993-08-15,1,0,0,0
Lyndon Hooper,1,1,1993-08-15,0,1,0,0
Iván Valenciano,4,4,2000-06-04,3,1,0,0
Roberto Palacios,14,13,2004-07-06,8,6,0,0
Marco Sandy,3,3,1996-11-10,3,0,0,0
Carlos Dunga,1,1,1993-08-22,1,0,0,0
Catalino Rivarola,3,3,1997-02-12,3,0,0,0
Lars Olsen,1,1,1993-08-25,1,0,0,0
Ricardo Gomes,3,2,1993-09-05,3,0,0,0
Alexis Mendoza,1,1,1993-08-29,1,0,0,0
Wilson Pérez,1,1,1993-08-29,1,0,0,0
Gabriel Cedrés,3,3,2000-09-03,2,1,0,0
Faustino Asprilla,12,9,2000-02-19,8,4,0,0
Evair Aparecido Paulino,1,1,1993-09-05,1,0,0,0
António Folha,2,2,1994-12-18,1,1,0,0
Darío Muchotrigo,1,1,1993-09-05,1,0,0,0
Jorge Soto,7,7,2004-09-04,6,1,0,1
Andrei Piatnitski,1,1,1993-09-08,0,1,0,0
László Klausz,3,3,1997-09-10,3,0,0,0
Aleksandr Borodiuk,1,1,1993-09-08,0,1,0,0
Haraldur Ingólfsson,1,1,1993-09-08,1,0,0,0
Phil Gray,5,5,2000-09-02,3,2,0,0
Alan Kernaghan,1,1,1993-09-08,1,0,0,0
Byron Tenorio,1,1,1993-09-12,0,1,0,0
Luis Morales,1,1,1993-09-12,1,0,0,0
Antonio Muñoz Gómez,1,1,1993-09-22,0,1,0,0
José Luis Caminero,8,7,1996-06-15,2,6,0,0
Wim Jonk,9,8,1996-12-14,4,5,0,1
Thompson Oliha,1,1,1993-09-25,1,0,0,0
Gibby Mbasela,1,1,1993-09-26,1,0,0,0
Elijah Litana,4,4,1996-01-27,3,1,0,0
Kenneth Malitoli,5,5,1997-04-09,3,2,0,0
Abdeslam Laghrissi,1,1,1993-10-10,1,0,0,0
Nikos Machlas,11,10,2001-06-02,8,3,0,1
Stefano Fanelli,1,1,1993-10-12,1,0,0,0
Yordan Letchkov,5,5,1997-06-08,5,0,0,0
David Ginola,2,2,1995-04-26,2,0,0,0
Eyal Berkovic,5,4,2000-10-11,3,2,0,0
Reuven Atar,1,1,1993-10-13,0,1,0,0
Ronny Johnsen,2,2,2001-09-05,1,1,0,0
John Sheridan,3,3,1994-11-16,1,2,0,0
Kim Suominen,2,2,1995-11-15,0,2,0,0
Henrik Larsson,27,21,2006-06-20,19,8,0,6
Ko Jeong-woon,4,4,1997-10-18,2,2,0,0
Reza Hassanzadeh,1,1,1993-10-18,0,1,0,0
Kim Pan-Keun,1,1,1993-10-19,0,1,0,0
Shin Hong-Ki,1,1,1993-10-22,1,0,0,0
Pavel Hapal,1,1,1993-10-27,1,0,0,0
Hannes Reinmayr,3,3,1998-10-10,1,2,0,0
Bülent Korkmaz,3,3,2002-06-13,2,1,0,0
Jaffar Omran,1,1,1993-10-28,1,0,0,0
Mehdi Fonounizadeh,2,1,1993-10-28,0,2,0,0
Mansour Al-Mousa,1,1,1993-10-28,1,0,0,0
Hamzah Idris,1,1,1993-10-28,1,0,0,0
Javad Manafi,1,1,1993-10-28,0,1,0,0
Abel Balbo,5,5,1995-07-17,2,3,0,0
Håkan Mild,2,2,1994-07-16,1,1,0,0
Aki Hyryläinen,2,1,1993-11-10,0,2,0,0
Oceano da Cruz,2,2,1994-12-18,2,0,0,1
Ertuğrul Sağlam,4,3,1996-11-10,4,0,0,0
Alex Tobin,1,1,1993-11-17,1,0,1,0
Billy McKinlay,3,3,1995-06-07,1,2,0,0
Colin Hendry,3,2,2001-03-28,2,1,0,0
Alan McLoughlin,2,2,1997-04-02,0,2,0,0
Davide Gualtieri,1,1,1993-11-17,1,0,0,0
Paul Ince,2,1,1993-11-17,0,2,0,0
Fernand Coulibaly,1,1,1994-03-26,0,1,0,0
Modibo Sidibé,1,1,1994-03-26,0,1,0,0
Tchiressoua Guel,5,4,2001-03-10,4,1,0,1
Hamza El-Gamal,1,1,1994-03-28,1,0,0,0
Bashir Abdel Samad,2,1,1994-03-28,2,0,0,0
Basaula Lemba,1,1,1994-03-28,0,1,0,0
Aboubacar Titi Camara,1,1,1994-03-29,0,1,0,0
Momath Gueye,1,1,1994-03-29,1,0,0,1
Athanas Tendeng,1,1,1994-03-29,1,0,0,0
Nsumbu Ngoy,1,1,1994-03-30,0,1,0,0
Prince Opoku Polley,1,1,1994-03-31,1,0,0,0
Soumaila Traoré,1,1,1994-04-02,0,1,0,0
Evans Sakala,1,1,1994-04-03,1,0,0,0
Michel Bassolé,2,1,1994-04-06,0,2,0,0
Ben Iroha,1,1,1994-04-06,1,0,0,0
Zeddy Saileti,1,1,1994-04-06,1,0,0,0
Adama Klofie Koné,1,1,1994-04-10,1,0,0,0
Amadou Pathé Diallo,1,1,1994-04-10,0,1,0,0
Emmanuel Amunike,6,5,1997-06-07,5,1,0,0
Steve Lomas,1,1,1994-04-20,1,0,0,0
Daniel Hasler,2,2,2004-10-09,0,2,1,0
Jon Andoni Goikoetxea,3,3,1995-04-26,1,2,0,0
Fuad Anwar,2,2,1994-06-25,1,1,0,0
Gaston Taument,1,1,1994-06-20,1,0,0,0
Andrés Escobar,1,1,1994-06-22,1,0,1,0
Earnie Stewart,11,10,2003-07-26,8,3,0,0
Márcio Roberto dos Santos,1,1,1994-06-24,1,0,0,0
Oleg Salenko,6,2,1994-06-28,5,1,0,2
Daniel Borimirov,3,3,1999-10-09,3,0,0,0
Hernán Gaviria,2,2,1997-06-21,0,2,0,0
Harold Lozano,1,1,1994-06-26,0,1,0,0
Daniele Massaro,1,1,1994-06-28,1,0,0,0
Bryan Roy,4,4,1994-12-14,1,3,0,0
Luis Enrique,12,9,1999-09-04,9,3,0,0
Fahad Al-Ghesheyan,1,1,1994-07-03,1,0,0,0
Valdas Ivanauskas,8,5,1998-10-14,7,1,0,1
Saulius Mikalajūnas,1,1,1994-07-29,1,0,0,0
Rolands Bulders,2,2,1996-07-07,0,2,0,0
Daniel Šmejkal,1,1,1994-09-06,1,0,0,1
Horst Siegl,5,3,1997-12-15,5,0,0,0
Patrik Berger,14,11,1999-09-08,12,2,0,4
Yervand Krbachyan,1,1,1994-09-07,1,0,1,0
Francisco Higuera,1,1,1994-09-07,0,1,0,0
Marios Charalambous,1,1,1994-09-07,0,1,1,0
Alexis Alexandris,4,3,1995-11-15,1,3,0,0
Duncan Shearer,1,1,1994-09-07,0,1,0,0
Igor Oprea,3,2,1998-09-05,0,3,0,0
Gábor Halmai,3,3,1997-09-10,3,0,0,0
Franz Aigner,1,1,1994-09-07,0,1,0,0
Mitko Stojkovski,5,3,1997-04-02,3,2,0,1
Domingos Paciência,8,7,1997-08-20,5,3,0,0
Geir Frigård,1,1,1994-09-07,1,0,0,0
Miodrag Belodedici,1,1,1994-09-07,1,0,0,0
Sašo Udovič,5,4,2000-09-03,4,1,0,0
Alessandro Costacurta,1,1,1994-09-07,0,1,0,0
Chris Coleman,2,2,1998-10-14,2,0,0,0
Christian Panucci,3,3,2008-06-13,1,2,0,0
Nikola Jerkan,1,1,1994-10-09,1,0,0,0
Ardian Kozniku,1,1,1994-10-09,1,0,0,0
Luís Figo,17,16,2001-10-06,9,8,0,1
Jevgeņijs Miļevskis,1,1,1994-10-09,1,0,0,0
Keith Gillespie,3,3,2007-09-12,2,1,1,0
Miroslav Romaschenko,1,1,1994-10-12,1,0,0,0
Syarhey Herasimets,5,4,1995-11-12,2,3,0,1
Dimitris Markos,1,1,1994-10-12,1,0,0,0
Daniel Batista Lima,2,2,1996-04-24,2,0,0,0
Stefan Rusnák,1,1,1994-10-12,0,1,0,0
Gary Speed,7,7,2004-09-04,3,4,0,0
Serghei Belous,1,1,1994-10-12,1,0,0,0
Serghei Secu,1,1,1994-10-12,1,0,0,0
Nathan Blake,4,4,2001-06-02,2,2,0,0
Valeriu Pogorelov,1,1,1994-10-12,1,0,0,0
Andrzej Juskowiak,11,8,1998-10-10,5,6,0,1
Tommy Coyne,2,1,1994-10-12,2,0,0,0
Valery Karpin,10,9,2002-06-05,5,5,0,2
Yuriy Nikiforov,4,3,1996-09-01,3,1,0,0
John McGinlay,3,3,1996-11-10,2,1,0,0
Jan Allan Müller,3,3,1996-10-06,2,1,0,0
Jesper Blomqvist,1,1,1994-10-12,1,0,1,0
Saffet Sancaklı,2,1,1994-10-12,2,0,0,0
Sergen Yalçın,4,4,1999-03-27,3,1,0,0
Miroslav Chvíla,1,1,1994-11-12,0,1,0,0
Daniel Prodan,1,1,1994-11-12,1,0,0,0
Serhiy Konovalov,1,1,1994-11-13,1,0,0,0
Tymerlan Huseynov,5,4,1995-10-11,1,4,0,0
Vladimirs Babičevs,4,4,1998-06-25,0,4,0,0
Henning Berg,5,5,2003-11-15,4,1,1,0
Gert Verheyen,5,5,2001-11-10,2,3,0,0
Zoran Boškovski,1,1,1994-11-16,0,1,0,0
Serghei Cleșcenco,5,5,2001-09-05,2,3,0,1
Costas Fasouliotis,1,1,1994-11-16,1,0,0,0
Antti Sumiala,7,7,1997-10-11,4,3,0,1
Temur Ketsbaia,9,7,2000-10-07,5,4,0,0
Georgi Kinkladze,5,5,2000-10-07,3,2,0,1
Gocha Gogrichiani,1,1,1994-11-16,1,0,0,0
Shota Arveladze,19,16,2007-03-24,8,11,0,0
Kostas Frantzeskos,3,3,1998-09-06,2,1,0,0
Roy Keane,9,7,2001-10-06,4,5,0,0
Zlatko Zahovič,24,20,2003-04-30,14,10,0,5
Vyacheslav Sukristov,1,1,1994-11-16,0,1,0,0
Audrius Žuta,1,1,1994-11-16,0,1,0,0
Miguel Ángel Nadal,2,2,2001-09-05,1,1,0,0
Donato Gama da Silva,2,2,1994-12-17,1,1,0,0
Patrice Loko,2,2,1996-06-18,1,1,0,0
Pier Domenico Della Valle,1,1,1994-12-14,0,1,0,0
Youri Mulder,3,3,1995-11-15,3,0,0,0
Clarence Seedorf,9,8,2002-10-16,4,5,0,0
Marcel Koller,1,1,1994-12-14,0,1,0,0
Recep Çetin,1,1,1994-12-14,1,0,0,0
Boško Gjurovski,3,1,1994-12-17,3,0,0,0
Paulo Alves,5,2,1995-08-15,2,3,0,0
Sebastián Rambert,1,1,1995-01-08,0,1,0,0
Ariel Ortega,10,7,2000-11-15,5,5,0,0
José Chamot,1,1,1995-01-08,0,1,0,0
Morten Wieghorst,2,2,1999-09-08,0,2,0,0
Peter Rasmussen,2,2,1995-01-13,2,0,0,0
Manuel Cardoni,2,2,2004-09-08,1,1,0,0
Gianfranco Zola,9,6,1997-03-29,6,3,0,0
Demetrio Albertini,2,2,1995-10-08,1,1,0,0
Martin Reim,9,9,2000-10-07,4,5,0,2
Fabrizio Ravanelli,7,5,1996-10-09,5,2,0,0
Salvador Kaçaj,1,1,1995-03-29,1,0,0,0
Andi Herzog,4,3,1999-10-09,4,0,0,1
Michael Schjønberg,3,3,1996-09-01,1,2,0,0
Marios Agathokleous,5,5,2000-11-15,4,1,0,0
Ihar Hurynovich,1,1,1995-03-29,0,1,0,0
Béla Illés,7,7,2000-10-11,5,2,0,1
Nestor Subiat,2,1,1995-03-29,0,2,0,0
Gunnar Aase,1,1,1995-03-29,0,1,0,0
Patrick Kluivert,22,19,2003-10-11,13,9,0,0
Józef Wandzik,1,1,1995-03-29,1,0,1,0
Dušan Tittel,5,4,1997-03-31,3,2,0,0
Jaroslav Timko,3,2,1996-09-22,3,0,0,0
Nazim Suleymanov,3,3,1997-04-02,2,1,0,2
Primož Gliha,6,4,1997-04-02,2,4,0,0
Vladimir Kokol,1,1,1995-03-29,1,0,0,0
Piotr Nowak,2,2,1995-06-07,2,0,0,0
Haim Revivo,10,9,2003-09-10,5,5,0,0
José Emilio Amavisca,1,1,1995-04-26,0,1,0,0
Herfried Sabitzer,1,1,1995-04-26,1,0,0,0
Marcus Pürk,1,1,1995-04-26,1,0,0,0
Adi Hütter,2,1,1995-04-26,2,0,0,0
Alyaksandr Taykow,1,1,1995-04-26,1,0,0,0
David Carabott,5,5,2003-09-10,1,4,0,2
Gilles De Bilde,2,2,1995-11-15,1,1,0,0
Gunther Schepens,2,2,1995-06-07,1,1,0,0
Peter Nielsen,1,1,1995-04-26,1,0,0,0
Janne Lindberg,1,1,1995-04-26,0,1,0,0
Petri Helin,1,1,1995-04-26,0,1,0,0
Ondrej Krištofík,1,1,1995-04-26,1,0,1,0
Vincent Guérin,2,2,1995-09-06,2,0,0,0
Heiko Herrlich,1,1,1995-04-26,1,0,0,0
Theodoros Zagorakis,3,3,2005-02-09,2,1,2,0
Vladimir Beschastnykh,18,14,2002-09-07,9,9,0,2
Harald Brattbakk,1,1,1995-04-26,1,0,0,0
Vítor Baía,1,1,1995-04-26,1,0,1,0
Colin Calderwood,1,1,1995-04-26,0,1,0,0
Ogün Temizkanoğlu,2,2,1998-10-14,1,1,0,0
Valery Kechinov,2,2,1997-04-30,2,0,0,0
Nikolai Pisarev,1,1,1995-05-06,1,0,0,0
Mukhsin Mukhamadiev,1,1,1995-05-06,1,0,0,0
Razmik Grigoryan,2,2,1995-09-06,1,1,0,0
Armen Shahgeldyan,5,5,2004-10-09,2,3,0,1
Gjorgji Hristov,9,8,2003-09-06,6,3,0,0
Ljupčo Markovski,1,1,1995-05-10,0,1,0,0
Armands Zeiberliņš,4,4,1995-09-06,3,1,0,0
Valērijs Ivanovs,1,1,1995-05-19,1,0,0,0
Aidas Preikšaitis,2,2,1997-09-06,1,1,0,0
Andrius Upstas,1,1,1995-05-20,0,1,0,0
Andrius Zuta,1,1,1995-05-20,0,1,0,0
Rimantas Žvingilas,2,2,1996-07-09,0,2,0,1
Mihails Zemļinskis,8,8,2004-11-17,3,5,1,4
Jens Kristian Hansen,3,3,2001-09-01,2,1,0,0
Jens Erik Rasmussen,1,1,1995-05-25,1,0,0,0
Julian Johnsson,2,2,2003-09-06,1,1,0,0
Arnar Gunnlaugsson,1,1,1995-06-01,0,1,0,0
Carlos Secretário,1,1,1995-06-03,1,0,0,0
Vīts Rimkus,7,5,1996-11-09,3,4,0,0
Thomas Strunz,1,1,1995-06-07,0,1,0,0
Ramūnas Stonkus,1,1,1995-06-07,1,0,0,0
Arūnas Šuika,3,2,1995-10-11,3,0,0,0
Alexandru Curtianu,2,2,1996-10-05,2,0,0,0
Arjan Bellaj,1,1,1995-06-07,0,1,0,0
Rudi Vata,2,2,1997-10-11,0,2,0,0
Tomasz Wieszczycki,1,1,1995-06-07,1,0,0,0
Dorinel Munteanu,13,11,2003-03-29,4,9,0,0
Dmitri Cheryshev,1,1,1995-06-07,0,1,0,0
Džoni Novak,2,1,1995-06-11,0,2,0,0
Demis Nikolaidis,8,7,2002-10-16,5,3,0,0
Guðni Bergsson,1,1,1995-06-11,1,0,0,0
Yuriy Kalitvintsev,1,1,1995-06-11,1,0,0,0
Marcelo Otero,6,6,1997-08-20,5,1,0,0
Gustavo Poyet,2,2,1996-04-24,1,1,0,0
Adriano Samaniego,1,1,1995-07-06,0,1,0,0
Ronaldo Rodrigues de Jesus,1,1,1995-07-07,1,0,0,0
Demetrio Angola,1,1,1995-07-08,0,1,0,0
Sebastián Rozental,1,1,1995-07-08,0,1,0,0
Jorge Campos,1,1,1995-07-09,0,1,1,0
Eduardo Espinoza,1,1,1995-07-09,1,0,0,0
Zinho,1,1,1995-07-10,1,0,0,1
Gabriel Miranda,2,2,1997-07-06,1,1,0,0
Juan Carlos Villamayor,2,2,1995-07-16,2,0,0,0
Carlos Gamarra,8,8,2006-06-10,7,1,1,0
Leonardo Araújo,4,3,1997-06-26,4,0,0,0
Túlio Costa,1,1,1995-07-13,1,0,0,0
Energio Díaz,1,1,1995-07-13,0,1,0,0
José Mora,1,1,1995-07-13,0,1,0,0
Iván Hurtado,2,2,1997-07-06,1,1,1,0
Frank Klopas,1,1,1995-07-14,0,1,0,0
Miguel Mercado,1,1,1995-07-14,0,1,0,0
Mauricio Ramos,1,1,1995-07-14,0,1,0,0
Óscar Carmelo Sánchez,1,1,1995-07-16,0,1,0,0
Túlio Maravilha,2,2,1995-07-23,1,1,0,0
Edgardo Adinolfi,1,1,1995-07-19,1,0,0,0
Aldair,2,2,1997-06-16,1,1,0,0
Luis Quiñónez,1,1,1995-07-22,1,0,0,0
Joe-Max Moore,9,7,2001-10-07,7,2,0,3
Paulinho Santos,2,2,1995-10-11,0,2,0,0
Allan Nielsen,7,6,1999-09-04,3,4,0,0
Tibor Jančula,6,6,1997-08-24,4,2,0,0
Darius Maciulevičius,5,5,2000-04-26,3,2,0,0
Youri Djorkaeff,13,12,2001-05-30,8,5,0,2
Dieter Ramusch,1,1,1995-08-16,0,1,0,0
Jan Suchopárek,2,2,1996-06-19,0,2,0,0
Mladen Mladenović,1,1,1995-09-03,1,0,0,0
Alen Bokšić,8,7,2001-10-06,4,4,0,0
Igor Štimac,1,1,1995-09-03,1,0,0,0
Michael Hughes,3,3,2001-09-05,2,1,0,0
Mikkel Beck,2,2,1995-11-15,1,1,0,0
Radek Drulák,3,2,1995-11-15,3,0,0,0
Henning Jarnskor,1,1,1995-09-06,1,0,0,0
Todi Jónsson,7,5,1997-06-08,3,4,0,0
Ilya Tsymbalar,3,3,1999-03-31,1,2,0,0
Marcel Desailly,2,2,2001-06-07,2,0,0,0
Reynald Pedros,1,1,1995-09-06,1,0,0,0
Frank Leboeuf,3,2,1999-06-09,2,1,0,1
Christophe Dugarry,6,6,2000-06-21,3,3,0,0
Zinedine Zidane,17,14,2006-07-09,9,8,0,4
Christophe Cocard,1,1,1995-09-06,1,0,0,0
Christian Ziege,5,3,1999-09-08,5,0,0,0
Markus Babbel,1,1,1995-09-06,1,0,0,0
Andriy Husin,7,7,2005-06-08,2,5,0,0
Luc Holtz,1,1,1995-09-06,1,0,0,0
Sarkis Oganessian,1,1,1995-09-06,1,0,1,0
Georgios Georgiadis,4,4,2001-03-28,2,2,0,0
Giorgos Donis,3,3,1996-10-09,1,2,0,0
Juan Antonio Pizzi,4,3,1997-02-12,4,0,0,0
Luc Nilis,7,5,1998-06-25,2,5,0,0
Martin Frýdek,2,2,1996-09-18,1,1,0,0
Serghei Stroenco,1,1,1995-10-08,1,0,1,0
Thomas Helmer,2,2,1997-10-11,2,0,0,0
Radu Rebeja,2,2,2001-09-05,0,2,0,0
Borče Jovanovski,1,1,1995-10-11,0,1,0,0
Gerry McMahon,1,1,1995-10-11,0,1,0,0
Christian Karembeu,1,1,1995-10-11,0,1,0,0
Marinos Ouzounidis,3,3,1998-10-14,3,0,1,0
Viktor Onopko,6,5,2002-10-16,3,3,0,0
Mauro Valentini,2,2,1998-10-10,1,1,1,0
Marek Ujlaky,1,1,1995-10-11,1,0,0,0
Július Šimon,3,3,1996-10-23,3,0,0,1
Viktor Skrypnyk,1,1,1995-10-11,0,1,0,0
Andy Melville,4,4,1997-08-20,1,3,1,0
Kit Symons,2,2,1998-10-14,2,0,0,0
Andriy Polunin,1,1,1995-11-11,0,1,0,0
Mark Pembridge,4,4,2001-06-06,0,4,0,1
Joe Spiteri,1,1,1995-11-15,1,0,0,0
Artur Petrosyan,9,8,2003-06-07,5,4,0,0
Bixente Lizarazu,2,2,1998-06-18,2,0,0,0
Vassilios Tsiartas,5,5,2004-10-09,3,2,0,1
Alessandro Del Piero,17,14,2006-07-04,11,6,0,3
Ion Testemițanu,2,2,1998-11-18,1,1,0,1
Iurie Miterev,2,1,1995-11-15,2,0,0,0
Davit Janashia,1,1,1995-11-15,0,1,0,0
Vitali Culibaba,1,1,1995-11-15,0,1,1,0
Barry Hunter,1,1,1995-11-15,1,0,0,0
Markus Schopp,5,4,2004-10-13,1,4,0,0
Christian Stumpf,1,1,1995-11-15,0,1,0,0
Hélder,1,1,1995-11-15,1,0,0,0
Eoin Jess,2,2,1999-03-31,2,0,0,0
Fabio Francini,1,1,1995-11-15,1,0,1,0
Nikola Jurčević,1,1,1995-11-15,0,1,0,0
Kiko,3,3,1998-06-24,2,1,0,0
Javier Manjarín,2,2,1996-06-18,1,1,0,0
Niclas Alexandersson,5,5,2002-06-02,3,2,0,0
Jörgen Pettersson,1,1,1995-11-15,1,0,0,0
Emre Aşık,2,2,2001-10-06,0,2,0,0
Carlo Corazzin,7,6,2000-02-27,4,3,0,2
Kevin Holness,2,1,1996-01-10,2,0,0,0
Presley Carson,1,1,1996-01-10,0,1,0,0
Ronald Cerritos,6,4,2008-03-26,4,2,0,0
Ricardo Peláez,6,4,1998-06-25,2,4,0,0
Agustín Garcia,1,1,1996-01-11,1,0,0,0
André Luiz Moreira,1,1,1996-01-12,1,0,0,0
Caio Ribeiro Decoussau,3,2,1996-01-14,1,2,0,0
Sávio Bortolini Pimentel,2,2,1996-01-14,1,1,0,0
Tomasz Radzinski,4,4,2008-10-15,3,1,0,0
Leandro Machado,1,1,1996-01-12,1,0,0,0
Mark Williams,6,5,2001-03-28,5,1,0,0
John Moshoeu,4,3,1996-01-31,4,0,0,0
Arnold Dwarika,9,6,2000-05-07,6,3,0,2
Eustacio Rizo,1,1,1996-01-14,0,1,0,0
Paulo Roberto Jamelli Júnior,2,1,1996-01-14,0,2,0,0
Joaquim Alberto Silva,4,4,2001-05-06,2,2,0,0
Gbassay Sessay,1,1,1996-01-15,1,0,0,0
Aboubakari Ouédraogo,1,1,1996-01-15,0,1,0,0
Mohamed Kallon,3,3,2008-06-14,2,1,0,1
Mass Sarr Jr.,1,1,1996-01-16,0,1,0,0
Guy Nzeng,1,1,1996-01-16,1,0,0,0
Edwin Westphal,2,2,1998-02-08,2,0,0,0
Martin Machón,1,1,1996-01-16,1,0,0,0
Tico-Tico,5,4,2009-09-06,4,1,0,0
Hédi Berkhissa,2,2,1996-06-16,2,0,0,0
Ali Meçabih,4,3,2001-03-11,2,2,0,0
Ali Maher,4,2,1996-11-08,3,1,0,0
Brice Mackaya,3,3,1996-06-16,2,1,0,1
Aurelien Bekogo,1,1,1996-01-19,0,1,0,0
Imed Ben Younes,3,2,1996-01-25,2,1,0,0
Cuauhtémoc Blanco,34,24,2010-06-17,23,11,0,11
Dennis Lota,7,7,2000-04-08,5,2,0,0
Issouf Traoré,1,1,1996-01-20,1,0,0,0
Jeff Agoos,3,3,2002-06-05,2,1,1,0
Jovan Kirovski,3,3,2000-02-12,2,1,0,0
Joni,2,2,2000-04-23,2,0,0,1
George Mouyémé,1,1,1996-01-24,0,1,0,0
Hélder Vicente de Jesus Serafin,1,1,1996-01-24,0,1,1,0
Khaled Lounici,1,1,1996-01-24,0,1,0,0
Billel Dziri,3,3,2000-01-29,1,2,0,0
Boureima Zongo,1,1,1996-01-24,1,0,0,0
Mordon Malitoli,1,1,1996-01-24,0,1,0,0
Liombi Essende,1,1,1996-01-25,0,1,0,0
Felix Aboagye,2,2,1997-04-27,1,1,0,0
Abdelkader Ben Hassen,1,1,1996-01-25,1,0,0,0
Mark Fish,2,2,1996-06-15,2,0,0,0
Tarek Lazizi,1,1,1996-01-27,0,1,0,0
Samir Kamouna,5,5,2000-04-23,3,2,0,1
Vincent Mutale,2,2,1996-06-16,2,0,0,0
Zoubeir Baya,12,9,2001-07-15,7,5,0,0
Shaun Bartlett,15,12,2004-07-03,14,1,0,1
Kaies Ghodhbane,4,4,2005-03-26,1,3,0,0
Hillary Makasa,1,1,1996-01-31,1,0,0,0
Anthony Dominique,1,1,1996-03-10,1,0,0,0
George Dangler,1,1,1996-03-10,1,0,0,0
Shane Marshall,1,1,1996-03-10,1,0,0,0
Ramón Mariano,1,1,1996-03-24,1,0,0,0
Raymond Davelaar,2,2,1996-03-31,1,1,0,1
Nelson Peña,1,1,1996-03-24,1,0,0,0
Ryan Malmberg,1,1,1996-03-24,0,1,0,0
Bryan Joseph,1,1,1996-03-29,1,0,0,0
Ricky Charles,8,5,2008-03-26,6,2,0,0
Otis Roberts,2,2,2000-03-18,1,1,0,0
Peter Greenaway,1,1,1996-03-31,0,1,0,0
Stevenson Morancie,1,1,1996-03-31,0,1,0,0
Jeffrey Edmond,1,1,1996-03-31,0,1,0,0
Pedro Aquino,2,2,1996-06-15,0,2,0,0
Cristian Queliz,1,1,1996-03-31,0,1,0,0
Theodore Whitmore,9,7,2004-10-09,5,4,0,0
Jason François,2,1,1996-04-07,2,0,0,0
Keith Fletcher,3,1,1996-04-07,3,0,0,0
Julio César Baldivieso,11,9,2003-09-10,8,3,0,3
Máximo Tenorio,1,1,1996-04-24,1,0,0,0
José Gavica,2,2,1997-06-17,1,1,0,0
Sašo Miloševski,1,1,1996-04-24,1,0,0,0
Boban Babunski,2,2,1999-09-08,1,1,1,1
Srgjan Zaharievski,2,2,1998-11-18,1,1,0,0
Savo Milošević,26,21,2004-10-13,11,15,0,0
John Petersen,5,4,2002-09-07,2,3,0,1
Alberto Jiménez,2,2,1996-06-15,2,0,0,0
Gijsberta Gersley,1,1,1996-05-04,0,1,0,0
Omar Zapata,4,4,2004-03-21,3,1,0,0
Marlos Huggins,1,1,1996-05-04,0,1,0,0
Andre Hinds,4,3,1996-06-23,2,2,0,0
Juan Carlos Plata,14,11,2004-09-05,9,5,0,0
Dwight Allers Kelley,3,2,1996-05-19,2,1,0,0
Vernon Sargeant,2,1,1996-05-05,2,0,0,0
Keith Gumbs,7,7,2004-10-10,5,2,0,2
Ezequiel Jerez,1,1,1996-05-10,0,1,0,0
Robert Seni,6,4,1997-06-15,4,2,0,0
Macha Gatien,1,1,1996-05-11,1,0,0,0
Lázaro Darcourt,6,3,1996-06-23,3,3,0,0
Wilson Chevalier,1,1,1996-05-12,1,0,0,0
Golman Pierre,15,9,2002-01-26,8,7,0,0
Isaac Chauvet,4,2,1996-06-30,4,0,0,0
Patrick Modeste,2,2,2008-06-14,1,1,0,0
Angel Mussenden,1,1,1996-05-12,1,0,1,0
Wesley Charles,2,2,2000-05-21,2,0,0,0
Alexander Cruzata,2,2,2000-05-21,1,1,1,0
Eduardo Sebrango,5,4,1998-02-04,2,3,0,0
Lester Moré,14,10,2005-07-07,7,7,0,1
Roger Proverbs,1,1,1996-05-14,0,1,0,0
Gregory Goodridge,4,4,2004-06-19,2,2,0,0
Abdul Aziz Corr,1,1,1996-06-01,1,0,0,1
Ebrima Ebou Sillah,1,1,1996-06-01,1,0,0,0
Pereira Tavares,2,1,1996-06-01,2,0,0,0
Cipriano Co,1,1,1996-06-01,1,0,0,1
Nedžmedin Memedi,1,1,1996-06-01,0,1,0,0
Eric Tinkler,1,1,1996-06-01,0,1,0,0
Ewald Hoeseb,1,1,1996-06-01,1,0,0,0
Johannes Ortmann,1,1,1996-06-01,1,0,0,0
Khalid Ahmed Elmustafa,2,2,2001-07-29,2,0,0,0
Anas Elnour,1,1,1996-06-01,1,0,0,0
Valyantsin Byalkevich,3,3,1999-03-31,0,3,0,0
Patrik Andersson,2,2,2001-09-01,1,1,0,0
Paulo Jorge Da Silva,4,4,1998-02-16,2,2,0,2
David McCaulay,1,1,1996-06-02,1,0,0,0
Rubén Guevara,2,2,1996-12-15,1,1,0,0
Julio Dely Valdés,11,9,2004-09-04,6,5,0,1
Sutche Wambo,1,1,1996-06-02,1,0,0,0
Olivier Niere,2,2,1996-11-10,2,0,0,0
Sousa Miyamou,1,1,1996-06-02,1,0,0,0
Alberto Montaño,1,1,1996-06-02,1,0,0,0
Jonas Ogandaga,1,1,1996-06-02,0,1,0,0
Vincent Kwarula,1,1,1996-06-02,1,0,0,0
Sid Ahmed Zerrouki,1,1,1996-06-02,0,1,0,0
Musa Otieno,3,3,2005-02-09,2,1,0,0
Jiana Raoelijaona,1,1,1996-06-02,1,0,0,0
Vitalis Takawira,5,4,1997-06-08,3,2,0,2
Emeka Mamale,1,1,1996-06-02,0,1,0,0
Michel Ngonge,2,2,1996-06-16,1,1,0,0
Mbuleya Tondelva,2,2,1996-06-16,1,1,0,0
Antoine Mocude,1,1,1996-06-02,1,0,0,0
Elos Elonga-Ekakia,2,1,1996-06-02,0,2,0,0
Ståle Solbakken,5,4,1998-09-06,4,1,0,0
Ole Gunnar Solskjær,14,11,2006-09-02,6,8,0,1
Frank Strandli,1,1,1996-06-02,1,0,0,0
Leon Mupenzi,1,1,1996-06-02,1,0,0,0
Mehdi Ben Slimane,3,3,1998-02-16,2,1,0,0
Zoran Mirković,1,1,1996-06-02,1,0,0,0
Predrag Mijatović,23,18,2003-02-12,13,10,0,4
Djima Oyawolé,2,2,1997-04-06,1,1,0,0
Omar Traoré,1,1,1996-06-02,0,1,0,0
Kossi Noutsoudje,2,2,1996-11-10,2,0,0,0
Francisco Arce,3,3,2002-06-02,1,2,0,1
Arístides Rojas,3,3,1997-04-30,2,1,0,0
Dioni Guerra,1,1,1996-06-02,1,0,0,0
Javier Margas,3,3,2000-04-26,1,2,0,0
Ricardo Sá Pinto,8,5,2000-09-03,4,4,0,0
Denmark Casey,1,1,1996-06-09,0,1,0,0
Goran Vlaović,5,5,2001-06-02,2,3,0,0
Jordi Cruyff,1,1,1996-06-13,0,1,0,0
Pavel Nedvěd,14,10,2003-09-06,8,6,0,0
Enrico Chiesa,2,2,1999-06-05,1,1,0,0
Radek Bejbl,3,3,1997-09-24,2,1,0,0
Angus Eve,12,10,2005-02-09,9,3,0,0
Robert Kizito,1,1,1996-06-16,0,1,0,0
Kassoum Ouédraogo,3,3,1998-02-21,3,0,0,2
Brahima Traore,1,1,1996-06-16,1,0,0,0
Anicet Yala Ngoukou,1,1,1996-06-16,1,0,0,0
Momo Soumah,4,3,1997-01-12,3,1,0,0
Fernando Manuel Co,1,1,1996-06-16,0,1,0,0
Tibou Bangoura,1,1,1996-06-16,1,0,0,0
Lassina Dao,1,1,1996-06-16,1,0,0,0
Charles Imboula,1,1,1996-06-16,0,1,0,0
Armando Macamo,1,1,1996-06-16,1,0,0,0
Gervatius Uri Khob,4,3,1998-02-12,0,4,0,0
Kokouni Akpalo Gnavor,1,1,1996-06-16,0,1,0,0
Jean-Marie Mbuyi,1,1,1996-06-16,0,1,0,0
Andrew Tembo,2,2,1997-04-09,1,1,0,0
Cloudious Zviripayi,1,1,1996-06-16,1,0,0,0
Etienne Hajason Rasoanaivo,1,1,1996-06-16,0,1,0,0
Samuel Johnson,3,3,1998-02-12,3,0,0,1
Mohamed Daima,1,1,1996-06-17,0,1,0,0
Augustine Ahinful,2,2,2000-04-23,2,0,0,0
Teddy Sheringham,6,5,2001-10-06,4,2,0,0
Omari Tetradze,1,1,1996-06-19,1,0,0,0
Vladimír Šmicer,20,16,2005-11-12,4,16,0,0
Mario Pedraza,1,1,1996-06-23,1,0,0,0
Rosemond Pierre,1,1,1996-06-23,0,1,0,0
Karel Poborský,6,6,2003-09-10,5,1,0,2
Robert Clarke,1,1,1996-06-23,1,0,0,0
Oliver Makor,4,4,2008-06-15,3,1,0,0
Kendall Velox,5,4,2004-10-13,0,5,0,0
Larrymore Bedford,1,1,1996-06-23,1,0,0,0
Stern John,23,17,2008-06-22,15,8,0,0
Dwight Yorke,10,9,2009-02-11,7,3,0,2
Anthony Rougier,2,2,2000-08-16,2,0,0,0
Stefan Kuntz,2,2,1996-10-09,0,2,0,0
Oliver Bierhoff,19,12,2002-06-01,11,8,0,0
Armando Cruz,1,1,1996-06-30,0,1,0,1
Marcelo Salas,22,15,2007-11-18,13,9,0,1
Edson Tortolero,3,3,2000-06-28,2,1,1,2
Milton Coimbra,3,3,2001-08-14,2,1,0,0
Roly Paniagua,1,1,1996-07-07,1,0,0,0
Urmas Rooba,1,1,1996-07-07,1,0,0,0
Tomas Ražanauskas,6,6,2003-04-02,2,4,0,3
Aleksandrs Jeļisejevs,3,3,2000-11-15,1,2,0,0
Ričardas Zdančius,1,1,1996-07-08,0,1,0,1
Paul Peschisolido,4,4,2004-06-13,4,0,0,0
Jorge Dely Valdés,12,11,2005-08-17,4,8,1,0
Vidadi Rzayev,1,1,1996-08-31,1,0,0,0
Uladzimir Makowski,2,2,1996-10-09,2,0,0,0
Luís Oliveira,6,4,1997-11-15,3,3,0,0
Keith O'Neill,1,1,1996-08-31,0,1,0,0
Ian Harte,7,7,2005-06-08,3,4,0,3
Serhii Rebrov,9,9,2006-06-19,4,5,0,3
Viorel Moldovan,16,13,2002-10-16,7,9,0,0
Constantin Gâlcă,3,3,1997-09-10,3,0,0,0
John Robinson,2,2,1998-10-14,2,0,0,0
Jorge Bermúdez,2,2,1996-12-15,1,1,0,0
Ferenc Orosz,1,1,1996-09-01,1,0,0,0
Nicky Barmby,1,1,1996-09-01,0,1,0,0
Rónald Gómez,14,13,2006-06-20,8,6,0,0
Óli Johannesen,1,1,1996-09-04,0,1,1,0
Damián Ariel Álvarez,1,1,1996-09-15,0,1,0,0
Richard Daniel,1,1,1996-09-16,1,0,0,0
Eddie Rukumana,2,2,1997-03-01,1,1,0,0
Noel Berry,7,4,1997-06-15,6,1,0,0
Iau Tuan Naukoot,1,1,1996-09-18,0,1,0,0
Reginal Garo,1,1,1996-09-20,0,1,0,0
Batman Furigi,1,1,1996-09-20,1,0,0,0
Roy Karang,1,1,1996-09-20,1,0,0,0
Mohammed Salem Al-Enazi,16,11,2001-09-28,12,4,0,0
Carlos Pavón,34,23,2009-10-14,23,11,0,5
Raman Vijayan,1,1,1996-09-21,1,0,0,0
Bruno Coutinho,1,1,1996-09-21,1,0,0,0
Manuel Bobadilla,1,1,1996-09-22,0,1,0,0
Marian Zeman,1,1,1996-09-22,1,0,0,0
Adel Khamis Al Noobi,1,1,1996-09-23,1,0,0,0
Abdul Jaloof,2,2,2001-08-26,1,1,0,0
Paul Young,3,2,1996-11-10,1,2,0,0
Christopher Harry,1,1,1996-09-23,1,0,0,1
Anton Silva,1,1,1996-09-24,1,0,0,0
Carlton Chapman,1,1,1996-09-24,0,1,0,0
Chaminda Steinwall,1,1,1996-09-26,0,1,0,0
Roshan Pereta,2,1,1996-09-26,0,2,0,0
Waleed Bakhit Maayof,1,1,1996-09-27,1,0,0,0
Sergei Hohlov-Simson,3,2,1998-10-10,2,1,1,0
Darren Jackson,1,1,1996-10-05,0,1,0,0
Edgaras Jankauskas,7,6,2007-09-12,5,2,0,1
Éric Assadourian,3,3,1997-09-06,1,2,0,0
Neil Lennon,2,2,1998-11-18,2,0,0,0
Serhiy Popov,3,3,1999-06-05,3,0,0,0
Yuriy Maksymov,2,2,1997-10-11,1,1,0,0
Pierre van Hooijdonk,11,8,2004-09-08,6,5,0,2
Slaviša Jokanović,4,3,2001-10-06,1,3,0,0
Massimo Lombardo,1,1,1996-10-06,0,1,0,0
Murat Yakin,3,3,2002-10-12,1,2,0,0
Joonas Kolkka,6,5,2003-06-07,6,0,0,0
Juan Carlos Cubillas,1,1,1996-10-06,1,0,0,0
Rudy Ramírez,2,2,2000-03-19,0,2,0,0
Jerren Nixon,5,5,2004-10-10,3,2,0,0
Slaven Bilić,3,3,1997-10-29,2,1,0,0
Hasan Salihamidžić,4,3,2005-06-04,1,3,0,0
Eber Moas,1,1,1996-10-08,1,0,0,0
Hélder Cristóvão,1,1,1996-10-09,0,1,0,0
Fredi Bobić,5,5,2003-10-11,2,3,0,0
Karapet Mikaelyan,2,2,1999-09-08,2,0,0,0
Marek Citko,1,1,1996-10-09,0,1,0,0
Gadi Brumer,1,1,1996-10-09,1,0,0,0
Harry Zech,1,1,1996-10-09,0,1,0,0
Jason McAteer,3,3,2001-09-01,2,1,0,0
Giovanni Savarese,3,3,2000-06-28,3,0,0,0
Juan Pablo Sorín,7,7,2004-09-04,2,5,0,0
Hugo Morales,1,1,1996-10-09,0,1,0,0
Rafael Dudamel,1,1,1996-10-09,1,0,0,0
Jose Albornoz,1,1,1996-10-09,0,1,0,0
Christian Santamaría,3,2,2000-11-14,0,3,0,0
James Chewitt,7,3,2000-03-19,3,4,0,0
Ernie Tapai,4,3,1997-06-17,3,1,0,0
Kris Trajanovski,11,3,1998-09-28,7,4,0,1
Dexter Walker,1,1,1996-10-30,1,0,0,0
Robbie Hooker,1,1,1996-11-01,1,0,0,0
Rupena Raumati,1,1,1996-11-01,1,0,1,0
Brian McBride,23,19,2005-08-17,19,4,0,1
Enrique Reneau,2,2,1996-11-17,1,1,0,0
Ahmed Hassan,19,16,2010-01-25,11,8,0,2
Eliphas Shivute,5,4,2000-04-08,0,5,0,0
Bajram Franholli,1,1,1996-11-09,1,0,0,0
Hakob Ter-Petrosyan,1,1,1996-11-09,0,1,0,0
Dejvi Glavevski,3,1,1996-11-09,0,3,0,0
Toni Micevski,3,2,2001-03-28,1,2,0,0
Saša Ćirić,5,4,1999-09-08,1,4,0,1
Franz Schädler,1,1,1996-11-09,1,0,0,0
Vančo Micevski,1,1,1996-11-09,0,1,0,0
El Arbi Hababi,1,1,1996-11-09,1,0,0,0
Khalid Raghib,3,2,1997-06-08,3,0,0,0
Phillip Cocu,10,10,2005-09-07,6,4,0,0
Akwá,14,13,2005-10-08,11,3,0,0
Elek Nyilas,2,1,1996-11-10,0,2,0,1
Flórián Urbán,1,1,1996-11-10,0,1,0,0
Mauricio Serna,2,2,1997-04-02,0,2,0,2
Jaime Moreno,6,6,2007-07-03,3,3,0,0
Siniša Gogić,4,3,1998-09-05,4,0,0,1
Wilfredo Iraheta Sanabria,1,1,1996-11-10,1,0,0,0
Giovanni Trigueros,1,1,1996-11-10,1,0,0,0
Théodore Nzue Nguema,5,5,2005-06-18,4,1,0,0
Mike Okoth Origi,6,3,2003-11-15,5,1,0,0
Peter Cargill,1,1,1996-11-10,1,0,0,0
Stephen Malcolm,1,1,1996-11-10,1,0,0,0
Riadh Jelassi,2,2,2001-07-01,1,1,0,0
Andrey Tikhonov,1,1,1996-11-10,0,1,0,0
Miguel Ángel Benítez,7,6,1999-07-10,5,2,0,0
Julio César de Andrade Moura,2,2,1997-08-20,1,1,0,0
Gerson Díaz,1,1,1996-11-10,0,1,0,0
Henryk Bałuszyński,1,1,1996-11-10,1,0,0,0
Elvir Bolić,15,11,2005-10-08,12,3,0,0
Meho Kodro,2,2,1999-06-05,1,1,0,0
Jean-Jacques Missé-Missé,1,1,1996-11-10,0,1,0,0
Oktay Derelioğlu,8,4,2001-06-02,8,0,0,0
Timote Moleni,2,1,1996-11-11,2,0,0,0
T. Tapunuu,1,1,1996-11-13,1,0,0,0
Michael Junior Palusami,1,1,1996-11-13,1,0,0,0
Mani Stenter,1,1,1996-11-13,0,1,0,0
Tolutau Vane,1,1,1996-11-15,1,0,0,0
Barrios Zapata,1,1,1996-11-17,1,0,0,0
Arnold Cruz,1,1,1996-11-17,1,0,0,0
Alwyn Guy,6,3,2000-05-21,5,1,0,0
Merlyn Membreño,1,1,1996-11-17,1,0,0,0
Milton Núñez,12,10,2005-07-16,8,4,0,0
Everad Sam,1,1,1996-11-17,0,1,0,0
Ian Goodison,3,3,2008-06-15,3,0,0,0
Paulo Wanchope,37,25,2006-06-09,22,15,0,0
Wilmer López,2,2,1998-02-04,1,1,0,1
Widodo Cahyono Putro,5,5,1997-06-13,2,3,0,0
Ronny Wabia,4,3,1997-04-06,3,1,0,0
Hani Al Saqer,2,2,1997-04-26,0,2,0,0
Badr Haji,1,1,1996-12-04,0,1,0,1
Hussam Fawzi,6,4,2004-06-09,3,3,0,0
Khalid Mohammed Sabbar,1,1,1996-12-05,0,1,0,0
Khalid Al-Temawi,3,2,1997-03-20,2,1,0,2
Igor Shkvyrin,5,3,1997-10-25,4,1,0,0
Oleg Shatskikh,9,7,1997-09-20,3,6,0,0
Nader Joukhadar,5,3,1997-06-04,3,2,0,0
Hassan Abbas,1,1,1996-12-06,1,0,1,0
Kim Do-hoon,7,5,2002-02-02,3,4,1,0
Hassan Saeed Ahmed,3,3,1996-12-19,3,0,0,0
Saad Bakheet Mubarak,1,1,1996-12-07,1,0,0,0
Naeim Saadavi,1,1,1996-12-08,0,1,0,0
Mehrdad Minavand,4,4,2001-10-31,0,4,0,0
Hiroshi Nanami,7,6,2000-10-24,4,3,0,0
Masakiyo Maezono,2,1,1996-12-09,2,0,0,0
Ma Mingyu,5,5,2001-05-20,3,2,0,0
Gao Feng,4,4,1997-10-31,1,3,0,0
Bashar Abdullah,10,8,2005-08-17,8,2,0,0
Haidar Mahmoud,4,3,2001-04-25,3,1,0,0
Dusit Chalermsan,2,2,1997-03-30,0,2,0,0
Karim Bagheri,32,18,2008-11-19,15,17,0,1
Khodadad Azizi,10,8,1997-11-29,4,6,0,0
Naoki Soma,2,2,1997-03-25,1,1,0,0
Sergey Lebedev,3,2,1997-05-25,3,0,0,1
Ilian Iliev,1,1,1996-12-14,0,1,0,0
Raúl,32,25,2006-06-19,18,14,0,0
Roy Lassiter,3,3,1997-06-29,1,2,0,0
Fernando Cornejo,1,1,1996-12-15,0,1,0,0
Abdulrahman Ibrahim,2,2,2001-10-19,2,0,0,0
Paolo Montero,5,5,2004-11-17,4,1,0,0
Zhang Enhua,3,2,1997-10-03,1,2,0,0
Shin Tae-Yong,1,1,1996-12-16,1,0,0,0
Preki,4,4,1998-02-10,3,1,0,0
Frankie Hejduk,3,3,2009-03-28,1,2,0,0
Abu Kanu,2,2,2000-04-22,2,0,0,0
Christ Bongo,2,2,2001-01-28,1,1,0,0
Nzelo Hervé Lembi,1,1,1997-01-12,1,0,0,0
Salaheddine Bassir,7,5,2000-01-25,1,6,0,0
Mustapha Hadji,4,4,2001-06-30,2,2,0,0
Arthur Moses,1,1,1997-01-12,1,0,0,0
Kennedy Simiyu,2,2,1997-08-16,1,1,0,0
Jonathan Akpoborie,2,2,2000-04-22,1,1,0,0
Julio César Enciso,1,1,1997-01-12,0,1,0,0
Kennedy Chihuri,1,1,1997-01-12,1,0,0,0
Agustín Delgado,23,18,2006-06-15,15,8,0,0
Vladimir Soria,1,1,1997-02-12,1,0,0,0
Pedro González Vera,1,1,1997-02-12,0,1,0,0
Claudio López,8,8,2001-11-14,4,4,0,0
José Pereda,3,3,1999-07-10,0,3,0,0
George Kiriau,2,2,1997-03-01,1,1,0,0
Augustine Peli,2,2,1997-06-17,0,2,0,0
Danny Wabo,1,1,1997-03-01,1,0,0,0
Roh Sang-Rae,1,1,1997-03-02,0,1,0,0
Krissada Piandit,1,1,1997-03-09,1,0,0,0
Natipong Sritong-In,2,2,1997-03-30,1,1,0,0
Idris Abdul Karim,1,1,1997-03-16,1,0,0,0
Obeid Al-Dosari,13,11,2001-09-21,10,3,0,0
Ibrahim Al-Shahrani,4,4,1999-07-29,1,3,0,0
Eddie Pope,4,4,2000-08-16,4,0,0,0
Mohammed Jewel Rana,2,2,1997-03-20,2,0,0,0
Lin Wen Han,1,1,1997-03-18,0,1,0,0
Huang Che-ming,1,1,1997-03-18,0,1,0,0
Chen Kuei-jen,1,1,1997-03-18,0,1,0,0
Ahmad Che Zambil,1,1,1997-03-20,1,0,0,0
Rosdee Sulong,1,1,1997-03-20,1,0,0,0
Mauricio Solís,2,2,2001-07-01,1,1,0,0
Cheang Chon Man,1,1,1997-03-23,0,1,0,0
Hari Khadka,3,3,2001-04-23,2,1,0,1
Norio Omura,2,2,1997-03-27,0,2,0,0
Yutaka Akita,3,3,1997-11-08,1,2,0,0
Hiroaki Morishima,6,5,2002-06-14,3,3,0,0
Saeed Shaaban Al Busaidy,2,2,1997-06-22,1,1,0,0
Yasuto Honda,1,1,1997-03-27,0,1,0,0
Majdi Shaaban Samir,4,4,2001-05-18,2,2,0,0
Nabeel Mubar Al Siyabi,2,1,1997-03-27,2,0,0,0
Mohamed Tayib Abdul Noor,1,1,1997-03-27,1,0,0,0
Igor Simutenkov,2,2,1997-04-30,1,1,0,0
Christian Vieri,18,15,2005-10-12,15,3,0,0
Gheorghe Craioveanu,3,2,1997-09-06,1,2,0,0
Tom Boyd,2,2,1998-06-10,2,0,1,0
Janek Meet,2,2,1998-10-14,2,0,2,0
Hsu Te Ming,1,1,1997-03-29,1,0,0,0
Alfaz Ahmed,3,2,2001-02-12,0,3,0,0
Imtiaz Ahmed Nakib,1,1,1997-03-29,0,1,0,0
Bertrand Crasson,1,1,1997-03-29,0,1,0,0
Cheng Sin Siu,1,1,1997-03-30,1,0,0,0
Abdulaziz Al-Dosari,1,1,1997-03-31,1,0,0,0
Khamis Al-Zahrani,1,1,1997-03-31,1,0,0,0
Bledar Kola,4,3,2001-03-24,3,1,0,1
Marco Antonio Sandy,2,2,2000-09-03,2,0,1,0
Néstor Gorosito,1,1,1997-04-02,0,1,0,1
Fernando Ochoaizpur,1,1,1997-04-02,1,0,0,0
Ioannis Okkas,17,15,2011-10-11,11,6,0,0
Ivaylo Yordanov,2,2,1999-03-31,1,1,0,0
David Kelly,1,1,1997-04-02,0,1,0,0
Hugo Galeano,1,1,1997-04-02,1,0,1,0
Derlis Soto,2,2,1997-04-30,2,0,0,0
Vitaliy Kosovskyi,2,2,1998-10-10,1,1,0,0
Andriy Shevchenko,40,35,2012-06-11,20,20,0,5
Gonzalo de los Santos,1,1,1997-04-02,1,0,0,0
Rafael Castellín,1,1,1997-04-02,0,1,0,0
Abu Kamara,1,1,1997-04-05,0,1,1,0
Lamin Conteh,1,1,1997-04-05,1,0,0,0
Fernando Manuel Sousa,1,1,1997-04-06,1,0,0,0
Bernard Tchoutang,5,4,2001-06-04,5,0,0,0
Macchambes Younga-Mouhani,3,2,1997-06-08,3,0,0,0
Ahmed Bahja,4,3,1998-02-09,1,3,0,1
Ansyari Lubis,2,1,1997-04-06,2,0,0,0
Rocky Putiray,3,1,1997-04-06,3,0,0,0
Mamadou Zongo,9,7,2004-06-05,5,4,0,0
Firmin Sanou,1,1,1997-04-06,0,1,0,1
Khaled Badra,6,6,2004-02-11,3,3,0,2
Mohammed Ouseb,2,2,1997-04-26,2,0,0,1
Étienne N'tsunda,1,1,1997-04-09,1,0,0,0
Epotele Bazamba,1,1,1997-04-09,1,0,0,0
Adel Mohamed Abdulla,2,1,1997-04-11,0,2,0,0
Hameed Darwish,1,1,1997-04-11,1,0,0,0
Zulkarnaen Zainal,1,1,1997-04-13,0,1,0,0
Joaquín del Olmo,1,1,1997-04-13,1,0,0,0
Luis Hernández,21,16,2000-02-13,9,12,0,3
Khaled Al-Doseri,2,2,2001-09-06,2,0,0,0
Hassouneh Al-Sheikh,1,1,1997-04-19,1,0,0,0
Faisal Aziz Rashed,1,1,1997-04-19,0,1,0,0
Basam Al-Khateeb,1,1,1997-04-19,1,0,0,0
Esam Dariban,1,1,1997-04-20,0,1,0,0
Nicolás Ramírez,2,2,1997-06-25,1,1,1,0
Ahmed H. Saeed,1,1,1997-04-22,1,0,0,0
Simon Uutoni,2,2,1998-02-16,1,1,0,0
Hady Khashaba,2,2,1997-08-17,1,1,0,2
Hok Sochetra,2,2,1997-06-29,2,0,0,0
Patrick M'Boma,24,18,2004-01-29,14,10,0,0
Doctor Khumalo,1,1,1997-04-27,0,1,0,0
Zico Tumba,1,1,1997-04-27,1,0,0,0
Mohammed Gargo,3,2,1998-02-09,3,0,0,1
Mwape Miti,1,1,1997-04-27,1,0,0,0
Pedro Reyes,4,3,1999-07-11,3,1,0,0
Hernán Crespo,26,23,2007-07-02,17,9,0,2
Ivica Vastić,9,7,2008-06-12,6,3,0,1
Per Pedersen,1,1,1997-04-30,1,0,0,0
Mario Basler,1,1,1997-04-30,1,0,0,0
Roberto Di Matteo,1,1,1997-04-30,1,0,0,0
Jurijs Ševļakovs,2,1,1997-04-30,2,0,0,0
Øssur Hansen,2,2,2000-09-03,1,1,0,0
Darío Silva,12,10,2004-07-18,7,5,0,0
Adrian Ilie,9,7,2001-09-05,6,3,0,0
Sergey Grishin,1,1,1997-04-30,1,0,0,0
Elías Montes,3,3,2000-07-23,3,0,0,0
Oumed Alidodov,2,2,1997-06-01,1,1,0,0
Tokhirjon Muminov,4,4,2000-11-26,3,1,0,0
Shukhrat Dzhaborov,3,2,1997-06-22,3,0,0,0
Djumadurdy Meredov,3,3,2001-04-27,2,1,0,0
Fawaz Al Ahmad,2,2,1997-06-05,2,0,0,0
Numon Khasanov,2,2,1997-05-25,1,1,0,0
Andy Williams,8,8,2008-08-20,2,6,0,3
Allan Oviedo,2,2,1998-02-07,1,1,0,0
Boulat Esmagambetov,3,2,1997-06-11,2,1,0,0
Valeri Yablochkin,1,1,1997-05-11,1,0,0,0
Redjep Agabaev,1,1,1997-05-11,1,0,0,0
Valeri Gulyan,1,1,1997-05-11,1,0,0,0
Nguyen Cong Vinh,1,1,1997-05-11,0,1,0,0
Omar Al Ariki,5,2,1997-06-13,5,0,0,0
Munif Shaef Noman,1,1,1997-05-16,1,0,0,0
Jeyab Bashafal,1,1,1997-05-16,1,0,0,0
Abdul Rahman Abdulla,1,1,1997-05-16,1,0,0,0
Indrek Zelinski,7,6,2007-08-22,4,3,0,0
Marek Lemsalu,1,1,1997-05-18,0,1,1,0
David Connolly,5,3,2001-10-06,4,1,0,0
Mohammad Umer,2,2,1997-06-20,1,1,0,0
Qahtan Chathir,4,3,2001-10-12,1,3,0,0
Zahir Rafiq,1,1,1997-05-23,1,0,0,0
Abdulfattah Shehab,2,2,1997-06-22,1,1,0,0
Chuan Tan Teng,1,1,1997-05-24,1,0,0,1
Georgi Tkavadze,1,1,1997-05-25,1,0,0,0
Viacheslav Knizaev,2,1,1997-05-25,0,2,0,0
Nikolay Shirshov,6,6,2001-10-19,4,2,0,0
Andrei Fyodorov,4,4,1997-10-25,3,1,0,2
Jafar Irismetov,11,6,2001-09-08,8,3,0,0
Fan Zhiyi,10,9,2001-09-15,6,4,1,4
Le Huynh Duc,1,1,1997-05-25,1,0,0,0
Yoo Sang-chul,6,6,2002-06-04,4,2,0,0
Choi Yong-soo,9,5,1997-10-18,6,3,0,0
Park Kun-Ha,1,1,1997-05-28,1,0,0,0
Francis Niakuam,1,1,1997-05-31,1,0,0,0
Eddy Berdusco,1,1,1997-06-01,1,0,0,0
Li Jinyu,8,6,2007-10-21,5,3,0,0
Arsen Avakov,4,2,1997-06-22,3,1,0,0
Alier Ashurmamadov,3,2,2000-11-26,2,1,0,0
Reza Shahroudi,3,3,1997-06-13,2,1,0,0
Mehdi Mahdavikia,9,8,2008-10-15,4,5,0,0
Farhad Majidi,5,2,2000-11-24,3,2,0,0
Ali Mousavi,1,1,1997-06-04,0,1,0,0
Bayazir al-Said,6,3,1997-06-13,2,4,0,0
Abdul Kader Rifai,1,1,1997-06-04,1,0,0,0
Tarek Jabban,3,2,2001-04-30,3,0,0,0
Bashar Srour,8,6,2001-05-18,8,0,0,1
Khaled Al Zaher,5,3,2001-05-11,3,2,0,0
Nihad Boshi,4,3,1997-06-13,2,2,0,0
Sadiq Saadoun,2,2,1997-06-29,2,0,1,0
Alexei Klishin,2,2,1997-06-11,0,2,0,0
Vladimir Loginov,3,3,1997-06-29,1,2,0,0
Alexandr Korzanov,1,1,1997-06-06,1,0,0,0
Aleksandr Merzlikin,2,2,1997-06-13,1,1,0,0
Rafik Yusupov,1,1,1997-06-06,1,0,0,0
Eric Van Meir,1,1,1997-06-07,1,0,0,0
Émile Mpenza,9,6,2009-10-10,9,0,0,0
Chris Jackson,5,4,2001-06-13,3,2,0,1
Sunday Oliseh,2,2,1998-06-13,1,1,0,0
Wilson Oruma,2,2,1998-06-24,2,0,0,0
Marc Rieper,2,2,1998-06-12,1,1,0,0
Miklos Molnar,2,2,1997-09-10,2,0,0,0
Ariel Graziani,10,8,2000-06-03,3,7,0,0
Andres Oper,18,17,2012-10-16,11,7,0,0
Marko Kristal,3,3,2001-03-28,2,1,0,0
Gilbert Agius,2,2,2001-09-05,0,2,0,0
Jari Vanhala,1,1,1997-06-08,1,0,0,0
Mohamadi Balma,1,1,1997-06-08,1,0,1,0
Petter Rudi,2,2,1997-08-20,0,2,0,0
Zoltán Kovács,1,1,1997-06-08,1,0,0,0
Andreas Heraf,1,1,1997-06-08,0,1,0,0
Prince Daye,1,1,1997-06-08,1,0,0,0
Vladislav Radimov,1,1,1997-06-08,1,0,0,0
Alexei Kosolapov,1,1,1997-06-08,1,0,0,0
Helman Mkhalele,4,4,1998-02-11,3,1,0,1
Bachirou Salou,2,1,1997-06-08,2,0,0,0
Hamilton Ricard,4,4,1999-07-07,1,3,0,0
Ramiro Castillo,2,2,1997-06-25,1,1,0,0
Muslim Agaev,3,1,1997-06-08,0,3,0,0
Valeri Broshin,1,1,1997-06-08,0,1,0,0
Sergey Kutsov,3,3,1997-06-13,1,2,0,0
Aref Al Agha,2,1,1997-06-09,0,2,0,0
Loay Taleb,1,1,1997-06-09,0,1,0,0
Ammar Rihawi,1,1,1997-06-09,0,1,0,0
Redwan Abrash,2,1,1997-06-09,0,2,0,0
John Aloisi,22,10,2007-07-21,17,5,0,1
Craig Foster,7,4,2000-06-28,6,1,0,0
Mark Bosnich,1,1,1997-06-11,1,0,0,1
Roberto Acuña,3,3,2000-08-16,1,2,0,1
Alireza Mansourian,4,3,1997-10-17,4,0,0,0
Kanat Sardarov,1,1,1997-06-11,1,0,0,0
Vaughan Coveny,23,10,2004-06-06,21,2,0,1
Simon Elliott,3,2,2000-06-25,3,0,0,0
Tim Stevens,1,1,1997-06-11,1,0,0,0
Nourken Mazbaev,2,2,1997-06-29,1,1,0,0
Viktor Zubarev,4,2,1997-10-04,1,3,0,0
Martín Hidalgo,2,2,1997-06-21,2,0,0,0
Matthew Bingley,1,1,1997-06-13,1,0,0,0
Djalminha,2,2,1997-06-26,2,0,0,0
Ronaldo,39,26,2006-06-27,29,10,0,5
Vladimir Chertkov,2,2,2003-12-03,1,1,0,0
Farhat Haitbaev,2,1,1997-06-13,0,2,0,0
Sergei Ivanov,1,1,1997-06-13,0,1,0,0
Sergio Berti,1,1,1997-06-14,1,0,0,0
Marcelo Gallardo,8,8,2001-09-05,5,3,0,2
Wellington Sánchez,2,2,2000-11-15,0,2,0,0
Adam Ledwoń,1,1,1997-06-14,1,0,0,0
Mirosław Trzeciak,2,2,1998-10-10,2,0,0,0
Krzysztof Bukalski,1,1,1997-06-14,1,0,0,1
Krzysztof Nowak,1,1,1997-06-14,1,0,0,0
Solome Pita,1,1,1997-06-15,1,0,0,0
Esala Masi,14,7,2004-05-17,6,8,0,1
Wesley Waiwai,1,1,1997-06-15,0,1,0,0
Liuai Duguga,1,1,1997-06-15,1,0,0,0
Jean Ludivion,1,1,1997-06-15,0,1,0,0
Moses Toata,1,1,1997-06-15,1,0,0,0
Álvaro Recoba,6,6,2005-10-12,3,3,0,1
Camilo Romero,1,1,1997-06-16,1,0,1,0
Neider Morantes,3,2,1999-07-07,3,0,0,0
Wilmer Cabrera,2,2,1997-09-10,2,0,0,1
Mauricio Wright,3,3,2004-07-14,1,2,0,0
Robbie Slater,1,1,1997-06-17,1,0,0,0
Jimmy Kaierea,1,1,1997-06-17,1,0,1,0
Fernando Vergara,1,1,1997-06-17,1,0,0,0
Nik Viljoen,1,1,1997-06-18,1,0,0,0
Riki van Steeden,1,1,1997-06-18,1,0,0,0
Paul Cominges,2,1,1997-06-18,2,0,0,0
Dunga,1,1,1997-06-19,1,0,0,0
Edmundo Alves de Souza Neto,2,2,1998-02-08,1,1,0,0
Sahib Abbas,2,1,1997-06-20,2,0,0,0
Shukhrat Maksudov,2,1,1997-06-20,2,0,0,0
Alivate Driu,1,1,1997-06-21,0,1,0,0
Eddy Carazas,1,1,1997-06-21,1,0,0,0
Jeffrey Kwaomae,1,1,1997-06-21,0,1,0,0
Su Maozhen,3,3,2001-10-13,2,1,0,0
Luis Capurro,1,1,1997-06-22,1,0,0,1
Hidetoshi Nakata,8,7,2003-06-18,7,1,0,0
Akinori Nishizawa,8,6,2001-05-31,7,1,0,0
Faisal Al Otaibi,1,1,1997-06-22,0,1,0,0
Raju Kaji Shakya,1,1,1997-06-22,0,1,1,0
Mahfood Sultan Al Araimi,2,2,1997-06-25,0,2,0,0
Farid Al Masori,1,1,1997-06-22,0,1,0,0
Denílson de Oliveira Araújo,5,5,2001-07-18,4,1,0,0
Flávio Conceição,1,1,1997-06-26,1,0,0,0
Deepak Amatya,1,1,1997-06-28,0,1,0,0
Che Chi Man,1,1,1997-06-28,1,0,0,0
José Maria da Cruz Martins,1,1,1997-06-28,1,0,0,0
Zé Roberto,6,6,2006-06-27,4,2,0,0
Abdukahhor Marifaliev,2,1,1997-06-29,0,2,0,0
Ravshan Bozorov,3,2,1997-08-24,1,2,0,0
Haidar Abdullah,1,1,1997-06-29,0,1,0,0
Juan Sebastián Verón,6,5,2001-08-15,3,3,0,1
Germán Carty,2,2,1997-09-10,2,0,0,0
Igoris Morinas,6,4,2005-05-21,3,3,0,0
Dainius Suliauskas,1,1,1997-07-09,1,0,0,1
Marians Pahars,9,9,2001-07-05,5,4,0,0
Pablo Paz,1,1,1997-07-20,1,0,0,0
Hugo Brizuela,3,2,2000-06-03,2,1,0,0
Francis Were,1,1,1997-08-16,0,1,0,0
Maurice Sunguti,2,1,1997-08-16,0,2,0,0
Ousmane Sanou,3,3,2000-02-01,2,1,0,0
Noureddine Naybet,1,1,1997-08-16,1,0,0,0
Frazer Kamwandi,2,1,1997-08-16,2,0,0,0
Hesham Hanafy,1,1,1997-08-17,1,0,0,0
Abdel Sattar Sabry,4,4,2001-07-13,3,1,0,0
Hazem Emam,3,3,2002-01-31,3,0,0,0
Jamiru Amidu,1,1,1997-08-17,0,1,0,0
Lantame Ouadja,2,2,2000-01-24,1,1,0,0
Skander Souayah,2,2,1998-06-26,1,1,0,1
Edelbert Dinha,1,1,1997-08-17,1,0,0,0
Sergei Gurenko,3,3,2003-03-29,2,1,0,0
Edin Mujčin,1,1,1997-08-20,1,0,0,0
Luboš Kozel,1,1,1997-08-20,1,0,0,0
Richard Báez,1,1,1997-08-20,0,1,0,0
Tore André Flo,10,9,2003-10-11,2,8,0,0
Einar Daníelsson,1,1,1997-08-20,0,1,0,0
Brynjar Gunnarsson,4,4,2007-06-02,2,2,0,0
Tryggvi Guðmundsson,6,6,2005-06-08,4,2,0,0
Pedro Barbosa,4,3,2001-06-06,3,1,0,0
Miroslav Gjokić,2,1,1997-08-20,0,2,0,0
Saffet Akyüz,1,1,1997-08-20,1,0,0,0
Robbie Savage,2,2,2001-09-05,0,2,0,0
Manuel Marengo,1,1,1997-08-20,0,1,0,0
Jozef Majoroš,3,3,1997-09-24,3,0,0,0
Mohammed Zughair,1,1,1997-08-24,0,1,0,0
Harutyun Vardanyan,1,1,1997-09-06,1,0,0,0
Garnik Avalyan,2,2,1998-09-05,2,0,0,1
Dražen Ladić,1,1,1997-09-06,0,1,1,0
Silvio Marić,1,1,1997-09-06,1,0,0,0
Helgi Sigurðsson,3,3,2003-06-07,2,1,0,0
Mark Kennedy,2,2,1999-09-01,1,1,0,0
Anton Doboş,1,1,1997-09-06,0,1,0,0
Constantin Barbu,1,1,1997-09-06,0,1,0,0
Mario Frick,12,12,2010-09-07,7,5,1,1
Jaap Stam,1,1,1997-09-06,1,0,0,0
Alekos Alexandris,1,1,1997-09-06,0,1,0,0
Kostas Konstantinidis,1,1,1997-09-06,0,1,0,0
Adrian Kunz,1,1,1997-09-06,1,0,0,0
Deon Burton,8,7,2008-06-18,5,3,0,0
Shoji Jo,2,2,1997-11-16,2,0,0,0
Paolo Amodio,1,1,1997-09-07,1,0,0,0
David Hopkin,2,1,1997-09-07,2,0,0,0
Petr Kachuro,1,1,1997-09-07,0,1,0,1
Altin Haxhi,2,2,2007-06-02,2,0,0,0
Paul Scholes,11,8,2004-06-21,5,6,0,0
Vyacheslav Lychkin,2,2,1999-06-05,1,1,0,0
Tomas Žiukas,1,1,1997-09-10,1,0,0,0
Jahn Ivar Jakobsen,1,1,1997-09-10,1,0,0,0
Dan Eggen,2,2,1998-06-10,1,1,0,0
Egil Østenstad,1,1,1997-09-10,1,0,0,0
Luca Gobbi,1,1,1997-09-10,0,1,1,0
Arif Erdem,9,4,2002-09-07,4,5,0,0
Siniša Mihajlović,6,6,2001-08-15,4,2,1,0
Mattias Jonson,7,5,2005-06-04,3,4,0,0
Lee Sang-yoon,3,3,1997-11-09,2,1,0,0
Gholam Ali,1,1,1997-09-12,1,0,0,0
Mohamed Obaid,1,1,1997-09-12,1,0,0,0
Li Ming,5,5,2004-08-07,5,0,0,0
Nildeson,3,3,1997-11-16,2,1,0,0
Bashar Abdulaziz,3,3,1997-10-17,1,2,0,0
Ibrahim Suwayed,2,2,1997-11-12,0,2,0,0
Ruslan Baltiyev,8,8,2009-09-09,4,4,0,2
Nasir Khamees,1,1,1997-09-26,1,0,0,0
Bakhit Alabadla,1,1,1997-09-27,0,1,0,0
Ravshan Bazarav,1,1,1997-09-27,1,0,0,0
Motohiro Yamaguchi,1,1,1997-09-28,1,0,0,0
Lee Min-sung,2,2,2000-02-17,1,1,0,0
Gert Claessens,1,1,1997-10-11,1,0,0,0
Milenko Špoljarić,6,5,2000-11-15,5,1,0,2
Jiří Novotný,1,1,1997-10-11,1,0,0,0
Teuvo Moilanen,1,1,1997-10-11,0,1,1,0
Archil Arveladze,3,3,2000-10-07,2,1,0,0
Kakhaber Tskhadadze,1,1,1997-10-11,1,0,0,0
Jurgen Kohler,1,1,1997-10-11,0,1,1,0
Igli Tare,7,6,2005-06-04,5,2,0,0
Olaf Marschall,1,1,1997-10-11,1,0,0,0
Þórður Guðjónsson,5,5,2003-06-11,3,2,0,0
Bjarni Guðjónsson,1,1,1997-10-11,1,0,0,0
Pavel Yevteyev,3,3,1997-11-08,2,1,0,0
Artim Šakiri,9,8,2004-08-18,6,3,0,1
Orestas Buitkus,4,3,2001-07-04,1,3,0,0
Sérgio Conceição,9,7,2001-09-05,6,3,0,0
Dmitri Alenichev,4,3,2001-06-06,3,1,0,0
Ilia Gruev,1,1,1997-10-11,0,1,0,0
Zvonimir Soldo,3,3,2001-09-05,1,2,0,0
Oli,1,1,1997-10-11,1,0,0,0
Bahtiyor Kambaraliev,1,1,1997-10-11,1,0,0,0
Wagner Lopes,5,5,1999-07-05,1,4,0,1
Enrique Alfaro Rojas,1,1,1997-10-12,0,1,0,0
Félix Ricardo Torres,1,1,1997-10-12,1,0,0,0
Mao Yijun,1,1,1997-10-17,0,1,0,0
Jamal Mubarak,1,1,1997-10-17,1,0,0,0
Vitali Sparyshev,1,1,1997-10-18,1,0,0,0
Dmitri Yurist,1,1,1997-10-18,1,0,0,0
Mirdjalal Kasimov,1,1,1997-10-25,1,0,0,0
Hassan Mubarak,2,2,1997-12-15,1,1,0,0
Branko Brnovic,1,1,1997-10-29,0,1,0,0
Miroslav Đukić,2,2,2001-08-15,1,1,0,0
Denis Irwin,2,2,1998-09-05,2,0,0,1
Fabio Cannavaro,1,1,1997-10-29,1,0,1,0
Dahi Al Naemi,4,4,2001-09-07,2,2,0,0
Zamel Essa Al-Kuwari,1,1,1997-10-31,0,1,0,0
Claudio Reyna,1,1,1997-11-09,0,1,0,0
Roy Wegerle,3,2,1998-02-01,1,2,0,0
Paul Hall,3,2,1998-02-08,0,3,0,0
Waldir Guerra,1,1,1997-11-09,1,0,0,0
Paulo César Chávez,1,1,1997-11-09,1,0,0,0
Jafet Soto,6,6,2005-07-09,4,2,0,2
Fernando Cáceres,1,1,1997-11-16,1,0,0,0
Rodrigo Barrera,1,1,1997-11-16,1,0,0,0
Juan Carreño López,1,1,1997-11-16,1,0,0,0
Farlen Ilama,1,1,1997-11-16,1,0,0,0
Carl Fletcher,1,1,1997-11-16,0,1,0,0
Luis Marín Murillo,3,3,2004-07-11,2,1,0,1
Masayuki Okano,1,1,1997-11-16,1,0,0,0
Sebastián Abreu,10,9,2009-11-18,7,3,0,0
Harry Kewell,13,13,2012-02-29,6,7,0,1
Mark Viduka,6,4,2007-07-16,2,4,0,0
César Sampaio,4,3,1998-06-27,3,1,0,0
Brendan Augustine,1,1,1997-12-13,1,0,0,0
Nicolás Olivera,6,5,2001-11-07,3,3,0,1
Antonio Pacheco D'Agosti,1,1,1997-12-13,0,1,0,0
Francisco Palencia,9,8,2009-10-10,4,5,0,0
Braulio Luna,1,1,1997-12-14,0,1,0,0
Marcelo Zalayeta,7,4,2005-09-04,5,2,0,0
Júnior Baiano,1,1,1997-12-16,1,0,0,0
Mohammed Al-Khilaiwi,2,2,2001-02-15,2,0,0,0
Mohamed Obaid Al-Zahiri,1,1,1997-12-17,0,1,1,0
Lucas Radebe,2,2,2002-06-12,1,1,0,0
Pollen Ndlanya,1,1,1997-12-17,0,1,0,0
Christian Callejas,1,1,1997-12-17,1,0,0,0
Edvard Lasota,1,1,1997-12-21,1,0,0,0
Luis Martén,3,3,2004-02-22,2,1,0,0
Clint Marcelle,1,1,1998-02-04,1,0,0,0
Giovane Élber,2,1,1998-02-08,0,2,0,0
Ibrahima Bakayoko,13,9,2001-07-01,9,4,0,1
Ricardo Mannetti,1,1,1998-02-08,0,1,0,0
Lassina Diabaté,1,1,1998-02-08,1,0,0,0
Jerry Tondelua,4,3,1998-02-27,2,2,0,2
Massamasso Tchangai,2,2,2000-01-31,0,2,0,0
Alex Nyarko,1,1,1998-02-09,1,0,0,0
Marcus Gayle,1,1,1998-02-09,1,0,0,0
Fitzroy Simpson,1,1,1998-02-09,1,0,0,0
Tenant Chilumba,1,1,1998-02-09,1,0,0,0
Seydou Traoré,1,1,1998-02-11,1,0,0,0
Pierre Womé,1,1,1998-02-11,1,0,0,0
Robert Nauseb,1,1,1998-02-12,0,1,0,0
Lázaro Oliveira,1,1,1998-02-12,1,0,0,0
Miguel Pereira,1,1,1998-02-12,1,0,0,0
Franck Doté,1,1,1998-02-12,0,1,0,0
Mohamed Kader,6,5,2006-06-13,1,5,0,0
Papi Kimoto,2,2,2002-01-29,1,1,0,1
Saïd Chiba,2,2,1998-02-22,2,0,0,0
Ali Elkhattabi,1,1,1998-02-13,1,0,0,0
Yasser Radwan,3,3,2000-01-23,1,2,0,0
Romeo Kambou,2,2,2001-04-21,2,0,0,0
Joseph-Désiré Job,4,3,2008-01-26,3,1,0,0
Bijou Kisombe Mundaba,1,1,1998-02-16,0,1,0,0
Quinzinho,1,1,1998-02-16,0,1,0,0
Benni McCarthy,12,8,2005-06-04,7,5,0,1
Komlan Assignon,2,2,2001-05-06,1,1,0,1
Hassen Gabsi,3,3,2000-04-07,1,2,0,0
Rotson Kilambe,3,2,2001-07-27,1,2,0,0
Avelino Salvador Maluana,1,1,1998-02-17,0,1,0,0
Masauso Tembo,1,1,1998-02-17,1,0,0,0
David Nyathi,1,1,1998-02-22,0,1,0,0
Eddy Bembuana-Keve,1,1,1998-02-25,1,0,0,0
Alassane Ouédraogo,2,2,2000-01-29,1,1,0,0
Oumar Barro,2,2,2000-04-23,2,0,0,0
Sidi Napon,1,1,1998-02-27,1,0,0,0
Lokenge Mungongo,2,1,1998-02-27,0,2,0,0
Ibrahima Tallé,1,1,1998-02-27,1,0,0,0
Jean-Kasongo Banza,1,1,1998-02-27,0,1,0,0
Tarek Mostafa,1,1,1998-02-28,0,1,0,0
Igors Stepanovs,2,2,1999-09-08,0,2,1,0
Irmantas Stumbrys,1,1,1998-04-21,0,1,0,0
Igors Sļesarčuks,1,1,1998-04-21,1,0,0,0
Kristen Viikmäe,4,4,2004-09-04,3,1,0,0
Sergei Terehhov,4,3,2005-03-30,2,2,0,0
Youssef Chippo,1,1,1998-06-10,0,1,1,0
Abdeljalil Hadda,6,4,2001-04-21,5,1,0,0
Pierre Njanka,1,1,1998-06-11,1,0,0,0
Pierre Issa,1,1,1998-06-12,1,0,1,0
Thierry Henry,34,29,2009-10-14,21,13,0,2
Andoni Zubizarreta,1,1,1998-06-13,0,1,1,0
Mario Stanić,3,3,1999-10-09,2,1,0,0
Robbie Earle,1,1,1998-06-14,1,0,0,0
Rivaldo,21,18,2003-11-16,17,4,0,3
Håvard Flo,1,1,1998-06-16,0,1,0,0
Craig Burley,2,2,1998-10-14,2,0,0,0
Luigi Di Biagio,2,2,2000-06-19,2,0,0,0
David Trezeguet,14,12,2006-10-11,9,5,0,0
Victor Ikpeba,3,2,2000-01-23,3,0,0,0
Léider Preciado,1,1,1998-06-22,1,0,0,0
Michael Owen,27,22,2007-09-12,14,13,0,1
Emmanuel Petit,3,3,1999-06-05,3,0,0,0
Celso Ayala,2,2,2000-04-26,1,1,0,0
Fernando Morientes,12,9,2007-03-24,10,2,0,0
Georgi Bachev,1,1,1998-06-24,1,0,1,0
Slobodan Komljenović,3,3,2000-06-21,1,2,0,0
Mauricio Pineda,1,1,1998-06-26,1,0,0,0
Darren Anderton,1,1,1998-06-26,0,1,0,0
David Beckham,13,13,2006-06-25,7,6,0,3
Ebbe Sand,13,9,2002-10-12,9,4,0,0
Thomas Helveg,1,1,1998-06-28,0,1,0,0
Tijani Babangida,5,3,2001-07-29,5,0,0,0
Edgar Davids,2,2,2002-09-07,2,0,0,0
Javier Zanetti,2,2,2004-10-09,2,0,0,0
Martin Jørgensen,7,7,2005-06-08,2,5,0,1
Lilian Thuram,2,1,1998-07-08,2,0,0,0
Boudewijn Zenden,4,4,2001-09-05,4,0,0,0
Elvir Baljić,10,6,2003-04-02,4,6,0,2
Cătălin Munteanu,1,1,1998-09-02,1,0,0,0
Modestus Haas,1,1,1998-09-02,1,0,1,0
Tigran Yesayan,3,2,1999-10-09,2,1,0,0
Jesús Julián Lucendo,1,1,1998-09-05,0,1,0,1
Avi Nimni,6,6,2005-09-07,0,6,0,1
Mirsad Hibić,1,1,1998-09-05,0,1,1,0
Sergej Barbarez,11,10,2006-09-02,4,7,0,1
Panayiotis Engomitis,2,2,1999-09-05,2,0,0,0
Jonatan Johansson,11,11,2009-10-14,6,5,0,0
Ríkharður Daðason,5,5,2001-06-06,5,0,1,0
Martin Fabuš,2,2,1999-06-09,1,1,0,0
Andreas Andersson,2,2,2001-09-05,1,1,0,0
Johan Mjällby,3,3,2000-06-10,2,1,0,0
Tayfur Havutçu,6,5,2000-10-07,1,5,0,2
Serhiy Skachenko,2,2,1998-10-14,2,0,0,0
Yevgeni Varlamov,1,1,1998-09-05,0,1,0,0
Diego Fuser,2,2,1999-09-08,1,1,0,0
Sylwester Czereszewski,2,1,1998-09-06,0,2,0,0
Tomasz Iwan,3,3,1999-06-09,1,2,0,0
Ferenc Horváth,4,3,2000-10-11,3,1,0,0
Risto Božinov,2,1,1998-09-06,2,0,0,0
Andrejs Štolcers,4,4,2001-03-24,1,3,0,0
Heimana Paama,1,1,1998-09-25,1,0,1,0
Brad Maloney,2,1,1998-09-28,2,0,0,0
Alvin Ceccoli,1,1,1998-09-28,1,0,0,0
Scott Chipperfield,10,8,2008-09-10,8,2,0,0
Troy Halpin,1,1,1998-09-28,1,0,0,0
Tinol Christie,1,1,1998-09-28,1,0,0,0
Rupert Ryan,2,1,1998-09-28,2,0,0,0
Peter Roronamahava,1,1,1998-09-28,0,1,0,0
Che Bunce,2,2,2004-06-06,1,1,0,0
Heath Dickinson,1,1,1998-09-30,1,0,1,0
Kameli Kilalwaca,1,1,1998-09-30,1,0,0,0
Nasema,1,1,1998-09-30,1,0,0,0
Gerald Quennet,3,1,1998-09-30,3,0,0,0
Teva Zaveroni,2,2,2002-07-12,1,1,0,0
Harold Amaru,3,3,2001-06-04,2,1,0,0
Edwin Rarai,1,1,1998-09-30,0,1,0,0
Hiro Labaste,1,1,1998-10-02,0,1,0,0
Danny Hay,1,1,1998-10-02,1,0,0,0
Mark Burton,6,5,2002-07-12,5,1,0,0
Shailend Lal,1,1,1998-10-04,0,1,0,0
Ulaisi Seruvatu,1,1,1998-10-04,0,1,0,0
Pál Dárdai,2,2,2006-09-06,0,2,0,0
István Pisont,1,1,1998-10-10,0,1,0,0
Miklós Fehér,4,2,2000-10-11,0,4,0,0
Miroslav Baranek,1,1,1998-10-10,0,1,0,0
Marko Topić,1,1,1998-10-10,1,0,0,0
Harald Cerny,3,2,2003-06-11,1,2,0,0
Søren Frederiksen,1,1,1998-10-10,1,0,0,0
Ady Williams,1,1,1998-10-10,0,1,0,0
Craig Bellamy,7,6,2009-10-10,2,5,0,0
Miroslav Sovič,1,1,1998-10-10,0,1,0,0
Róbert Tomaschek,3,2,2001-03-24,0,3,0,0
Dario Šimić,2,2,2003-09-10,0,2,0,0
Davor Vugrinec,4,3,2001-06-02,2,2,0,0
Keith Rowland,1,1,1998-10-10,1,0,0,0
Jerzy Brzęczek,2,2,1999-03-27,1,1,0,0
Nicolas Anelka,9,9,2009-11-14,4,5,0,0
Robert Pires,6,6,2003-06-26,5,1,0,1
Igor Yanovsky,1,1,1998-10-10,1,0,0,0
Alain Boghossian,1,1,1998-10-10,0,1,0,0
Alon Mizrahi,6,5,2000-09-03,5,1,0,0
Najwan Ghrayib,2,2,1999-06-06,1,1,0,0
Billy Dodds,7,5,2001-03-28,6,1,0,1
Maksim Smirnov,2,2,2005-09-03,1,1,0,0
Dževdet Šainovski,1,1,1998-10-14,0,1,0,0
Argo Arbeiter,1,1,1998-10-14,0,1,0,0
Vincent Candela,1,1,1998-10-14,1,0,0,0
Nikos Liberopoulos,6,6,2007-10-13,4,2,0,0
János Hrutka,1,1,1998-10-14,1,0,0,0
Yuri Kovtun,2,2,2001-06-02,2,0,1,0
Alon Hazan,1,1,1998-10-14,1,0,0,0
Joseba Etxeberria,8,7,2003-11-19,2,6,0,0
Martin Telser,1,1,1998-10-14,1,0,0,0
Gurban Gurbanov,5,4,2003-06-11,2,3,0,1
Muhamed Konjić,2,2,2001-10-07,1,1,0,0
Gareth Southgate,1,1,1998-10-14,0,1,0,0
Alexandru Guzun,1,1,1998-10-14,1,0,0,0
Alban Bushi,6,5,2004-10-13,4,2,0,0
Robbie Keane,44,32,2015-09-04,28,16,0,10
Gary Breen,4,4,2002-06-11,2,2,0,0
Christian Mayrleb,4,3,2004-10-13,2,2,0,0
Martin Hiden,1,1,1998-10-14,0,1,0,0
Eduard Glieder,3,3,2001-04-25,2,1,0,0
Andy Selva,7,7,2008-10-11,6,1,0,1
Abel Xavier,2,2,1999-10-09,1,1,0,0
Ole Tobiasen,1,1,1998-10-14,0,1,0,0
Igor Nikolovski,2,2,2001-06-06,0,2,0,0
Paul Sixsmith,1,1,1998-11-18,1,0,0,0
Vladimir Gaidamașciuc,1,1,1998-11-18,0,1,0,0
Vassos Melanarkitis,1,1,1999-02-10,1,0,0,0
Michalis Konstantinou,22,16,2010-09-03,10,12,0,4
Marios Christodoulou,2,2,2000-11-15,2,0,0,0
Albert Nađ,2,1,1999-02-10,0,2,0,0
Paulo Madeira,3,2,1999-03-31,1,2,0,0
Pauleta,25,18,2006-06-11,17,8,0,0
Steinar Dagur Adolfsson,1,1,1999-03-27,0,1,0,0
Sébastien Fournier,2,2,2000-10-07,1,1,0,0
Michal Horňák,1,1,1999-03-27,1,0,0,0
Filippo Inzaghi,22,15,2007-06-02,12,10,0,2
Antonio Conte,2,2,2000-06-11,0,2,0,0
Zaza Janashia,2,2,1999-04-28,2,0,0,0
Aleksander Knavs,3,3,2003-09-06,1,2,0,0
József Sebők,1,1,1999-03-27,1,0,0,0
Vilmos Sebők,6,4,2001-06-06,6,0,0,3
Marco Bode,5,4,2002-06-11,1,4,0,0
Steve Morrow,1,1,1999-03-27,0,1,1,0
Ismael Urzaiz,6,3,1999-09-08,5,1,0,0
Fran,2,2,1999-03-31,1,1,0,0
Florentin Petre,4,4,2008-10-11,2,2,0,0
Sylvain Wiltord,15,14,2005-10-12,11,4,0,0
Jens Jeremies,1,1,1999-03-31,1,0,0,0
Oliver Neuville,4,4,2006-06-14,4,0,0,0
Artūras Fomenka,2,2,2001-06-06,2,0,0,0
Freddie Ljungberg,12,10,2007-10-13,5,7,0,1
Yegor Titov,6,6,2003-10-11,5,1,0,0
Juli Sánchez,1,1,1999-03-31,0,1,0,0
Matt Elliott,2,2,2000-10-07,0,2,1,0
Vladyslav Vashchuk,1,1,1999-03-31,1,0,0,0
Lárus Sigurðsson,1,1,1999-03-31,0,1,0,0
Martin Amerhauser,1,1,1999-04-28,1,0,0,0
Steffen Iversen,17,14,2008-09-06,7,10,0,3
Mehmet Scholl,3,3,2000-09-02,3,0,0,0
Oleg Șișchin,1,1,1999-06-04,0,1,0,0
Tomasz Hajto,1,1,1999-06-04,1,0,0,0
Zaur Tagizade,3,3,2001-06-06,3,0,0,0
Mirbağır İsayev,1,1,1999-06-05,1,0,0,0
Jan Heintze,2,2,2001-03-24,1,1,0,0
Jan Koller,33,25,2008-06-15,18,15,0,2
Allan Johnston,2,2,1999-06-09,0,2,0,0
Hans Fróði Hansen,1,1,1999-06-05,1,0,0,0
Hannu Tihinen,4,4,2009-09-05,3,1,0,0
Aleksandr Panov,2,1,1999-06-05,0,2,0,0
Dimitris Mavrogenidis,1,1,1999-06-05,0,1,0,0
Rúnar Kristinsson,1,1,1999-06-05,1,0,0,0
Capucho,1,1,1999-06-05,1,0,0,0
Mirco Gennari,1,1,1999-06-05,1,0,1,0
Gaizka Mendieta,7,6,2002-06-12,5,2,0,2
Yuriy Dmytrulin,1,1,1999-06-05,1,0,0,0
Nicky Saliba,1,1,1999-06-08,0,1,0,0
Darko Kovačević,2,2,2002-10-16,2,0,0,0
Georgi Markov,1,1,1999-06-09,1,0,0,0
Paul Ritchie,1,1,1999-06-09,0,1,0,0
Tomáš Řepka,1,1,1999-06-09,1,0,0,0
Māris Verpakovskis,24,19,2012-10-12,10,14,0,1
Andreas Niniadis,1,1,1999-06-09,1,0,0,1
Rafał Siadaczka,1,1,1999-06-09,0,1,0,0
Artur Wichniarek,1,1,1999-06-09,0,1,0,0
Marc Birsens,1,1,1999-06-09,1,0,0,0
Jean-Pierre Vanek,1,1,1999-06-09,1,0,0,0
Ionel Ganea,9,8,2003-09-06,4,5,0,1
Ion Vlădoiu,1,1,1999-06-09,1,0,0,0
Laurenţiu Roşu,3,3,2006-09-02,2,1,0,0
Jon Dahl Tomasson,36,29,2010-06-24,16,20,0,5
Stig Tøfting,2,2,1999-11-13,0,2,0,1
Roberto Holsen,4,3,2001-07-18,3,1,0,0
Atsuhiro Miura,1,1,1999-06-29,0,1,0,0
Emerson,1,1,1999-06-30,1,0,0,0
Márcio Amoroso,4,3,1999-07-14,3,1,0,0
Ronaldinho,17,14,2007-10-17,13,4,0,5
Martín Palermo,5,4,2010-06-22,3,2,0,0
Iván Kaviedes,9,9,2007-11-21,4,5,0,0
Víctor Bonilla,4,4,2001-04-24,1,3,0,0
Roque Santa Cruz,21,18,2013-09-10,17,4,0,0
Ysrael Zúñiga,2,2,2000-02-14,1,1,0,0
Alexsandro de Souza,9,7,2004-07-18,8,1,0,1
Isaac Terrazas,1,1,1999-07-03,0,1,0,0
Iván Córdoba,3,3,2001-07-29,2,1,0,2
Edwin Congo,2,2,2004-07-12,0,2,0,0
Johnnier Montaño,1,1,1999-07-04,0,1,0,0
Daniel Osorno,6,6,2004-11-17,4,2,0,0
Gabriel Urdaneta,3,3,2004-10-14,1,2,0,1
Kily González,6,6,2004-07-25,5,1,0,3
Nolberto Solano,9,9,2004-10-13,5,4,0,2
Gerardo Torrado,5,5,2009-07-26,4,1,0,1
Jorge Bolaño,1,1,1999-07-11,0,1,0,0
Daniel Alejandro Lembo,1,1,1999-07-13,1,0,0,0
Rivaldo Vítor Borba Ferreira,1,1,1999-07-14,0,1,0,0
Raúl Palacios,1,1,1999-07-17,1,0,0,0
Miguel Zepeda,5,4,2000-09-03,3,2,0,0
Chris Zoricich,1,1,1999-07-24,1,0,0,0
Limberg Gutiérrez,3,3,2005-10-12,1,2,0,0
Renny Ribera,1,1,1999-07-25,1,0,0,0
José Manuel Abundis,6,6,2001-06-16,6,0,0,0
Nawaf Al-Temyat,4,3,2000-10-24,1,3,0,1
Pável Pardo,8,7,2009-03-28,7,1,0,1
Michael Preetz,1,1,1999-07-28,1,0,0,0
Marzouk Al-Otaibi,8,4,2001-02-08,2,6,0,0
Marcos Paulo,1,1,1999-07-30,0,1,0,0
Ben Olsen,1,1,1999-07-30,1,0,0,0
João Carlos dos Santos,1,1,1999-08-01,1,0,0,0
Rôni,2,2,1999-08-04,1,1,0,0
Paul Bravo,1,1,1999-08-03,1,0,0,0
Serginho,1,1,1999-08-04,0,1,0,1
Milan Osterc,4,4,2001-11-10,3,1,0,0
Dejan Stanković,9,7,2010-09-03,3,6,0,1
Devi Muka,1,1,1999-09-04,1,0,0,0
Vasili Baranov,1,1,1999-09-04,1,0,0,0
Don Hutchison,4,4,2000-10-07,1,3,0,0
Steve McManaman,3,2,2000-06-12,2,1,0,0
Raio Piiroja,9,9,2011-09-06,4,5,3,0
Janne Salli,1,1,1999-09-04,1,0,0,0
Hermann Hreiðarsson,5,5,2006-09-02,1,4,0,0
Eiður Guðjohnsen,21,19,2015-03-28,13,8,0,2
Vladimír Labant,2,2,1999-10-09,1,1,0,1
Liviu Ciobotariu,1,1,1999-09-04,0,1,0,0
Milenko Ačimovič,9,7,2004-09-04,9,0,0,1
Walid Badir,4,4,2005-03-30,3,1,0,0
Yossi Benayoun,17,12,2011-06-04,13,4,0,2
Justo Ruiz,2,2,2000-10-07,2,0,0,2
Lilian Laslandes,1,1,1999-09-08,0,1,0,0
Mikheil Kavelashvili,1,1,1999-09-08,1,0,0,0
Imants Bleidelis,6,5,2005-06-08,5,1,0,0
Gábor Egressy,1,1,1999-09-08,1,0,0,0
Thomas Sowunmi,1,1,1999-09-08,1,0,0,0
Nir Sivilia,1,1,1999-09-08,1,0,0,0
Yossi Abukasis,2,2,2000-10-11,2,0,0,0
Brian Said,5,5,2008-09-06,3,2,2,0
Sergiu Epureanu,1,1,1999-09-08,1,0,0,0
Ljubinko Drulović,2,2,2000-06-13,1,1,0,0
Rudi Istenič,1,1,1999-09-08,1,0,1,0
Szilárd Németh,13,11,2005-11-12,10,3,0,0
Miroslav Karhan,9,8,2011-06-04,7,2,0,1
César Martín,2,2,1999-10-10,2,0,0,0
Costas Costa,1,1,1999-10-09,0,1,0,0
Ivaylo Petkov,1,1,1999-10-09,1,0,0,0
Rumen Hristov,1,1,1999-10-09,1,0,0,0
Pavel Verbíř,1,1,1999-10-09,1,0,0,0
Jeff Whitley,2,2,2004-09-08,0,2,0,0
Sami Hyypiä,4,4,2006-10-11,3,1,0,0
Goran Stavrevski,2,2,2000-09-03,2,0,1,0
Gary McSwegan,1,1,1999-10-09,1,0,0,0
Colin Cameron,2,2,2001-03-28,2,0,0,0
Alexandre Rey,4,2,2004-09-04,3,1,0,0
Patrick Bühlmann,1,1,1999-10-09,0,1,0,0
Brian Steen Nielsen,2,2,1999-11-17,1,1,0,0
Miran Pavlin,2,2,2000-06-13,0,2,0,0
Marc-Vivien Foé,6,6,2002-02-07,3,3,0,0
Shiva N'Zigou,2,2,2003-11-15,1,1,0,0
Dumisa Ngobe,1,1,2000-01-23,1,0,0,0
Henri Camara,16,13,2008-06-21,7,9,0,0
Pape Sarr,1,1,2000-01-25,0,1,0,0
Salif Keita,1,1,2000-01-25,0,1,0,0
Otto Addo,1,1,2000-01-27,1,0,0,0
Raymond Kalla,1,1,2000-01-28,1,0,0,0
Samuel Eto'o,40,33,2013-03-23,30,10,0,7
Farid Ghazi,1,1,2000-01-29,1,0,0,0
Bruno Zita Mbanangoyé,4,4,2012-01-27,2,2,0,0
Bonaventure Kalou,4,4,2006-06-21,3,1,0,1
Ismaël Koudou,1,1,2000-02-01,0,1,0,0
Ahmed Salah Hosny,1,1,2000-02-01,1,0,0,0
Abdel Halim Ali,4,3,2005-06-05,3,1,0,0
Laughter Chilembe,1,1,2000-02-01,1,0,0,0
Abdoulaye M'Baye,1,1,2000-02-01,0,1,0,0
Fawzi Moussouni,1,1,2000-02-02,0,1,0,0
Julius Aghahowa,10,9,2005-03-26,5,5,0,0
Radhi Jaïdi,4,4,2008-06-15,2,2,0,0
Siyabonga Nomvethe,8,7,2005-07-10,5,3,0,0
Khalilou Fadiga,4,4,2005-03-26,2,2,0,1
Gonzalo Martínez,1,1,2000-02-12,1,0,0,0
Ali Zitouni,8,6,2004-06-05,4,4,0,0
Harold Wallace,1,1,2000-02-13,1,0,0,0
Rafael Márquez,13,13,2016-11-11,8,5,0,0
Shurland David,1,1,2000-02-13,1,0,1,0
Raphael Chukwu,1,1,2000-02-13,1,0,0,0
Sébastien Vorbe,1,1,2000-02-14,1,0,0,0
Samuel Caballero,8,8,2005-07-12,3,5,0,0
Guillermo Ramírez,6,6,2011-11-15,2,4,0,0
David Nakhid,1,1,2000-02-15,1,0,0,0
Emilio Mora,1,1,2000-02-17,1,0,0,0
Erick Miranda,1,1,2000-02-17,0,1,0,0
Lee Dong-gook,18,15,2012-09-11,12,6,0,1
Reynaldo Clavasquín,1,1,2000-02-19,1,0,0,0
José Luis Pineda,2,2,2001-02-28,1,1,0,0
Waldir Sáenz,1,1,2000-02-19,0,1,0,0
Chris Armas,1,1,2000-02-19,1,0,0,0
Gerardo Bedoya,3,3,2001-07-26,1,2,0,0
Mickey Trotman,1,1,2000-02-20,0,1,0,0
Richard Hastings,1,1,2000-02-20,0,1,0,0
Marcial Salazar,1,1,2000-02-23,1,0,1,0
Jason de Vos,3,3,2004-09-04,2,1,0,0
Iván Guerrero,3,3,2005-07-21,1,2,0,0
Marvin Andrews,7,7,2005-09-03,3,4,1,0
Anton Haven,2,2,2000-03-19,1,1,0,0
George Moussis,1,1,2000-03-05,0,1,0,0
Kevin Davies,2,2,2000-03-19,1,1,0,0
Kenneth Hughes,1,1,2000-03-05,1,0,0,1
Jerry Alexander,7,4,2000-05-07,4,3,0,0
Anthony Modeste,3,2,2004-02-28,1,2,0,0
Paul Cam,1,1,2000-03-05,0,1,0,0
Avondale Williams,3,2,2008-03-30,1,2,0,1
Ariel Álvarez,1,1,2000-03-05,1,0,0,0
Serguei Prado,1,1,2000-03-05,1,0,0,0
Miguel Gandara,1,1,2000-03-05,1,0,0,0
Miguel Pérez,1,1,2000-03-05,1,0,0,0
Carlos Reyes,1,1,2000-03-05,1,0,0,0
Roberto Guadalupe Martínez,1,1,2000-03-05,1,0,0,0
William Torres,2,2,2008-09-06,2,0,0,0
Renne Regis,1,1,2000-03-05,1,0,0,0
Kenlyn Gonsalves,2,2,2000-03-19,1,1,0,0
Raphel Ortiz,2,2,2000-03-18,1,1,0,0
Carlos Astondoa,1,1,2000-03-11,0,1,0,0
Theodore Filomina,2,1,2000-03-11,2,0,0,0
Oswalding Mackay,1,1,2000-03-11,1,0,0,0
Jean-Robert Menelas,4,2,2000-04-01,4,0,0,0
Angelo Martina,1,1,2000-03-18,1,0,0,0
Llewellyn Riley,5,4,2000-10-08,3,2,0,0
Norman Forde,1,1,2000-03-18,0,1,0,0
Franklyn Baptiste,1,1,2000-03-18,1,0,0,0
Carlos Geerman,1,1,2000-03-18,1,0,1,0
Mark Mackay,1,1,2000-03-18,0,1,0,0
Santana Vander Kross,1,1,2000-03-18,0,1,0,0
Alexis Saddler,3,1,2000-03-18,3,0,0,1
George Isaac,6,5,2004-09-04,5,1,0,0
Leroy Francis,2,2,2000-03-21,2,0,0,0
Michael Crawford,1,1,2000-03-18,1,0,0,0
John Smith,2,2,2000-03-21,2,0,0,0
Richard O'Connor,1,1,2000-03-19,0,1,0,1
Freddy García,9,7,2011-11-11,7,2,0,0
Emory Núñez,1,1,2000-03-19,1,0,0,0
Devarr Boyles,1,1,2000-03-19,1,0,0,0
Tokia Russell,1,1,2000-03-19,1,0,0,0
Meshach Wade,2,2,2004-02-29,2,0,0,0
Shannon Burgess,4,4,2004-06-20,4,0,0,2
Stanton Lewis,1,1,2000-03-19,1,0,0,0
Stephen Astwood,2,1,2000-03-19,2,0,0,0
John Barry Nusum,12,7,2011-10-11,7,5,0,0
Kelvyn Peters,1,1,2000-03-19,1,0,0,0
Roosevelt Desir,1,1,2000-03-19,0,1,0,0
Luis Omar Sanchez,1,1,2000-03-19,0,1,0,0
Vladimir Gregorio,1,1,2000-03-19,0,1,0,0
Wayne Dyer,1,1,2000-03-19,1,0,0,0
Mario Méndez,1,1,2000-03-19,0,1,0,0
Alberto Doesburg,1,1,2000-03-19,1,0,0,0
Joaquim Santos,1,1,2000-03-19,1,0,0,0
Austin Huggins,3,2,2004-02-18,2,1,0,0
Rodrigo Tello,1,1,2000-03-29,0,1,0,0
Pablo García,2,2,2007-07-07,1,1,0,0
Wandel Gross,1,1,2000-04-01,1,0,0,0
Gabriel Michel,3,1,2000-04-01,3,0,0,0
Vladimir Edouard,3,2,2000-04-16,1,2,0,0
Osmin Hernández,1,1,2000-04-02,1,0,0,0
Mahad Khaireh,1,1,2000-04-07,1,0,0,0
Ngidi Yemweni,5,3,2000-07-09,4,1,0,0
Salem Ould Ely,1,1,2000-04-07,1,0,0,0
Harry Randrianaivo,3,2,2000-06-17,3,0,0,0
Dereck Somanje,1,1,2000-04-08,1,0,0,0
Jones Nkhwazi,1,1,2000-04-08,1,0,0,0
Philip Zialor,3,3,2008-09-06,3,0,0,0
Amilcar Ramos,1,1,2000-04-08,1,0,0,0
Celso Pontes,1,1,2000-04-08,1,0,0,0
Samuel Kuffour,2,2,2000-04-23,1,1,0,0
Pablo Thiam,1,1,2000-04-08,0,1,0,0
Souleymane Youla,5,4,2008-01-28,2,3,0,0
Hassan Mubiru,2,2,2003-10-11,2,0,0,0
Majid Musisi,1,1,2000-04-08,1,0,0,0
Abubaker Tabula,1,1,2000-04-08,1,0,0,0
Pascal Feindouno,19,15,2009-06-21,10,9,0,4
Jamil Kyambadde,1,1,2000-04-08,1,0,0,0
Moussa N'Diaye,4,4,2005-03-26,2,2,0,0
Jonas Okétola,1,1,2000-04-09,1,0,0,0
Mohamed Emara,1,1,2000-04-09,1,0,0,0
Mohamed Farouk,3,2,2000-04-23,3,0,0,0
George Ngoma Nanitelamio,1,1,2000-04-09,0,1,0,0
Jean-Silvestre N'Keoua,1,1,2000-04-09,0,1,0,0
Remo Eyoma,1,1,2000-04-09,1,0,0,0
Modeste Eta,1,1,2000-04-09,0,1,0,0
Felipe Cata Edson,1,1,2000-04-09,0,1,0,0
Anteneh Alameraw,1,1,2000-04-09,1,0,0,0
Sentayehu Getachew,1,1,2000-04-09,1,0,0,0
Amadou Touré,2,2,2004-06-20,0,2,0,0
Bouchaib El Moubarki,1,1,2000-04-09,0,1,0,0
Jabu Pule,1,1,2000-04-09,0,1,0,0
Jehad Muntasser,2,2,2001-01-28,1,1,0,0
Ahmed Al Masli,5,3,2003-11-16,4,1,0,0
Khaled Mhemed,1,1,2000-04-09,1,0,0,0
Ghislain Akassou,1,1,2000-04-09,0,1,0,0
Hassan Mili,1,1,2000-04-09,1,0,0,0
Julien Nsengiyumva,1,1,2000-04-09,1,0,0,0
Fadel Keïta,2,2,2001-07-01,1,1,0,0
Faroug Jabra,1,1,2000-04-09,1,0,0,0
Elmer Martínez,1,1,2000-04-16,0,1,0,0
Bent Burgess,1,1,2000-04-16,1,0,0,0
Nigel Pierre,3,3,2000-11-15,2,1,0,1
Luis Alfredo Ramírez,1,1,2000-04-16,0,1,0,0
Marlon James,4,4,2008-06-20,3,1,0,0
Isâad Bourahli,2,2,2004-10-09,1,1,0,0
Rafik Saïfi,5,5,2009-09-06,4,1,0,0
Daniel Cousin,5,5,2012-01-27,3,2,0,0
Abdelfattah El Khattari,2,1,2000-04-22,2,0,0,0
Razundara Tjikuzu,4,2,2001-02-24,4,0,0,0
Benedict Akwuegbu,2,2,2000-06-17,2,0,0,0
Garba Lawal,4,4,2006-02-09,3,1,0,0
Nwankwo Kanu,6,6,2005-10-08,5,1,0,1
Chernor Mansaray,2,1,2000-04-22,2,0,0,0
Sidique Mansaray,2,2,2001-04-21,2,0,0,0
Bilal Sidibé,1,1,2000-04-22,1,0,1,0
Ziad Jaziri,9,8,2006-06-14,7,2,0,0
Imed Mhedhebi,4,4,2001-07-01,2,2,0,0
Harry Milanzi,5,5,2004-06-19,3,2,0,0
Hélder Vicente,1,1,2000-04-23,1,0,0,0
Isaac Boelua Lokuli,2,1,2000-04-23,2,0,0,0
Siza Dlamini,3,3,2008-06-08,2,1,0,0
Victor Covilhã,1,1,2000-04-23,1,0,0,0
Gayson Gregory,4,3,2008-02-06,2,2,0,0
Robert Jama Mba,2,1,2000-04-23,2,0,0,0
Salomon Olembé,4,3,2002-02-07,2,2,0,0
Bedel Moyimbouabeka,1,1,2000-04-23,1,0,0,0
Casiano Mba,1,1,2000-04-23,0,1,0,0
Ulrich Lepaye,1,1,2000-04-23,1,0,0,0
Jason Mayélé,3,2,2000-07-09,3,0,0,0
Hared Robleh,1,1,2000-04-23,0,1,0,0
Shabani Nonda,11,7,2008-06-22,9,2,0,1
Michél Mazingu-Dinzey,1,1,2000-04-23,1,0,0,0
Lwata Mpia,1,1,2000-04-23,1,0,0,0
Jacques-Désiré Périatambée,1,1,2000-04-23,0,1,0,0
Jean-Sebastien Bax,1,1,2000-04-23,0,1,0,0
Walid Salah Abdel Latif,1,1,2000-04-23,1,0,0,0
John Lungu,1,1,2000-04-23,0,1,0,0
Ally Abubakari,1,1,2000-04-23,0,1,0,0
Daniel Addo,1,1,2000-04-23,1,0,0,0
Faisal Bushaala,1,1,2000-04-23,0,1,0,0
Brehima Traoré,2,1,2000-04-23,2,0,0,0
Yaya Dissa,1,1,2000-04-23,1,0,0,0
Mujahid Ahmed,3,3,2003-10-11,2,1,0,0
Cheikh Ba,1,1,2000-04-23,1,0,0,0
Moustapha Salifou,6,6,2009-09-06,4,2,0,0
Salam Kouko,1,1,2000-04-23,1,0,0,0
Togbe Dovi-Akon,1,1,2000-04-23,1,0,0,0
Nqobizitha Ncube,1,1,2000-04-23,1,0,0,0
Luciano Djim,1,1,2000-04-23,0,1,0,0
Luke Jukulile,1,1,2000-04-23,1,0,0,0
Jairo Castillo,3,3,2000-09-02,1,2,0,0
Antônio Carlos Zago,2,2,2000-06-04,1,1,0,0
Ulises de la Cruz,4,4,2005-03-30,1,3,0,0
Juan Jayo,1,1,2000-04-26,0,1,0,0
Ēriks Pelcis,1,1,2000-04-26,0,1,0,0
Vidas Dančenka,1,1,2000-04-26,1,0,0,0
Roberto Ayala,6,6,2007-07-15,2,4,3,0
Phillip Skeal,1,1,2000-05-07,0,1,1,0
Dieuphane Thelamour,1,1,2000-05-19,1,0,0,0
Neftali Díaz,1,1,2000-05-21,1,0,0,0
Roberto Brown,7,7,2005-03-26,5,2,0,1
Vincent John,1,1,2000-05-21,1,0,0,0
Francisco Antonio Pavón,1,1,2000-06-03,1,0,0,0
Delio Toledo,1,1,2000-06-03,1,0,0,0
Gustavo Adrián López,1,1,2000-06-04,1,0,0,0
Alexander Viveros,1,1,2000-06-04,1,0,0,0
Bart Goor,6,4,2003-06-11,6,0,0,0
Okan Buruk,8,8,2005-09-03,5,3,0,0
Nuno Gomes,18,13,2008-06-19,7,11,0,0
Francesco Totti,8,7,2006-06-26,5,3,0,2
Stefano Fiore,1,1,2000-06-14,0,1,0,0
Pape Seydou Diop,1,1,2000-06-16,0,1,0,0
Julio César de León,8,7,2009-10-10,4,4,0,1
Nathalie Suiverstin,1,1,2000-06-17,1,0,0,0
Daniel Chitsulo,2,2,2001-04-21,1,1,0,0
Costinha,1,1,2000-06-17,0,1,0,0
Andrew Sinkala,1,1,2000-06-18,0,1,0,0
Edgar Valencia,1,1,2000-06-18,1,0,0,0
Carlos Ruiz,47,30,2016-09-06,32,15,0,4
Desmond Bleau,1,1,2000-06-18,0,1,0,0
James Moga,3,3,2001-03-10,2,1,0,0
Paul Agostino,3,1,2000-06-19,3,0,0,0
Kevin Muscat,9,5,2001-11-20,8,1,0,4
Danny Tiatto,1,1,2000-06-19,1,0,0,0
David Zdrilic,17,6,2004-05-31,17,0,0,0
Tony Popovic,6,4,2001-04-16,6,0,0,0
Steve Corica,2,2,2001-04-14,2,0,0,0
Clayton Zane,6,3,2001-06-01,4,2,0,0
Kris Bouckenooghe,1,1,2000-06-19,0,1,0,0
Cristian Chivu,2,2,2002-09-07,0,2,0,0
Richard Iwai,9,6,2004-06-06,2,7,0,0
Chris Killen,10,6,2013-03-22,10,0,0,0
Jonathan Perry,2,2,2001-06-06,2,0,0,0
Dejan Govedarica,2,2,2000-06-25,2,0,1,0
Pedro Munitis,1,1,2000-06-21,0,1,0,0
Commins Menapi,12,7,2004-06-06,5,7,0,0
Daniel Shepherd,1,1,2000-06-21,0,1,0,0
Jack Samani,4,4,2004-05-12,3,1,0,0
Gideon Omokirio,5,5,2004-05-15,3,2,1,1
Henry Koto,1,1,2000-06-21,1,0,0,0
Jimmy Ben,2,2,2001-06-06,0,2,0,0
Georgina Tura,1,1,2000-06-22,0,1,0,0
Pablo Cardozo,1,1,2000-06-23,0,1,0,0
Shaun Murphy,3,3,2001-06-09,2,1,0,0
Lexa Bibi,2,2,2004-06-02,1,1,0,0
Miguel Mea Vitali,1,1,2000-06-28,1,0,0,0
Ruberth Morán,11,9,2005-06-08,9,2,0,0
Denis Caniza,1,1,2000-06-29,1,0,1,0
Frankie Oviedo,3,3,2004-06-02,1,2,0,0
Juan Pajuelo,3,3,2001-07-12,1,2,0,0
Marco Delvecchio,3,3,2001-06-02,1,2,0,0
Chaswe Nsofwa,3,3,2001-07-27,2,1,0,0
Patrice Abanda,1,1,2000-07-09,1,0,0,0
Charles Amoah,3,2,2001-07-01,2,1,0,0
Yaw Preko,1,1,2000-07-09,1,0,0,0
Ishmael Addo,1,1,2000-07-09,1,0,0,0
Christopher Wreh,2,1,2000-07-09,2,0,0,0
Delron Buckley,3,2,2005-06-04,0,3,0,0
Alejandro Madrigal,1,1,2000-07-16,0,1,0,0
Michael Forde,1,1,2000-07-16,1,0,0,0
Danilo Turcios,5,5,2005-07-16,3,2,0,0
David Suazo,11,9,2009-09-05,6,5,0,0
Ante Razov,4,4,2002-01-27,2,2,0,0
Onandi Lowe,7,7,2003-07-15,3,4,0,0
Carlos Humberto Paredes,8,8,2004-10-13,7,1,0,0
Jorge Luis Campos,2,2,2002-06-12,1,1,0,0
Daniel Noriega,2,2,2001-11-08,1,1,0,0
Darío Rodríguez,3,3,2005-11-12,3,0,0,0
Roger Suárez,3,3,2004-06-01,3,0,0,0
Juan Pablo Ángel,8,7,2005-09-04,6,2,0,2
Rolando Fonseca,16,13,2004-10-09,9,7,0,1
Jamal Ballantyne,1,1,2000-07-23,0,1,0,0
Francisco Ramírez,5,3,2000-11-14,2,3,0,0
Héctor Tapia,1,1,2000-07-25,0,1,0,0
Vampeta,2,1,2000-07-26,2,0,0,0
MaNicolás Oliveratias Almeyda,1,1,2000-07-26,0,1,0,0
Dwight Pezzarossi,8,7,2012-09-07,4,4,0,0
Paul Fenwick,1,1,2000-08-15,1,0,1,0
Pablo Aimar,6,6,2007-06-28,4,2,0,0
Amado Guevara,15,13,2009-09-05,10,5,0,4
Jorge Bengoché,1,1,2000-08-16,1,0,0,0
John O'Brien,3,3,2005-07-21,3,0,0,0
Emiliano González Arqués,1,1,2000-09-02,1,0,0,0
Ildefons Lima,8,8,2015-10-10,5,3,2,4
Anders Svensson,12,11,2013-09-06,9,3,0,0
Alexander Khatskevich,3,3,2001-03-28,3,0,0,0
Valentin Belkevich,3,3,2005-06-04,2,1,0,0
Gerard López,2,2,2000-10-07,1,1,0,0
Edvin Murati,3,3,2004-09-04,2,1,0,0
Aki Riihilahti,5,5,2005-03-26,3,2,0,0
Sebastian Deisler,2,2,2001-03-24,2,0,0,0
Morten Bisgaard,1,1,2000-09-02,0,1,0,0
Jeffrey Talan,1,1,2000-09-02,1,0,0,0
Giovanni van Bronckhorst,4,4,2010-07-06,2,2,0,0
Gabriel González,1,1,2000-09-02,1,0,0,0
Emre Belözoğlu,6,6,2012-09-11,3,3,0,1
Emmanuel Olisadebe,9,7,2002-06-14,4,5,0,0
Radosław Kałużny,6,4,2004-10-09,3,3,0,0
Pini Balili,3,3,2003-09-10,2,1,0,0
Neil McCann,3,3,2003-09-10,1,2,0,0
Walter Samuel,3,3,2001-11-08,3,0,1,0
Igor Demo,4,3,2004-08-18,4,0,0,0
Reynold Carrington,1,1,2000-09-03,1,0,0,0
Stokely Mason,1,1,2000-09-03,1,0,0,0
Federico Magallanes,3,3,2001-10-07,3,0,0,2
Argjend Beqiri,1,1,2000-10-06,1,0,0,0
Georgi Ivanov,3,2,2001-06-02,2,1,0,0
Svetoslav Todorov,2,2,2003-06-07,2,0,0,1
Dietmar Hamann,1,1,2000-10-07,0,1,0,0
Bob Peeters,4,2,2001-02-28,3,1,0,0
Jurgen Cavens,1,1,2000-10-07,0,1,0,0
Thomas Flögel,2,2,2001-04-25,1,1,0,0
Željko Milinovič,2,2,2001-09-05,0,2,0,0
Jeff Strasser,3,3,2008-09-10,1,2,0,0
David Healy,22,16,2012-11-14,15,7,0,3
Dennis Rommedahl,15,12,2011-10-07,4,11,0,0
Mikalay Ryndzyuk,2,2,2000-10-11,1,1,0,0
Matt Holland,4,4,2002-06-01,1,3,0,0
Marco Zwyssig,1,1,2000-10-07,1,0,0,0
Thorstein Helstad,4,4,2009-09-09,2,2,0,0
Mario Acevedo,1,1,2000-10-08,0,1,0,0
Jared Borgetti,37,26,2008-06-21,29,8,0,1
Duilio Davino,2,2,2004-06-19,1,1,0,0
Daniel Velasquez,1,1,2000-10-08,0,1,0,0
Jaime Vladimir Cubías,1,1,2000-10-08,0,1,0,0
Euller,1,1,2000-10-08,0,1,0,0
Juninho Paulista,1,1,2000-10-08,0,1,0,0
Jim Brennan,3,3,2004-06-16,3,0,0,0
Ervin Fakaj,1,1,2000-10-11,1,0,0,0
Michael Baur,4,3,2001-03-28,2,2,1,0
Rubén Baraja,3,2,2002-10-12,2,1,0,0
Felix Khojoyan,1,1,2000-10-11,0,1,0,0
Dimitar Berbatov,28,20,2009-10-14,14,14,0,1
Bruno Akrapović,1,1,2000-10-11,0,1,0,0
Yaniv Katan,2,2,2005-09-07,1,1,0,0
Krisztián Lisztes,5,4,2003-09-10,1,4,0,0
Mark Kinsella,2,2,2001-04-25,2,0,0,0
Richard Dunne,6,6,2011-10-11,3,3,0,0
Maksim Buznikin,1,1,2000-10-11,1,0,0,0
Dmitri Khokhlov,2,2,2001-03-24,2,0,0,0
Ermin Šiljak,10,7,2003-11-15,5,5,0,0
Lee Young-pyo,3,3,2005-03-30,3,0,0,0
Mohammed Gholam,1,1,2000-10-14,1,0,0,0
Mirjalol Qosimov,15,11,2004-11-17,7,8,0,1
Atsushi Yanagisawa,3,3,2005-06-16,1,2,0,0
Naohiro Takahara,10,7,2007-07-21,6,4,0,0
Ryuzo Morioka,1,1,2000-10-14,1,0,1,0
Shinji Ono,3,3,2004-09-08,1,2,0,0
Seksan Piturat,9,8,2001-10-21,5,4,0,0
Sabah Jeayer,4,2,2001-04-12,2,2,0,0
Abbas Chahrour,1,1,2000-10-15,1,0,0,0
Moussa Hojeij,4,4,2001-05-30,3,1,0,0
Shen Si,1,1,2000-10-16,1,0,0,1
Yang Chen,5,5,2001-05-13,5,0,0,0
Qi Hong,7,7,2001-09-27,5,2,0,0
Sergey Lushan,1,1,2000-10-17,0,1,0,0
Hideaki Kitajima,1,1,2000-10-17,1,0,0,0
Luís Fernandes,1,1,2000-10-18,1,0,0,0
Abdulnasser Al-Obaidly,2,2,2001-08-31,0,2,0,0
Mohammad Al-Shalhoub,9,5,2005-06-03,9,0,0,1
Kim Sang-sik,1,1,2000-10-23,0,1,0,0
Abbas Obeid,1,1,2000-10-24,0,1,0,0
Tomokazu Myojin,2,2,2000-10-26,1,1,0,0
Talal Al-Meshal,17,9,2004-10-12,13,4,0,0
Shigeyoshi Mochizuki,1,1,2000-10-29,1,0,0,0
Wilmer Velásquez,4,3,2005-07-16,3,1,0,0
Luis Santamaría,1,1,2000-11-14,0,1,0,0
Renán Bengoche,1,1,2000-11-14,0,1,0,0
Clint Mathis,3,3,2002-06-10,0,3,0,0
Roque Júnior,1,1,2000-11-15,1,0,0,0
Claudio Husaín,1,1,2000-11-15,0,1,0,0
Juan Carlos Padilla,1,1,2000-11-15,1,0,0,0
Pedro Alejandro García,1,1,2000-11-15,0,1,0,0
Ali Karimi,13,8,2011-07-23,8,5,0,0
Alireza Vahedi Nikbakht,5,5,2008-03-26,3,2,0,0
Sohrab Bakhtiarizadeh,3,2,2006-06-21,3,0,0,0
Denis Knitel,1,1,2000-11-26,1,0,0,0
Rustam Khojaev,3,1,2000-11-26,3,0,0,0
Sukhrob Hamidov,5,2,2003-11-26,4,1,0,1
Rahmatullo Fuzailov,1,1,2000-11-26,1,0,0,0
Zaker Berdykulov,2,1,2000-11-26,2,0,0,0
Shukhrat Jabbarov,1,1,2000-11-26,1,0,0,0
Rustam Usmonov,1,1,2000-11-26,1,0,0,0
Mehdi Hasheminasab,1,1,2000-11-28,1,0,0,0
Reynaldo Parks,1,1,2001-01-06,1,0,0,0
Djamel Belmadi,1,1,2001-01-26,1,0,0,0
Victor Agali,4,3,2001-07-29,4,0,0,0
Bodunha,2,1,2001-01-28,2,0,0,0
Frank Seator,1,1,2001-01-28,0,1,0,0
Emmanuel Duah,1,1,2001-01-28,1,0,0,0
Musa Shannon,1,1,2001-01-28,0,1,0,0
Ruphin Menakely,1,1,2001-01-28,1,0,0,0
Zéphirin Zoko,1,1,2001-01-28,0,1,0,0
Naser Al-Sauhi,1,1,2001-02-03,0,1,0,0
Yusuf A'Amer Al Sadi,5,4,2001-02-24,3,2,0,0
Ilia Kovalenko,2,2,2001-02-27,1,1,0,0
Noh Alam Shah,3,3,2007-11-18,1,2,0,0
Hussein Abdulghani,3,2,2004-10-12,2,1,0,0
Ali Asel,1,1,2001-02-09,0,1,0,0
Khalaf Al-Mutairi,2,2,2001-02-21,1,1,0,0
Mohd Noor Ali,1,1,2001-02-09,1,0,0,0
Nguyễn Hồng Sơn,5,3,2001-02-17,2,3,0,2
Rokonuzzaman Kanchan,1,1,2001-02-12,0,1,0,0
Nguyễn Văn Sỹ,1,1,2001-02-15,0,1,0,0
Nguyễn Trung Vĩnh,1,1,2001-02-15,0,1,0,0
Mohsin Harthi,1,1,2001-02-17,1,0,0,0
Nguyễn Lương Phúc,2,1,2001-02-17,2,0,0,0
Bayarzorig Davaa,1,1,2001-02-19,0,1,0,0
Mohammed Sujan,2,1,2001-02-19,2,0,0,0
Boldyn Buman-Uchral,1,1,2001-02-19,0,1,0,0
Zamirbek Jumagulov,1,1,2001-02-21,1,0,0,0
Mohamed Salmeen,3,3,2005-03-30,1,2,1,0
Mohammad Hassan,1,1,2001-02-21,0,1,0,0
Khalifa Khalifa,1,1,2001-02-23,1,0,0,0
Khaled Elfallah,2,1,2001-02-23,2,0,0,0
Komlan Amewou,2,2,2013-06-14,1,1,1,0
Zanzan Atte-Oudeyi,1,1,2001-02-23,0,1,0,0
Khamis Eid,1,1,2001-02-24,1,0,0,0
Moumouni Dagano,19,14,2009-11-14,10,9,0,2
Faraj Laheeb,3,2,2004-11-17,3,0,0,0
Ibrahim Said,1,1,2001-02-24,0,1,0,0
Zizi Roberts,2,2,2003-11-16,2,0,0,0
Patrick Mabedi,2,2,2004-09-04,1,1,0,1
Maher Kanzari,1,1,2001-02-25,1,0,0,0
Mohamed Husain,4,4,2015-01-15,2,2,1,0
Rafi Ali,1,1,2001-02-27,0,1,0,0
Yves Vanderhaeghe,2,1,2001-02-28,2,0,0,0
Walter Baseggio,1,1,2001-02-28,1,0,0,0
Rodrigo Cordero,1,1,2001-02-28,1,0,0,0
Tyrone Marshall,2,2,2008-06-18,2,0,0,0
Josh Wolff,5,5,2005-07-16,4,1,0,0
Emad Ayoub,4,4,2001-03-25,1,3,0,0
Chan Ho Man,1,1,2001-03-04,1,0,0,0
Rosdi Talib,2,2,2004-02-18,1,1,0,0
Jassem Al-Tamimi,2,2,2001-03-25,2,0,0,0
Akmal Rizal Ahmad Rakhli,4,2,2001-03-25,2,2,0,1
Papy Okitankoy Kimoto,1,1,2001-03-10,1,0,0,0
El Hadji Diouf,15,10,2008-06-21,12,3,0,1
Khalid Bakhit,2,2,2001-07-29,1,1,0,0
Jones Mwewa,2,2,2001-07-14,2,0,0,0
Charles Lota,2,2,2001-04-21,2,0,0,0
Mohamed Barakat,4,3,2004-01-25,3,1,0,0
Abdel-Zaher El-Saqqa,2,2,2006-02-03,1,1,1,0
Tarek El-Said,5,4,2005-06-05,5,0,0,0
Feng Ji-zhi,2,2,2001-03-23,1,1,1,0
Mohammed Al-Jaish,2,2,2001-03-25,1,1,0,0
Sherif Touré Coubageat,1,1,2001-03-11,1,0,0,0
Benjani Mwaruwari,5,5,2006-01-31,3,2,0,0
Edzai Kasinauyo,1,1,2001-03-11,1,0,0,0
Fadi Lafi,1,1,2001-03-20,1,0,0,0
Keung He-chi,1,1,2001-03-23,1,0,0,0
Hairuddin Omar,2,2,2001-03-25,1,1,0,0
Abdul-Aziz Hassan,1,1,2001-03-23,1,0,0,0
Jimmy Floyd Hasselbaink,4,4,2002-09-07,2,2,0,1
Mark van Bommel,6,5,2009-06-06,2,4,0,0
Arthur Minasyan,1,1,2001-03-24,1,0,0,0
John Hartson,10,9,2004-10-13,6,4,0,1
Andrey Movsisyan,1,1,2001-03-24,1,0,0,0
Krassimir Chomakov,2,2,2001-03-28,2,0,0,0
Boško Balaban,8,5,2006-10-07,5,3,0,0
Gary Kelly,1,1,2001-03-24,0,1,0,0
Miroslav Klose,48,34,2014-07-08,29,19,0,0
Christian Høgni Jacobsen,1,1,2001-03-24,0,1,0,0
Kurt Mørkøre,1,1,2001-03-24,0,1,0,0
Claus Jensen,4,4,2005-09-07,1,3,0,0
John Carew,15,13,2011-10-11,10,5,0,1
Bartosz Karwan,3,3,2003-04-02,2,1,0,0
Daniel Van Buyten,7,6,2010-09-07,1,6,0,0
Iván Helguera,2,2,2003-04-02,2,0,0,0
Steven Bryce,4,4,2003-07-19,2,2,0,0
Jamal Al-Holi,1,1,2001-03-25,0,1,0,1
Irwan Fadzli Idrus,1,1,2001-03-25,1,0,0,0
Antonio de Nigris,2,1,2001-03-25,2,0,0,0
Meshal Mubarak,2,2,2011-07-23,2,0,0,0
Reinaldo Navia,4,4,2004-06-06,1,3,0,1
Andrés Mendoza,3,3,2003-09-09,2,1,0,0
Claudio Pizarro,10,9,2015-06-18,7,3,0,1
Andy Cole,1,1,2001-03-28,0,1,0,0
Kevin Kilbane,7,7,2010-09-07,3,4,1,0
Raman Vasilyuk,7,4,2007-06-06,5,2,0,2
Martin Petrov,15,12,2009-10-14,11,4,0,2
Stuart Elliott,3,3,2005-09-03,2,1,0,0
Cosmin Contra,8,6,2007-06-06,3,5,1,0
Marko Rehmer,3,3,2001-11-14,1,2,0,0
Angelos Charisteas,20,17,2011-10-11,12,8,0,2
Michael Ballack,27,26,2009-09-09,15,12,0,8
Almedin Hota,1,1,2001-03-28,0,1,0,0
Marcus Allbäck,19,13,2007-11-21,12,7,0,0
Igor Mitreski,1,1,2001-03-28,0,1,1,0
Ümit Davala,4,4,2002-10-16,2,2,0,0
Michał Żewłakow,3,3,2009-03-28,3,0,1,2
Marcin Żewłakow,4,4,2002-06-14,3,1,0,0
Vadim Vasilyev,2,2,2001-06-06,1,1,0,1
Ľubomír Meszároš,1,1,2001-03-28,1,0,0,0
Alexander Frei,24,20,2009-09-09,13,11,0,2
Johann Lonfat,1,1,2001-03-28,1,0,0,0
Guido Alvarenga,2,2,2001-07-18,0,2,0,1
Ali Umar,3,2,2004-09-08,3,0,0,0
Adam Abdulativ,2,1,2001-04-01,2,0,0,0
Ali Shiham,1,1,2001-04-01,1,0,0,0
Ashraf Luthfy,1,1,2001-04-01,1,0,0,0
Anwar Ahmed,1,1,2001-04-07,0,1,0,0
Adel Al-Salimi,5,3,2001-05-18,3,2,0,1
Ali Aboud Awad,1,1,2001-04-07,0,1,0,0
Ali Al-Nono,7,5,2007-11-09,4,3,0,0
Shailemdra Lal,5,1,2001-04-07,5,0,0,0
Ulaiasi Mateiwai,1,1,2001-04-07,1,0,0,0
Valerio Nasema,2,2,2001-04-16,1,1,0,0
Abinesh Samy,2,1,2001-04-07,2,0,0,0
Lokoua Taufahema,5,3,2011-11-24,0,5,0,0
Jules Alberto,2,2,2001-05-20,2,0,0,0
Agung Setyabudi,1,1,2001-04-08,1,0,0,0
Kurniawan Dwi Yulianto,4,4,2001-05-13,2,2,0,0
Bima Sakti,1,1,2001-04-08,1,0,0,0
Uston Nawawi,4,2,2001-04-22,4,0,0,0
Bambang Pamungkas,4,4,2011-11-15,3,1,0,0
Lisi Leututu,1,1,2001-04-09,0,1,1,0
Dominic Gabriel,1,1,2001-04-09,0,1,0,0
Desmond Fa'aiuaso,5,2,2015-08-31,1,4,0,0
Ben Lemana,2,2,2001-04-11,1,1,0,1
Junior Michael,3,3,2004-05-19,2,1,0,1
Tony Vidmar,2,2,2004-10-12,2,0,0,0
Archie Thompson,21,8,2012-10-16,18,3,0,0
Con Boutsianis,4,2,2001-04-11,4,0,0,0
Simon Colosimo,2,1,2001-04-11,2,0,0,0
Fausto De Amicis,2,2,2002-07-10,2,0,0,0
Ul Radike Mateiwai,1,1,2001-04-11,0,1,0,0
Manoa Masi,2,1,2001-04-11,0,2,0,0
Molesi Tokuma,1,1,2001-04-11,0,1,1,0
Atnesh Prasad,2,1,2001-04-11,0,2,0,0
Hesham Mohammed,9,3,2001-08-17,9,0,0,0
Ahmad Kadhim,3,2,2001-04-14,3,0,0,0
Oleg Litvinenko,4,3,2001-04-25,2,2,0,0
Rafael Urazbakhtin,1,1,2001-04-12,0,1,0,0
Yevgeniy Lunev,1,1,2001-04-12,0,1,0,0
Askhat Kadyrkulov,1,1,2001-04-12,0,1,0,0
Penieli Moa,1,1,2001-04-14,0,1,0,1
Teu Fakava,1,1,2001-04-14,0,1,0,0
Hayden Foxe,2,2,2001-04-16,2,0,0,0
Yaser Salem Ali,10,5,2001-10-04,4,6,0,0
Mohammad Omar,4,3,2001-10-19,1,3,0,0
Mohammad Ibrahim Hussain,1,1,2001-04-14,0,1,0,0
Subait Khater,3,3,2008-09-10,2,1,0,0
Abdulsalaam Jumaa,1,1,2001-04-14,0,1,0,0
Ali Momin,1,1,2001-04-14,0,1,1,0
Fahed Masoud,1,1,2001-04-14,0,1,0,0
Abdul-Wahab Abu Al-Hail,7,5,2001-10-05,5,2,0,3
Nirajan Rayamajhi,7,4,2001-04-25,2,5,0,0
Haidar Najim,1,1,2001-04-14,1,0,0,0
Emad Mohammed,10,10,2008-06-14,7,3,0,0
Igor Avdeyev,4,3,2005-06-04,4,0,1,0
Konstantin Gorovenka,3,3,2001-04-23,3,0,0,0
Ismail Naseem,1,1,2001-04-15,0,1,0,0
Chea Makara,2,2,2001-05-20,1,1,0,0
Abdulsalam Al Ghurbani,3,3,2001-05-11,2,1,0,0
Baichung Bhutia,2,2,2001-05-20,2,0,0,1
Filipo Bureta,1,1,2001-04-16,1,0,1,0
Kit Leong Cheong,1,1,2001-04-16,0,1,0,0
Basanta Thapa,2,2,2001-04-25,1,1,0,0
Jope Namawa Leka,1,1,2001-04-16,0,1,0,0
Leone Vurukania,2,1,2001-04-16,0,2,0,0
Fillisione Taufahema,1,1,2001-04-16,1,0,0,0
Harouna Traoré,1,1,2001-04-21,1,0,0,0
John Maduka,1,1,2001-04-21,0,1,0,0
Brahima Korbeogo,1,1,2001-04-21,1,0,0,0
Narcisse Yaméogo,1,1,2001-04-21,1,0,0,0
Maksim Igorevich Shevchenko,2,1,2001-04-21,2,0,0,0
Abbas Hassan Hassun,2,1,2001-04-21,0,2,0,0
Haidar Obeid,2,2,2001-04-23,1,1,0,0
Rachid Rokki,1,1,2001-04-21,1,0,0,0
Sebastião Gilberto,3,3,2010-01-10,2,1,0,1
Lauren,1,1,2001-04-22,1,0,0,0
Xu Yunlong,5,4,2004-11-17,5,0,0,0
Wu Chengying,2,2,2001-05-27,1,1,0,0
Xie Hui,7,4,2001-05-27,5,2,0,0
Mohamed Jameel,1,1,2001-04-22,0,1,0,0
Li Weifeng,7,7,2011-11-15,5,2,0,0
Mawa Inunu,1,1,2001-04-22,1,0,0,0
Sam El Nasa,4,3,2011-06-29,3,1,1,0
Aples Tecuari,1,1,2001-04-22,1,0,0,0
Abdul Kader Keïta,8,8,2010-01-24,8,0,0,0
Amer Mushraf,1,1,2001-04-23,1,0,0,0
Dmitry Byakov,7,6,2007-10-17,4,3,0,0
Rejepmyrat Agabaýew,4,2,2003-11-19,4,0,0,0
Aleksey Dionisiev,1,1,2001-04-23,1,0,0,0
Vladimir Maminov,3,3,2001-05-07,2,1,0,2
Georgi Georgiev,2,2,2001-05-03,1,1,0,0
Ítalo Díaz,1,1,2001-04-24,0,1,1,0
Alexander Rondón,3,3,2009-10-10,3,0,0,0
Juan Arango,14,14,2013-06-07,8,6,0,0
Líder Paz,3,3,2001-11-07,2,1,0,0
Percy Colque,1,1,2001-04-25,1,0,0,0
Joaquín Botero,17,10,2009-04-01,14,3,0,1
Ricardo Gardner,2,2,2008-06-15,2,0,0,0
Nicola Albani,1,1,2001-04-25,0,1,0,0
Kim Meng Leong,1,1,2001-04-25,1,0,0,0
Bal Gopal Maharjan,1,1,2001-04-25,0,1,0,0
Deepak Lama,1,1,2001-04-25,0,1,0,0
Michael Mifsud,15,15,2018-09-07,9,6,0,2
Ruud van Nistelrooy,29,22,2011-03-29,21,8,0,1
Bilal Al-Laham,1,1,2001-04-25,0,1,0,0
Mahmoud Shelbaieh,4,4,2007-10-28,2,2,0,0
Goçguly Goçgulyýew,1,1,2001-04-27,0,1,0,1
Kakha Gogoladze,4,3,2001-05-07,1,3,0,0
Yuri Borodolimov,1,1,2001-04-27,0,1,0,0
Badran Al-Shagran,5,4,2004-10-13,2,3,0,0
Essam Abu Touk,5,4,2001-05-07,4,1,0,2
Patrick Ranaivoson,1,1,2001-04-28,1,0,1,0
Edson Minga,2,2,2008-06-22,2,0,0,0
Eko Purdjianto,1,1,2001-04-29,0,1,0,0
Hani Al-Dhabit,11,5,2001-10-19,9,2,0,2
Taqi Mubarak,4,4,2001-10-19,3,1,0,0
Yaqoob Juma Al-Mukhaini,11,5,2001-10-13,11,0,0,0
Nasser Zayid,1,1,2001-04-30,1,0,0,1
Fawzi Bashir,3,2,2007-10-08,3,0,0,0
Mohammed Khamis Al-Araimi,4,3,2001-05-18,3,1,0,0
Said Bayazid,11,5,2001-05-18,11,0,0,0
Nihad Al Boushi,4,3,2001-05-11,4,0,0,0
Raghdan Shehadeh,2,2,2001-05-11,2,0,0,0
Mouhanad Boushi,3,2,2001-05-07,3,0,0,0
Maher Malki,1,1,2001-04-30,1,0,0,0
Rateb Al-Awadat,1,1,2001-05-03,1,0,0,0
Ghanem Hamarsheh,2,1,2001-05-03,2,0,0,0
Wladimir Baýramow,4,2,2004-03-31,4,0,0,0
Ulugbek Bakayev,8,7,2013-06-18,5,3,0,1
Andrey Akopyants,1,1,2001-05-03,0,1,0,0
Rachid Benmahmoud,2,2,2002-01-30,0,2,0,1
Gharib Amzine,1,1,2001-05-04,0,1,0,0
Yanti Barsales,1,1,2001-05-04,0,1,0,0
Jomard Moussa,3,2,2001-05-07,3,0,0,0
Saeed Al Kass,7,6,2007-10-28,5,2,0,1
Faisal Khalil,4,4,2008-02-06,2,2,0,0
Jo Paul Ancheri,4,3,2001-05-20,1,3,0,0
Gurbangeldi Durdyýew,2,2,2004-11-17,0,2,0,0
Mahmadu Alphajor Bah,1,1,2001-05-05,1,0,0,0
Qu Bo,5,4,2011-07-28,3,2,0,0
Walter Bakouma,2,2,2001-07-15,2,0,0,0
Kanika Matondo,1,1,2001-05-06,0,1,0,0
Mido,6,6,2006-01-20,5,1,0,1
Ismed Sofyan,2,2,2004-09-08,0,2,0,0
Elijah Tana,3,3,2006-01-26,2,1,0,0
Chalwe Kunda,1,1,2001-05-06,0,1,0,0
Jérôme Doté,1,1,2001-05-06,1,0,0,0
Eric Akoto,1,1,2001-05-06,1,0,0,0
Firas Al-Khatib,5,4,2019-09-05,2,3,0,2
Maher Al Sayed,2,2,2007-10-08,2,0,0,1
Haitham Zein,5,3,2004-06-09,4,1,0,0
Gilberto dos Santos,3,2,2001-05-26,1,2,0,1
Hussein Hamdan,1,1,2001-05-13,1,0,0,0
Imthyas Raheem,3,2,2001-05-17,0,3,0,0
Therdsak Chaiman,3,3,2004-10-13,3,0,0,0
Thawatchai Damrong-Ongtrakul,1,1,2001-05-13,1,0,0,0
Roda Antar,12,10,2015-11-12,8,4,0,0
Mohammad Kassas,1,1,2001-05-15,1,0,0,0
Gohar Zaman,3,1,2001-05-17,3,0,0,0
Channa Ediri Bandanage,3,3,2003-12-03,2,1,0,0
Weerarathne Kassun,1,1,2001-05-17,0,1,0,0
Phengta Phounsamay,1,1,2001-05-19,1,0,0,0
Valasine Dalaphone,1,1,2001-05-19,1,0,0,0
Abdul Hakim,1,1,2001-05-20,1,0,0,0
Majdi Samir,1,1,2001-05-25,1,0,0,0
Faisal Antar,3,3,2004-09-08,0,3,0,0
Wartan Ghazarian,4,3,2001-05-30,0,4,0,0
Muhammad Arshad,2,2,2001-05-30,1,1,0,0
Marcílio Alves da Silva,2,2,2001-05-28,0,2,0,0
Jimmy Doña,1,1,2001-05-26,1,0,0,0
Nitsavong Khouphachansy,2,2,2004-03-31,0,2,1,0
Korken Yenkibarian,1,1,2001-05-28,0,1,0,0
Niweat Siriwong,2,2,2004-11-17,2,0,0,0
Surachai Jirasirichote,1,1,2001-05-28,1,0,0,0
Josip Skoko,5,4,2005-06-15,1,4,0,0
Steve Marlet,3,2,2002-10-12,2,1,0,0
Patrick Vieira,5,5,2006-06-27,1,4,0,0
Kasun Jayasuriya,3,2,2003-12-03,3,0,0,0
Totchtawan Sripan,2,2,2008-06-22,1,1,0,1
Washington,1,1,2001-05-31,1,0,0,0
Carlos Miguel da Silva Júnior,1,1,2001-05-31,1,0,0,0
Roman Týce,1,1,2001-06-02,0,1,0,0
Mikael Forssell,20,14,2011-09-02,16,4,0,2
Carsten Jancker,3,3,2002-06-01,2,1,0,0
Giorgi Gakhokidze,2,2,2005-09-03,2,0,0,0
Takayuki Suzuki,7,6,2004-10-13,5,2,0,0
Idan Tal,2,2,2007-03-28,1,1,0,0
Serghei Pogreban,1,1,2001-06-02,0,1,0,0
Mile Krstev,2,2,2003-06-07,2,0,0,0
Ruslan Barburoş,1,1,2001-06-02,0,1,0,0
Édison Méndez,15,13,2011-11-15,10,5,1,1
Marius Niculae,5,4,2004-09-08,2,3,0,0
Mirsad Bešlija,1,1,2001-06-02,0,1,0,0
Javi Moreno,1,1,2001-06-02,1,0,0,0
Diego Tristán,3,3,2003-04-02,3,0,0,0
Tayfun Korkut,1,1,2001-06-02,1,0,0,0
Paweł Kryszałowicz,3,3,2002-06-14,2,1,0,0
Raúl Justiniano,1,1,2001-06-03,1,0,0,0
Eric Carrière,3,2,2002-10-16,2,1,0,0
Niki Temiha,1,1,2001-06-04,0,1,0,0
Patterson Daudau,4,2,2002-07-07,4,0,0,0
David Firisua,1,1,2001-06-04,1,0,0,0
Joel Konofilla,1,1,2001-06-04,1,0,0,0
Tony Senechal,3,2,2001-06-11,0,3,0,0
Naea Bennett,4,2,2001-06-11,0,4,0,0
Simon Lauru,3,3,2004-05-10,1,2,0,0
Felix Tagawa,7,4,2002-07-09,0,7,0,0
Junior Pukoku,1,1,2001-06-06,1,0,0,0
Gerard Maki,1,1,2001-06-06,0,1,0,0
Pita David Maki,1,1,2001-06-06,0,1,0,0
Waren Waiwai,1,1,2001-06-06,0,1,0,0
Philip Mulryne,2,2,2001-09-01,0,2,0,0
Milan Baroš,25,20,2011-03-29,20,5,0,1
George Mallia,2,2,2007-03-24,0,2,0,0
Mateja Kežman,10,7,2005-10-12,4,6,0,0
János Mátyus,2,2,2001-09-01,1,1,0,0
Attila Korsós,2,1,2001-06-06,2,0,0,0
Levan Kobiashvili,8,8,2011-03-26,3,5,0,3
Sacha Schneider,1,1,2001-06-06,1,0,0,0
Sergei Semak,3,2,2002-10-16,2,1,0,0
Aaran Lines,3,3,2004-05-31,3,0,0,0
Wesley Sonck,15,13,2009-03-28,11,4,0,1
Sebastjan Cimirotič,4,4,2005-09-03,2,2,0,0
Žarko Serafimovski,1,1,2001-06-06,0,1,0,0
Alpay Özalan,3,1,2001-06-06,3,0,0,0
Hennadiy Zubov,3,3,2002-09-07,2,1,0,0
Ramon Menezes,1,1,2001-06-07,0,1,0,0
Noah Hickey,2,1,2001-06-08,2,0,0,0
Vivian Wickham,2,1,2001-06-08,0,2,0,0
Stanley Waita,2,2,2004-05-12,1,1,0,0
Paul Urlovic,3,3,2002-07-09,3,0,0,0
Ivan Vicelich,5,4,2007-10-17,4,1,0,0
Samuel Garcia,2,2,2002-07-09,1,1,0,1
Steve Fatupua-Lecaill,2,2,2002-07-07,1,1,0,0
Rony Morales,1,1,2001-06-16,0,1,0,0
Brett Emerton,15,12,2012-02-29,8,7,0,1
Rajab Elharbi,1,1,2001-06-29,1,0,0,0
Fernando Francisco,1,1,2001-06-29,0,1,0,0
Fares Aouni,4,1,2001-06-30,0,4,0,0
Sibusiso Zuma,5,4,2005-10-08,3,2,0,0
Alain Nana,1,1,2001-07-01,1,0,0,0
Gilles Yapi Yapo,2,2,2004-09-05,2,0,0,0
Isaac Boakye,5,3,2003-11-16,2,3,0,0
Yakubu,11,10,2010-06-22,4,7,0,4
Vladimirs Koļesņičenko,3,3,2008-10-15,3,0,0,0
Aivar Anniste,1,1,2001-07-04,1,0,0,0
Mark Švets,1,1,2001-07-04,1,0,0,0
Deividas Česnauskis,3,3,2004-11-17,0,3,0,0
Nerijus Vasiliauskas,1,1,2001-07-04,0,1,0,0
Valdas Trakys,1,1,2001-07-04,0,1,0,0
Raimondas Vilėniškis,1,1,2001-07-04,0,1,0,0
Nerijus Barasa,1,1,2001-07-05,0,1,0,0
Andrejs Rubins,5,4,2009-10-14,4,1,0,0
Oļegs Blagonadeždins,1,1,2001-07-05,1,0,0,0
Freddy Grisales,4,4,2004-10-09,3,1,0,0
Cristian Montecinos,3,2,2001-07-14,1,2,0,0
Marcelo Corrales,1,1,2001-07-11,0,1,0,0
Abel Lobatón,1,1,2001-07-12,1,0,0,0
Virgilio Ferreira,2,1,2001-07-12,0,2,0,0
Silvio Garay,1,1,2001-07-12,0,1,0,0
Javier Chevantón,6,5,2004-10-09,3,3,0,1
Abdul-Hamid Bassiouny,3,1,2001-07-13,3,0,0,0
Patrick Mkontwana,1,1,2001-07-13,0,1,0,0
Erastus Gariseb,1,1,2001-07-13,0,1,0,0
Mohamed Salah Abo Greisha,1,1,2001-07-13,1,0,0,0
Matthew Booth,1,1,2001-07-14,1,0,0,0
Bradley August,1,1,2001-07-14,1,0,0,0
Pius Ndiefi,2,2,2003-06-26,1,1,0,0
Guilherme de Cássio Alves,1,1,2001-07-15,1,0,0,0
Kandia Traoré,2,2,2002-01-29,0,2,0,0
Emmanuel Osei Kuffour,1,1,2001-07-15,1,0,0,0
Koffi Kossi,2,1,2001-07-15,2,0,0,0
Blessing Makunike,1,1,2001-07-15,1,0,0,0
Carlos María Morales,1,1,2001-07-16,1,0,0,0
Eudalio Arriaga,1,1,2001-07-17,1,0,0,0
Juliano Belletti,2,2,2001-07-23,1,1,1,0
Yacine Bezzaz,1,1,2001-07-21,1,0,0,0
Pape Thiaw,2,1,2001-07-21,0,2,0,0
Jesús Arellano,4,3,2004-09-08,1,3,0,0
Rodrigo Lemos,1,1,2001-07-22,1,0,0,1
Pablo Lima,1,1,2001-07-22,1,0,0,0
Saúl Martínez,3,3,2004-08-18,0,3,0,0
Giovanni Hernández,4,4,2003-06-28,3,1,0,0
Richard Morales,4,3,2002-06-11,2,2,0,0
Mutaz Kablan,2,1,2001-07-27,2,0,0,0
Dadley Fichite,2,2,2003-10-11,0,2,0,0
Master Masiku,1,1,2001-07-28,0,1,0,0
Alfa Potowabawi,1,1,2001-07-29,0,1,0,0
Bolombo Tokala,1,1,2001-07-29,0,1,0,0
Kanku Mulekelayi,1,1,2001-07-29,0,1,0,0
Jean-Yves Randriamarozaka,1,1,2001-07-29,1,0,0,0
Edward Jildo,1,1,2001-07-29,1,0,0,0
Joe Emerson Bizera,1,1,2001-07-29,1,0,0,0
Júnior Izaguirre,1,1,2001-07-29,0,1,0,0
Andrés Martínez,1,1,2001-07-29,1,0,0,0
Marcelinho Paraíba,1,1,2001-08-15,1,0,0,0
Jevgeni Novikov,1,1,2001-08-15,1,0,0,0
Gharib Hareb,1,1,2001-08-17,1,0,0,1
Fahd Ali,1,1,2001-08-17,1,0,0,0
Talal Yousef,6,6,2005-10-08,3,3,0,0
Ghazi Al Kuwari,1,1,2001-08-23,1,0,0,0
Li Xiaopeng,3,2,2004-06-09,3,0,0,0
Ahmad Khalifa Hashim,2,2,2001-09-28,1,1,0,0
Teemu Tainio,4,4,2007-08-22,1,3,0,0
Shefki Kuqi,5,4,2009-03-28,3,2,0,0
Roberto Jonas,1,1,2001-09-01,1,0,0,0
Rui Jorge,1,1,2001-09-01,0,1,0,0
Gocha Jamarauli,1,1,2001-09-01,1,0,0,0
Aleksandr Iashvili,12,10,2010-09-03,7,5,0,1
Steven Gerrard,16,14,2013-10-15,10,6,0,0
Emile Heskey,3,3,2009-06-06,0,3,0,0
Andri Sigthórsson,1,1,2001-09-01,1,0,0,0
Marek Jankulovski,9,9,2009-04-01,4,5,0,3
Serghei Covalciuc,2,2,2003-09-10,2,0,0,0
Dragan Načevski,1,1,2001-09-01,1,0,0,0
Hakan Yakin,9,8,2008-09-06,7,2,0,1
Mladen Krstajić,1,1,2001-09-01,0,1,0,0
Heriberto Morales,1,1,2001-09-02,1,0,1,0
Ricardo Páez,2,2,2007-06-26,1,1,0,0
Cris,1,1,2001-09-05,1,0,1,0
Vančo Trajanov,2,2,2002-10-16,0,2,0,0
Farrukh Ismayilov,3,3,2003-09-06,3,0,0,0
Nico Van Kerckhoven,1,1,2001-09-05,1,0,0,0
Vratislav Lokvenc,9,7,2005-06-04,7,2,0,0
Robbie Fowler,1,1,2001-09-05,1,0,0,0
Aleksandr Shirko,1,1,2001-09-05,0,1,0,0
Giorgos Karagounis,6,6,2013-10-15,4,2,0,1
George McCartney,1,1,2001-09-05,1,0,0,0
Frode Johnsen,1,1,2001-09-05,1,0,0,0
Niko Kovač,8,7,2008-09-06,5,3,0,0
Predrag Đorđević,1,1,2001-09-05,1,0,0,0
Peter Németh,2,2,2001-10-07,1,1,0,0
Andriy Vorobey,4,3,2007-10-17,4,0,0,0
Maksim Shatskikh,19,14,2011-09-02,13,6,0,1
Mohamed Abdulazeez,1,1,2001-09-14,0,1,0,0
Radhwan Nairooz,1,1,2001-09-14,1,0,0,0
Abdullah Bin Shehan,5,4,2001-10-21,1,4,0,0
Abdullah Al-Waked,2,2,2001-09-28,1,1,0,1
Waleed Hamzah,4,4,2004-09-08,1,3,0,0
Sutee Suksomkit,4,4,2007-07-07,3,1,0,1
Al Hasan Al-Yami,1,1,2001-09-28,1,0,0,0
Sirous Dinmohammadi,1,1,2001-09-28,0,1,0,0
Bård Borgersen,2,1,2001-10-06,0,2,0,0
Hayk Hakobyan,1,1,2001-10-06,1,0,0,0
Gonzalo Galindo,3,3,2005-06-08,1,2,0,0
Luis Gómez,1,1,2001-10-06,0,1,0,0
Tomáš Rosický,15,13,2013-09-06,8,7,0,1
Thomas Gravesen,4,3,2003-06-11,2,2,0,0
Jan Michaelsen,1,1,2001-10-06,1,0,0,0
Themistoklis Nikolaidis,1,1,2001-10-06,0,1,0,0
Nihat Kahveci,12,11,2010-09-03,6,6,0,0
İlhan Mansız,6,5,2003-11-19,2,4,0,0
Dougie Freedman,1,1,2001-10-06,1,0,0,0
David Weir,1,1,2001-10-06,1,0,0,0
René Peters,2,2,2008-10-11,1,1,0,0
Marcel Christophe,1,1,2001-10-06,0,1,0,0
Nastja Čeh,5,4,2005-06-04,4,1,0,0
Senad Tiganj,1,1,2001-10-06,1,0,0,0
Wilfredo Alvarado,2,1,2001-10-06,2,0,0,0
Nermin Šabić,1,1,2001-10-07,1,0,0,0
Marijo Dodik,1,1,2001-10-07,1,0,0,0
Edílson,2,2,2001-11-07,1,1,0,0
Yu Genwei,2,2,2004-11-17,2,0,0,0
Ľubomír Reiter,6,6,2005-06-08,2,4,0,0
Peter Dzúrik,1,1,2001-10-07,0,1,0,0
Attila Pinte,1,1,2001-10-07,0,1,0,0
Tomáš Oravec,1,1,2001-10-07,0,1,0,0
Mauricio Pochettino,1,1,2001-10-07,0,1,0,0
Gustavo Morínigo,2,2,2005-03-30,2,0,0,0
Zlatan Ibrahimović,44,32,2015-11-17,26,18,0,5
Jamie Lawrence,1,1,2001-10-07,0,1,0,0
Arnulfo Valentierra,1,1,2001-10-07,0,1,0,0
Fevzi Davletov,1,1,2001-10-13,0,1,0,0
Nabil Ashoor,1,1,2001-10-13,0,1,1,0
Fawzi Bashir Doorbeen,1,1,2001-10-13,1,0,0,0
Badar Al-Mahrouqi,1,1,2001-10-13,1,0,0,0
Worrawoot Srimaka,1,1,2001-10-16,1,0,0,0
Husain Ali,9,8,2005-08-17,4,5,0,0
Abdulla Al Marzooqi,1,1,2001-10-21,1,0,0,0
Abdullah Jumaan Al-Dosari,1,1,2001-10-21,1,0,0,0
Ibrahim Al-Harbi,1,1,2001-10-21,1,0,0,0
Shimon Gershon,2,2,2006-09-06,2,0,0,2
Jaime Riveros,1,1,2001-11-07,0,1,0,0
Jersson González,1,1,2001-11-07,1,0,0,0
William Sunsing,2,2,2004-10-13,0,2,0,0
Luizão,2,1,2001-11-14,2,0,0,0
Rafael Arlex Castillo,1,1,2001-11-14,0,1,0,0
Piero Alva,2,2,2008-09-06,2,0,0,0
José Alfredo Castillo,6,6,2005-10-09,3,3,0,1
Mladen Rudonja,1,1,2001-11-14,0,1,0,0
Yıldıray Baştürk,2,2,2005-03-26,2,0,0,0
Yahya Golmohammadi,3,3,2006-06-11,2,1,1,0
Kevin McKenna,4,3,2004-06-13,2,2,0,0
Jair García,1,1,2002-01-19,0,1,0,0
Seydou Keita,13,10,2013-02-09,8,5,0,0
Landon Donovan,38,31,2013-09-10,31,7,0,10
Song Chong-gug,2,2,2002-06-29,1,1,0,0
DaMarcus Beasley,13,9,2008-10-11,11,2,0,0
Charles Alerte,1,1,2002-01-20,0,1,0,0
Lamine Diatta,2,2,2004-06-05,1,1,0,0
Adolfo Bautista,6,4,2004-07-13,4,2,0,0
Marco Garcés,1,1,2002-01-21,1,0,0,0
Carlos Ochoa,1,1,2002-01-21,1,0,0,0
Patrick Percin,1,1,2002-01-22,0,1,0,0
Santos Cabrera,1,1,2002-01-23,0,1,0,0
Prince Akim Daye,1,1,2002-01-25,1,0,0,0
Nassim Akrour,4,2,2003-11-14,3,1,0,0
Nasreddine Kraouche,1,1,2002-01-25,0,1,0,0
Hicham Zerouali,2,1,2002-01-26,0,2,0,0
Mark Rogers,1,1,2002-01-26,0,1,1,0
Walter Centeno,15,13,2009-11-18,10,5,0,2
Souleymane Camara,2,2,2006-01-31,1,1,0,0
Mamadou Bagayoko,2,2,2010-01-18,2,0,0,0
Bassala Touré,2,2,2002-02-03,2,0,0,0
Lucien Mettomo,1,1,2002-01-29,1,0,0,0
Yves Yuvuladio,1,1,2002-01-29,1,0,0,0
Koh Traoré,1,1,2002-01-30,1,0,0,0
Choi Jin-cheul,2,2,2004-10-13,0,2,0,0
Thabo Mngomeni,1,1,2002-01-30,1,0,0,0
Gift Kampamba,3,3,2005-06-05,0,3,0,0
Dwayne De Rosario,15,12,2012-09-07,12,3,0,5
Dramane Coulibaly,3,2,2005-06-05,3,0,0,1
Salif Diao,4,4,2008-09-05,1,3,0,0
Papa Bouba Diop,8,7,2006-02-03,3,5,0,0
Thomas Linke,1,1,2002-06-01,1,0,0,0
Bernd Schneider,2,2,2006-09-06,1,1,0,1
Sol Campbell,1,1,2002-06-02,1,0,0,0
Teboho Mokoena,5,5,2024-02-07,1,4,0,1
Quinton Fortune,2,2,2005-03-26,1,1,0,2
Juan Carlos Valerón,4,4,2004-06-12,2,2,0,0
Hasan Şaş,2,2,2002-06-13,1,1,0,0
Junichi Inamoto,2,2,2002-06-09,2,0,0,0
Peter Van Der Heyden,1,1,2002-06-04,0,1,0,0
Jorge Costa,1,1,2002-06-05,1,0,1,0
Beto,1,1,2002-06-05,0,1,0,0
Carles Puyol,3,3,2010-07-07,0,3,1,0
Roberto Carlos,3,3,2005-10-12,2,1,0,0
Ivica Olić,12,11,2015-03-28,5,7,0,0
Milan Rapaić,4,3,2004-06-17,3,1,0,2
Winston Parks,1,1,2002-06-09,1,0,0,0
Ahn Jung-hwan,6,6,2006-06-13,5,1,0,0
Raouf Bouzaiene,1,1,2002-06-10,1,0,0,0
Damien Duff,3,3,2003-09-06,1,2,0,0
Diego Forlán,28,22,2013-06-20,16,12,0,3
Nelson Cuevas,3,2,2006-06-20,1,2,0,0
Edmílson,1,1,2002-06-13,0,1,0,0
Jenílson Ângelo de Souza,1,1,2002-06-13,0,1,0,0
Johan Walem,1,1,2002-06-14,1,0,0,0
Dmitri Sychev,9,7,2007-11-21,4,5,0,0
Park Ji-sung,9,9,2010-06-12,6,3,0,0
Rio Ferdinand,3,3,2008-10-11,2,1,0,0
Seol Ki-hyeon,4,3,2008-02-06,4,0,0,0
Lee Eul-yong,1,1,2002-06-29,1,0,0,0
Ryan Nelsen,5,4,2004-06-04,5,0,0,0
Jeff Campbell,5,3,2002-07-09,5,0,0,0
Bobby Despotovski,5,2,2002-07-08,5,0,0,1
Veresa Toma,8,6,2004-06-04,7,1,0,0
Junior Bukaudi,1,1,2002-07-06,1,0,0,0
Andre Sinedo,1,1,2002-07-06,0,1,0,0
Joe Aisa,1,1,2002-07-07,0,1,0,1
Raf de Gregorio,2,2,2003-06-20,1,1,0,0
Sylvain Booene,1,1,2002-07-07,0,1,0,0
Steve Horvat,1,1,2002-07-08,1,0,0,0
Angelo Costanzo,1,1,2002-07-08,1,0,0,0
Joel Porter,6,3,2002-07-12,6,0,0,0
Willie August Marango,1,1,2002-07-08,0,1,0,0
Henry Fa'arodo,11,9,2017-09-05,6,5,0,4
Reginald Davani,7,4,2004-05-19,1,6,0,0
Ante Milicic,3,3,2004-10-12,2,1,0,0
Ante Juric,1,1,2002-07-10,1,0,0,0
Tetahio Auraa,1,1,2002-07-14,1,0,0,0
Serhiy Serebrennikov,1,1,2002-09-07,0,1,0,0
Albert Sarkisyan,3,2,2003-06-07,1,2,0,2
Tarlan Ahmadov,1,1,2002-09-07,0,1,1,0
Zoran Janković,1,1,2002-09-07,0,1,0,0
Stiliyan Petrov,5,5,2008-09-06,1,4,1,0
Djibril Cissé,6,5,2005-10-08,3,3,0,0
Paul Lambert,1,1,2002-09-07,0,1,0,0
Barry Ferguson,2,2,2007-11-17,1,1,0,0
Simon Davies,6,6,2007-09-12,3,3,0,0
Marius Stankevičius,6,6,2011-03-29,2,4,1,1
John Arne Riise,9,9,2012-09-11,7,2,0,1
Andrei Karyaka,5,5,2005-03-26,2,3,1,0
Gary Doherty,3,3,2003-06-11,1,2,0,0
Aleksandr Kerzhakov,21,16,2014-06-17,12,9,0,0
Clinton Morrison,4,4,2005-03-26,1,3,0,0
Phil Babb,1,1,2002-09-07,1,0,1,0
Paweł Kaczorowski,1,1,2002-09-07,0,1,0,0
Mariusz Kukiełka,1,1,2002-09-07,0,1,0,0
Darren Debono,1,1,2002-09-07,1,0,1,0
Serhat Akın,3,2,2002-10-16,3,0,0,0
Michael Stocklasa,1,1,2002-09-08,1,0,0,0
Patrick Müller,1,1,2002-09-08,1,0,0,0
Muhammet Akagündüz,1,1,2002-10-12,0,1,0,0
Emin Ağayev,1,1,2002-10-12,1,0,1,0
Sidney Govou,6,5,2008-09-06,4,2,0,0
Christian Dailly,3,3,2006-09-06,1,2,0,0
Gary Naysmith,1,1,2002-10-12,0,1,0,0
Robertas Poškus,1,1,2002-10-12,1,0,0,0
Vlatko Grozdanoski,2,2,2003-06-11,1,1,0,0
Juris Laizāns,11,11,2008-05-30,6,5,0,2
Guti,2,2,2005-02-09,2,0,0,0
Krisztián Kenesei,2,2,2003-06-11,0,2,0,0
Andriy Voronin,4,4,2007-11-21,4,0,0,0
Roy Makaay,2,2,2004-06-23,1,1,0,0
Georgi Chilikov,1,1,2002-10-16,1,0,0,0
Antoni Lima Solá,1,1,2002-10-16,0,1,0,0
Arne Friedrich,3,3,2011-06-03,1,2,2,0
Zoltán Gera,21,17,2016-11-13,14,7,0,4
Heiðar Helguson,4,4,2010-10-12,3,1,0,0
Mirel Rădoi,1,1,2002-10-16,0,1,0,0
Tiberiu Ghioane,1,1,2002-10-16,0,1,0,0
Claus Lundekvam,2,2,2005-09-03,1,1,0,0
Ludovic Magnin,2,2,2005-10-08,2,0,1,0
Fabio Celestini,1,1,2002-10-16,0,1,0,0
Klodian Duro,3,3,2010-10-08,2,1,0,0
Rainer Rauffmann,2,2,2003-03-29,2,0,0,0
Carlo Valentini,1,1,2002-11-20,0,1,1,0
Nikola Lazetić,1,1,2003-02-12,1,0,0,0
Altin Lala,2,2,2003-06-11,1,1,0,0
Boris Cebotari,1,1,2003-03-29,0,1,0,0
Vitali Kutuzov,8,7,2007-11-17,3,5,0,0
Darijo Srna,13,12,2013-11-19,8,5,0,2
Dado Pršo,8,7,2005-03-30,7,1,0,0
Tomislav Marić,1,1,2003-03-29,1,0,0,0
Jerko Leko,1,1,2003-03-29,1,0,0,0
Omri Afek,2,2,2003-04-02,1,1,0,0
Carsten Ramelow,1,1,2003-03-29,1,0,0,0
Martin Petráš,1,1,2003-03-29,0,1,0,0
Adrian Mutu,24,19,2013-03-22,17,7,0,5
Kenny Miller,11,10,2012-09-11,8,3,0,1
Lee Wilkie,1,1,2003-03-29,1,0,0,0
Aleksandr Gorshkov,2,2,2003-06-07,2,0,0,0
Darius Vassell,1,1,2003-04-02,1,0,0,0
Sigurd Rushfeldt,2,2,2005-10-08,1,1,0,0
Vadim Boret,1,1,2003-04-02,1,0,0,0
Mirosław Szymkowiak,2,2,2003-09-06,1,1,0,0
Kamil Kosowski,3,3,2005-09-03,3,0,0,0
Marcin Kuźba,2,1,2003-04-02,2,0,0,0
Vladimír Janočko,2,2,2003-06-11,1,1,0,0
Malkhaz Asatiani,5,5,2006-09-02,3,2,1,0
Shay Holtzman,1,1,2003-04-30,1,0,0,0
Andrejs Prohorenkovs,3,3,2004-11-17,1,2,0,0
Philippe Clement,1,1,2003-06-07,0,1,0,0
Jesper Grønkjær,2,2,2004-06-18,1,1,0,0
Teet Allas,1,1,2003-06-07,1,0,0,0
Imre Szabics,7,6,2011-09-02,5,2,0,0
Rógvi Jacobsen,8,8,2007-11-21,3,5,0,0
Luke Dimech,1,1,2003-06-07,1,0,0,0
Viorel Frunză,6,5,2013-10-11,3,3,0,0
Roger Beck,1,1,2003-06-07,0,1,0,0
Goce Sedloski,4,4,2007-10-17,2,2,0,1
Aco Stojkov,4,4,2009-06-10,4,0,0,0
Ervin Skela,5,5,2007-06-06,1,4,0,2
Adrian Aliaj,2,2,2004-09-04,2,0,1,0
Stelios Giannakopoulos,4,4,2005-09-07,0,4,0,0
Sergei Ignashevich,7,6,2018-07-01,1,6,1,1
Serhiy Fedorov,1,1,2003-06-07,1,0,0,0
René Aufhauser,5,4,2008-09-06,5,0,0,0
Mario Haas,2,2,2003-10-11,2,0,0,0
Roland Kirchler,1,1,2003-06-11,1,0,0,0
Roman Wallner,2,2,2009-10-10,2,0,0,1
Branko Bošković,2,2,2013-10-11,1,1,1,0
Jiří Štajner,1,1,2003-06-11,1,0,0,0
Zoltán Böőr,1,1,2003-06-11,0,1,0,0
Bernt Haas,1,1,2003-06-11,1,0,0,0
Ricardo Cabanas,1,1,2003-06-11,1,0,0,0
Gökdeniz Karadeniz,5,5,2007-03-24,2,3,0,0
Shunsuke Nakamura,13,12,2009-03-28,5,8,0,1
Okan Yılmaz,3,3,2003-06-28,1,2,0,1
Tuncay Şanlı,3,3,2003-06-28,1,2,0,0
Jorge López Caballero,1,1,2003-06-20,1,0,0,0
Mario Yepes,4,3,2013-10-15,2,2,0,0
Adriano,17,12,2008-10-12,10,7,0,0
Geremi,2,2,2006-01-29,2,0,0,1
Olivier Kapo,1,1,2003-06-22,1,0,0,0
Ludovic Giuly,3,3,2005-10-12,2,1,0,0
Jaanus Sirel,1,1,2003-07-03,1,0,0,0
Andrius Velička,1,1,2003-07-03,0,1,0,0
Marius Bezykornovas,1,1,2003-07-03,0,1,0,0
Edgaras Česnauskis,3,2,2012-10-12,0,3,0,0
Tomas Tamošauskas,1,1,2003-07-04,0,1,0,0
Paul Stalteri,1,1,2003-07-12,0,1,0,0
Eddie Lewis,4,4,2008-06-22,1,3,0,0
Jairo Patiño,3,2,2005-07-21,2,1,0,0
Maicon Sisenando,4,4,2010-06-15,2,2,0,0
Diego,2,2,2003-07-23,1,1,0,1
Erick Scott,2,2,2003-07-19,1,1,0,0
Marvin González,2,2,2009-10-10,2,0,1,0
Mauricio Molina,1,1,2003-07-17,1,0,0,0
Kaká,17,13,2009-06-15,8,9,0,2
Gilberto Murgas,1,1,2003-07-19,0,1,0,1
Alfredo Pacheco,4,3,2012-06-12,1,3,0,1
Steve Ralston,3,3,2005-09-03,3,0,0,0
Omar Bravo,9,8,2009-03-28,9,0,0,0
Rafael García Torres,1,1,2003-07-20,1,0,0,0
Juan Pablo Rodríguez,1,1,2003-07-20,1,0,0,0
Carlos Bocanegra,8,8,2012-10-16,6,2,0,0
Bobby Convey,1,1,2003-07-26,1,0,0,0
Pétur Marteinsson,1,1,2003-08-20,0,1,0,0
Dragan Mladenović,1,1,2003-08-20,1,0,0,0
Josip Šimunić,2,2,2005-03-26,1,1,0,0
Đovani Roso,1,1,2003-09-06,0,1,0,0
Milovan Mirosevic,2,2,2005-03-26,1,1,0,0
Zisis Vryzas,3,3,2005-03-26,0,3,0,0
Mika Nurmela,2,2,2006-11-15,1,1,0,0
Vital Bulyga,4,4,2007-11-21,3,1,0,0
Zlatan Bajramović,3,3,2009-03-28,1,2,0,0
Giovanny Espinoza,1,1,2003-09-06,1,0,0,0
Carlos Tenorio,4,4,2009-06-07,2,2,0,0
Mikheil Ashvetia,1,1,2003-09-06,1,0,0,0
Tomasz Kłos,2,2,2005-06-04,0,2,0,0
Tümer Metin,6,6,2007-03-24,2,4,0,0
Rafael van der Vaart,15,15,2013-10-11,8,7,0,1
Emanuel Pogatetz,1,1,2003-09-06,0,1,0,0
Wayne Rooney,37,30,2016-06-27,18,19,0,6
Jefferson Farfán,18,15,2019-06-18,14,4,0,1
Daniel Pancu,5,4,2004-09-08,2,3,0,0
Florin Bratu,1,1,2003-09-06,1,0,0,0
Paul Dickov,1,1,2003-09-06,1,0,0,0
James McFadden,10,10,2009-09-05,7,3,0,0
Andreas Jakobsson,1,1,2003-09-06,1,0,0,0
Kim Källström,10,10,2011-10-11,7,3,0,1
Nelson Abeijon,1,1,2003-09-07,1,0,0,0
Carlos Bueno,9,8,2008-10-14,6,3,0,1
Mauricio Pinilla,5,4,2016-03-29,1,4,0,0
Arturo Norambuena,1,1,2003-09-09,1,0,0,0
César Delgado,2,2,2004-07-25,1,1,0,0
Besnik Hasi,2,2,2006-09-02,1,1,0,0
Marian Hristov,1,1,2003-09-10,0,1,0,0
Martin Laursen,2,2,2007-09-12,2,0,0,0
Súni Olsen,3,3,2009-09-09,3,0,1,0
Donatas Vencevicius,1,1,2003-09-10,0,1,0,0
Serghei Dadu,3,3,2012-10-16,2,1,0,1
Arman Karamyan,1,1,2003-09-10,0,1,0,0
Mikael Nilsson,1,1,2003-09-10,0,1,0,0
Olof Mellberg,8,7,2012-06-15,6,2,0,0
Dmitri Bulykin,6,4,2004-09-04,6,0,0,0
Saša Ilić,3,3,2006-06-21,2,1,0,0
Dragan Dimitrovski,1,1,2003-09-10,0,1,0,0
Olivier Dacourt,1,1,2003-09-10,0,1,0,0
Dionisio Fernandes,1,1,2003-10-10,1,0,0,0
Soumaïla Coulibaly,6,6,2008-06-01,3,3,0,0
José Antonio Reyes,2,1,2003-10-11,0,2,0,0
Andreas Ivanschitz,6,6,2013-10-15,4,2,0,1
Štěpán Vachoušek,1,1,2003-10-11,0,1,0,0
Thomas Buffel,3,3,2005-09-07,3,0,0,0
Tshepiso Molwantwa,4,4,2005-10-08,3,1,0,0
Nelson Gabolwelwe,2,2,2004-06-19,2,0,0,0
Diphetogo Selolwane,5,4,2008-06-14,3,2,0,0
Moses Ramafole,1,1,2003-10-11,0,1,0,0
Stavros Georgiou,1,1,2003-10-11,1,0,0,0
Yiasoumis Yiasoumi,2,2,2006-09-02,1,1,0,0
Sergio Barila,1,1,2003-10-11,1,0,0,1
Jean-Alain Boumsong,1,1,2003-10-11,1,0,0,0
Kevin Kurányi,6,5,2007-06-02,4,2,0,0
Andrzej Niedzielan,2,1,2003-10-11,0,2,0,0
Marco Di Vaio,1,1,2003-10-11,1,0,0,0
Róbert Vittek,14,10,2010-06-28,6,8,0,1
Robert Edmond,1,1,2003-10-11,1,0,0,0
Anicet Adjamossi,2,2,2004-01-31,1,1,1,0
Wesley Sneijder,21,19,2017-06-09,16,5,0,0
Arjen Robben,22,19,2017-10-10,12,10,0,1
Mansour Boutabout,5,5,2005-09-04,3,2,0,0
Darren Fletcher,4,4,2011-09-03,3,1,0,0
Mumamba Numba,2,2,2005-10-01,0,2,0,0
Haytham Tambal,7,7,2008-09-06,5,2,0,0
Haitham Elrasheed,1,1,2003-10-11,1,0,0,0
Assani Bajope,1,1,2003-10-11,1,0,0,0
David Obua,5,5,2008-09-07,2,3,0,1
Zvonimir Vukić,5,5,2005-10-08,1,4,0,0
Danijel Ljuboja,1,1,2003-10-11,0,1,0,0
Robert Earnshaw,5,5,2007-10-17,4,1,0,0
Bruno Mauro,2,2,2003-11-16,1,1,0,0
Francis Oumar,3,1,2003-10-12,3,0,0,0
Mbiamcie Mvoubi,1,1,2003-10-12,1,0,0,1
Carlos Pedro Silva Morais,2,2,2003-11-16,1,1,0,0
Essau Kanyenda,5,2,2008-05-31,3,2,0,0
Teshome Getu,1,1,2003-10-12,1,0,0,1
Peter Mgangira,1,1,2003-10-12,0,1,0,0
Abdou-Rahman Njie,1,1,2003-10-12,1,0,0,0
Edrissa Sonko,1,1,2003-10-12,1,0,0,0
Sambégou Bangoura,8,6,2009-06-07,4,4,0,0
Joao Rafael Elias,1,1,2003-10-12,1,0,0,0
Olivier Karekezi,4,4,2011-11-15,4,0,0,0
Jean Lomami,2,2,2003-11-15,1,1,0,0
Kaitano Tembo,1,1,2003-10-12,1,0,0,0
Abdelmalek Cherrad,4,3,2004-06-20,2,2,0,0
Djibril Sidibé,1,1,2003-11-14,1,0,0,1
Yoann Langlet,1,1,2003-11-14,1,0,0,0
Ahmed Sidibe,1,1,2003-11-14,1,0,0,0
George Mbwando,1,1,2003-11-14,0,1,0,0
Andrés D'Alessandro,2,2,2004-07-07,2,0,0,0
Rajabu Mwinyi,1,1,2003-11-15,1,0,1,0
Stéphane N'Guéma,4,3,2012-01-23,4,0,0,0
Gabriel Nzeyimana,1,1,2003-11-15,0,1,0,0
Dennis Oliech,16,13,2011-11-15,11,5,0,0
Paulus Shipanga,2,2,2008-10-11,2,0,0,0
Rodrigo Meléndez,1,1,2003-11-15,0,1,0,0
Adrián Romero,1,1,2003-11-15,1,0,0,0
Robert Suzette,1,1,2003-11-15,0,1,0,0
Jean Jacques Radonamahafalison,1,1,2003-11-16,0,1,0,0
Alain Rakotondramanana,1,1,2003-11-16,0,1,0,0
Oumar Tchomogo,5,3,2008-06-08,5,0,0,2
Arlindo Gomes Semedo,5,4,2005-06-04,5,0,0,0
Nana Arhin Duah,2,1,2003-11-16,2,0,0,0
Asamoah Gyan,24,22,2017-01-21,10,14,0,4
Isaac Tondo,3,2,2005-03-26,2,1,0,0
Tarik El Taib,2,1,2003-11-16,2,0,0,0
Marei Suliman,1,1,2003-11-16,1,0,0,0
Ahmed Osman,1,1,2003-11-16,1,0,0,0
Mohamed El Rabty,1,1,2003-11-16,1,0,0,0
Richardo Nabuth,1,1,2003-11-16,1,0,0,0
Cyril Mourgine,1,1,2003-11-16,1,0,0,0
Jerry Louis,1,1,2003-11-16,1,0,0,0
Dário Monteiro,5,3,2009-11-14,4,1,0,0
Ibrahim Koroma,1,1,2003-11-16,1,0,0,0
Rolf-Christel Guié-Mien,1,1,2003-11-16,0,1,0,0
Emmanuel Adebayor,17,11,2013-01-26,14,3,0,0
José Manuel Rey,5,5,2009-09-05,3,2,1,0
Gilberto Silva,1,1,2003-11-19,0,1,1,0
Stephen Appiah,6,5,2008-10-11,6,0,0,1
Lawrence Adjei,1,1,2003-11-19,1,0,0,0
André Ooijer,2,2,2009-06-10,2,0,0,0
Guwançmuhammet Öwekow,3,2,2004-02-18,3,0,0,0
Begençmuhammet Kulyýew,8,5,2004-07-22,5,3,0,0
Nazar Baýramow,3,3,2004-07-18,2,1,0,0
Omar Berdiýew,1,1,2003-11-19,1,0,0,0
Didargylyç Urazow,1,1,2003-11-19,1,0,0,0
Vadim Evseev,1,1,2003-11-19,0,1,0,0
Chuang Yao-tsung,1,1,2003-11-23,1,0,0,0
Chen Jui-te,3,2,2003-11-29,1,2,0,0
Chang Wu-yeh,1,1,2003-11-23,1,0,0,0
Numondzhon Khakimov,5,3,2007-10-28,3,2,0,2
Chiang Shih-lu,1,1,2003-11-29,0,1,0,0
Fu Weng Lei,1,1,2003-11-29,1,0,0,0
Mohamed Nizam,2,2,2003-12-03,1,1,0,0
Evgeny Boldygin,2,2,2003-12-03,1,1,0,0
Sergey Chikishev,3,3,2004-10-13,1,2,0,0
Akmal Kholmatov,2,2,2004-06-10,1,1,0,0
Yusuf Rabiev,2,2,2004-10-13,2,0,0,0
Andrey Krasnov,1,1,2003-12-03,1,0,0,0
Ali Ashfaq,14,7,2019-11-19,10,4,0,2
Ibrahim Fazeel,3,2,2004-09-08,3,0,0,0
Assad Ghani,1,1,2003-12-03,1,0,0,0
Ahmed Thoriq,3,2,2004-10-13,3,0,0,0
Khishigdalai Battulga,1,1,2003-12-03,1,0,1,0
Mohamed Nazeeh,1,1,2003-12-03,1,0,0,0
Mohamed Hameed,1,1,2003-12-03,1,0,0,0
João Elias,1,1,2004-01-24,0,1,0,0
Francileudo Santos,18,10,2008-01-27,14,4,0,0
Brahim Zafour,1,1,2004-01-25,0,1,0,0
Alain Masudi,1,1,2004-01-25,1,0,0,0
Tamer Abdel Hamid,1,1,2004-01-25,0,1,0,0
Mohamed Sissoko,2,2,2005-09-03,1,1,0,0
Titus Mulama,2,2,2011-11-15,2,0,0,0
Frédéric Kanouté,17,14,2010-01-18,8,9,0,2
Youssouf Hadji,9,7,2008-10-11,8,1,0,0
Karim Kamanzi,1,1,2004-01-28,1,0,0,0
Najeh Braham,2,2,2004-06-20,1,1,0,0
Mamar Mamouni,1,1,2004-01-29,1,0,0,0
Ahmed Belal,1,1,2004-01-29,0,1,0,0
Hocine Achiou,2,2,2004-02-03,2,0,0,0
Modeste M'Bami,2,1,2004-01-29,2,0,0,0
Esrom Nyandoro,2,2,2008-10-11,0,2,0,0
Mahamadou Diarra,3,3,2005-06-05,2,1,0,0
Dieudonné Minoungou,1,1,2004-01-30,1,0,0,0
Mamadou Niang,5,4,2006-02-07,3,2,0,0
Marouane Chamakh,5,5,2005-10-08,3,2,0,0
Abdeslam Ouaddou,2,2,2008-01-24,1,1,0,0
Talal El Karkouri,4,4,2005-10-08,3,1,0,0
Joseph Yobo,6,6,2014-06-30,3,3,2,0
Osaze Odemwingie,3,2,2004-02-13,3,0,0,0
Saïd Makasi,3,3,2008-06-14,3,0,0,1
Selim Benachour,2,2,2006-01-26,2,0,0,0
Emmanuel Ake,1,1,2004-02-02,0,1,0,0
John Baraza,3,2,2004-09-04,2,1,0,0
Dramane Traoré,1,1,2004-02-02,0,1,0,0
Habib Beye,1,1,2004-02-02,1,0,0,0
Joel Lupahla,1,1,2004-02-03,0,1,0,0
Patrick Mayo,1,1,2004-02-04,0,1,0,0
Youssef Safri,6,6,2008-10-11,3,3,0,3
John Utaka,3,3,2005-09-04,1,2,0,0
Moussa Latoundji,1,1,2004-02-04,0,1,0,0
Jawhar Mnari,2,2,2006-06-19,1,1,0,0
Jaouad Zairi,4,2,2005-02-09,4,0,0,0
Youssef Mokhtari,4,3,2004-07-03,2,2,0,0
Nabil Baha,1,1,2004-02-11,1,0,0,0
Sedonoude Abouta,1,1,2004-02-13,0,1,0,0
Winston Roberts,1,1,2004-02-18,1,0,0,0
A'ala Hubail,13,8,2008-03-26,10,3,0,1
Yousef Sheikh Al-Eshreh,2,2,2004-10-13,1,1,0,0
Jean-Philippe Peguero,2,2,2004-06-12,2,0,0,0
Johnny Descouines,3,1,2004-02-18,3,0,0,0
Corriolan Wadson,1,1,2004-02-18,1,0,0,0
Renedy Singh,2,2,2004-03-31,2,0,0,0
Tatsuhiko Kubo,2,2,2004-06-09,2,0,0,0
Hatem Aqel,2,2,2007-10-28,2,0,0,1
Awad Ragheb,1,1,2004-02-18,1,0,0,0
Mustafa Shehdeh,1,1,2004-02-18,1,0,0,0
Valeri Berezovsky,1,1,2004-02-18,1,0,0,0
Pirmurod Burkhanov,2,1,2004-02-18,0,2,0,0
Ng Wai Chiu,1,1,2004-02-18,0,1,0,0
Chu Siu Kei,2,2,2004-10-13,1,1,0,0
Kwok Yue Hung,1,1,2004-02-18,0,1,0,0
Ziyad Al-Kord,1,1,2004-02-18,1,0,0,0
Safwan Habaib,2,1,2004-02-18,2,0,0,0
Francisco Atura,1,1,2004-02-18,1,0,0,0
Roberto Kettlun,3,2,2004-03-31,3,0,0,0
Taysir Amer,2,2,2004-10-14,1,1,0,0
Ahmed Keshkesh,1,1,2004-02-18,1,0,0,0
Ibrahim Sowed,3,2,2004-03-31,2,1,0,0
Yasser Al-Qahtani,14,12,2008-06-02,8,6,0,3
Cha Du-ri,2,2,2004-07-27,2,0,0,0
Cho Byung-kuk,1,1,2004-02-18,1,0,0,0
Mohamed Rashid,2,2,2004-07-19,1,1,0,0
Ian Lake,10,5,2011-10-11,6,4,0,0
Ahmad Salah Alwan,1,1,2004-02-18,0,1,0,0
Anvarjon Soliev,4,4,2009-03-28,4,0,0,0
Phan Văn Tài Em,3,2,2004-09-08,3,0,0,0
Nguyễn Minh Hải,1,1,2004-02-18,1,0,0,0
Phạm Văn Quyến,1,1,2004-02-18,1,0,0,1
Akram Al-Selwi,1,1,2004-02-18,1,0,0,0
Hong Yong-jo,8,7,2008-09-10,5,3,0,1
Roody Lormera,1,1,2004-02-21,0,1,0,1
Lawrence Harvey,1,1,2004-02-21,0,1,1,0
Titus Elva,3,3,2008-03-26,2,1,0,0
Thomas Elliot,1,1,2004-02-22,1,0,0,0
Marlon Felter,5,3,2008-09-10,3,2,1,1
Patrick Zinhagel,2,2,2004-03-27,1,1,0,0
Maurice Escalona,3,3,2011-07-08,2,1,0,0
Nigel Bishop,1,1,2004-02-28,1,0,0,0
Kennedy Phillip,1,1,2004-02-28,1,0,0,0
Anthony Augustine,1,1,2004-02-28,1,0,0,0
Dennis Rennie,1,1,2004-02-28,1,0,0,0
Damon Ming,4,2,2004-03-21,3,1,0,0
Khano Smith,6,5,2011-11-14,3,3,0,2
Ralph Bean,3,2,2004-03-21,2,1,0,0
Otis Steede,1,1,2004-02-29,1,0,0,0
Rohann Simons,1,1,2004-02-29,1,0,0,0
Carey Harris,1,1,2004-03-14,1,0,0,0
Jason Roberts,5,4,2008-06-14,4,1,0,1
Byron Bubb,2,2,2008-03-26,1,1,0,0
Kervin Severino,2,1,2004-03-21,2,0,0,1
Juan Contrera,2,1,2004-03-21,2,0,0,0
Luis Casquez,1,1,2004-03-21,1,0,0,0
Clevon Hill,1,1,2004-03-21,0,1,0,0
Damani Horton,1,1,2004-03-26,1,0,0,0
Vincent Casimir,3,2,2004-03-28,0,3,0,0
Gordon Kinsaini,2,1,2004-03-27,2,0,0,0
Carlos Loswijk,1,1,2004-03-27,1,0,0,0
Clifton Sandvliet,4,4,2008-10-11,3,1,0,0
Nesley Jean,3,2,2011-07-02,1,2,0,0
Kelly Peters,1,1,2004-03-28,0,1,0,0
Sheldon Emmanuel,2,1,2004-03-28,2,0,0,1
Elijah Joseph,1,1,2004-03-28,1,0,0,0
Jarvin Skeete,2,1,2004-03-28,2,0,0,0
Andy Baptiste,1,1,2004-03-28,1,0,0,0
Moisés Villarroel,1,1,2004-03-30,0,1,0,0
Mark González,2,2,2010-06-21,1,1,0,0
Rocky Siberie,7,5,2011-11-15,3,4,0,0
Eugene Martha,2,2,2008-06-22,1,1,1,0
Brutil Hosé,2,2,2004-06-12,2,0,0,0
Amad Ali,2,2,2004-09-08,0,2,0,0
Ahmed Mubarak Al-Mahaijri,9,8,2019-01-17,6,3,0,1
Mohammed Al-Hinai,3,2,2007-10-28,0,3,0,0
Mo'ayyad Salim,1,1,2004-03-31,1,0,0,0
Azamat Ishenbaev,1,1,2004-03-31,1,0,0,0
Meaataz Kailouni,1,1,2004-03-31,0,1,0,0
Reza Enayati,3,2,2004-07-20,1,2,0,0
Ebrahim Taghipour,2,1,2004-03-31,0,2,0,0
Bader Al-Mutawa,14,12,2019-11-19,8,6,0,4
Hamad Al Harbi,1,1,2004-03-31,0,1,0,0
Razzaq Farhan,4,3,2004-07-22,2,2,0,0
Indra Sahdan Daud,2,2,2004-10-13,2,0,0,0
Toshiya Fujita,1,1,2004-03-31,0,1,0,0
Leonid Koshelev,2,2,2004-11-17,1,1,0,0
Budi Sudarsono,4,4,2007-11-09,2,2,0,0
Khaled Hamieh,1,1,2004-03-31,0,1,0,0
Sarayoot Chaikamdee,9,6,2008-06-02,4,5,0,0
Nirut Surasiang,2,2,2007-10-15,0,2,0,0
Mauri Wasi,2,2,2004-05-17,1,1,0,0
Dennis Bryce,1,1,2004-05-10,1,0,0,0
Tama Fasavalu,2,1,2004-05-10,2,0,0,0
Alick Maemae,3,2,2004-05-12,3,0,0,0
Axel Temataua,3,3,2004-06-06,3,0,0,0
Rino Moretta,1,1,2004-05-10,1,0,0,0
Alphose Qorig,3,2,2004-06-02,0,3,0,1
Etienne Mermer,5,3,2008-06-14,1,4,0,0
Natia Natia,1,1,2004-05-12,1,0,0,0
Moise Poida,1,1,2004-05-12,0,1,0,0
Seimata Chilia,3,3,2004-06-02,0,3,0,0
Jean Maleb,4,3,2004-06-02,0,4,0,0
Pita Rabo,1,1,2004-05-12,1,0,0,0
Paul Komboi,2,2,2004-05-17,0,2,0,0
Laisiasa Gataurua,4,3,2004-06-02,3,1,0,0
Seveci Rokotakala,4,3,2004-05-17,3,1,0,0
Leo Leslie,1,1,2004-05-12,1,0,0,0
Thomas Vulivuli,1,1,2004-05-15,1,0,0,0
Waisake Sabutu,3,2,2004-05-17,2,1,0,0
George Suri,1,1,2004-05-15,1,0,0,0
Mark Uhatahi,1,1,2004-05-15,1,0,0,0
John Pareanga,1,1,2004-05-15,0,1,0,0
Viliami Vaitaki,1,1,2004-05-15,1,0,0,0
Andrew Lepani,4,2,2004-05-19,0,4,0,0
Michael Lohai,1,1,2004-05-17,0,1,0,0
Pierre Wajoka,5,4,2008-06-21,5,0,0,1
Michel Hmaé,11,6,2008-09-06,10,1,0,0
Ramon Djamali,2,2,2008-06-14,1,1,0,0
José Hmae,2,2,2004-05-19,2,0,0,0
Gabriel Wajoka,2,2,2004-06-06,2,0,0,0
Lorry Thomsen,1,1,2004-05-19,0,1,0,0
Wilkins Lauru,2,1,2004-05-19,0,2,0,0
Paul Poatinda,3,1,2004-05-19,3,0,0,0
Robert Kaumé,1,1,2004-05-19,1,0,0,0
Nathaniel Lepani,1,1,2004-05-19,0,1,0,0
Eric Komeng,1,1,2004-05-19,0,1,0,0
Vincent Simon,2,2,2004-05-31,1,1,1,0
Mark Bresciano,5,5,2013-06-11,4,1,0,0
Tim Cahill,36,24,2017-10-10,26,10,0,0
Mile Sterjovski,4,2,2009-06-10,4,0,0,0
Brent Fisher,4,2,2004-06-04,4,0,0,0
Duncan Oughton,2,2,2004-06-04,2,0,0,0
Adrian Madaschi,2,1,2004-06-02,2,0,0,0
Ahmad Elrich,3,3,2004-10-12,2,1,0,0
Franklin Salas,2,2,2004-07-10,1,1,0,0
Paul Kakai,1,1,2004-06-04,0,1,0,0
Mahlon Houkarawa,1,1,2004-06-04,0,1,0,0
Neil Jones,1,1,2004-06-04,1,0,0,0
Herman Soliz,1,1,2004-06-05,1,0,1,0
Shingayi Kaondera,4,4,2005-09-04,2,2,0,0
Heston Munthali,2,2,2004-09-04,1,1,0,0
Obafemi Martins,13,7,2010-01-20,7,6,0,2
Mbulelo Mabizela,2,1,2004-06-05,2,0,0,0
Janício Martins,1,1,2004-06-05,0,1,0,0
José Clayton,4,4,2005-10-08,4,0,0,3
Karim Haggui,3,2,2006-02-04,2,1,0,0
Dipsy Selolwane,4,4,2012-01-28,3,1,0,1
Jacob Mulenga,7,6,2013-06-15,5,2,0,0
Séïdath Tchomogo,3,3,2009-06-21,0,3,0,0
Rigobert Song,3,3,2008-05-31,2,1,0,0
Luís Fabiano,20,13,2010-06-28,10,10,0,1
Víctor Pacheco,2,1,2004-06-06,2,0,0,0
Tressor Moreno,6,5,2005-07-10,4,2,0,2
John Restrepo,2,2,2005-06-04,2,0,0,0
Sergio Herrera,2,2,2004-07-24,2,0,0,1
Aruna Dindane,10,7,2008-01-25,6,4,0,1
Didier Drogba,31,25,2013-10-12,20,11,0,6
Alvin Kieh,1,1,2004-06-06,1,0,0,0
Mohamed Aboutrika,20,17,2013-10-15,10,10,0,4
Mohamed Abdelwahab,1,1,2004-06-06,0,1,0,0
Ibrahim Sekagya,2,2,2008-05-31,2,0,0,0
Duaij Naser Abdulla,2,2,2004-08-03,2,0,0,0
Sun Jihai,1,1,2004-06-09,1,0,0,0
Elie Aiboy,3,3,2007-07-14,2,1,0,0
Haitham Al-Shboul,1,1,2004-06-09,0,1,0,0
Ahmad Mnajed,2,1,2004-06-09,2,0,0,0
Huang Wei-yi,3,3,2004-11-17,1,2,0,0
Jassim Swadi,1,1,2004-06-09,1,0,0,0
Takashi Fukunishi,5,5,2005-03-25,1,4,0,0
Yuji Nakazawa,9,7,2008-06-14,5,4,0,0
Mitsuo Ogasawara,3,3,2005-06-03,2,1,0,0
Hussain Seraj,1,1,2004-06-09,1,0,0,0
Musaed Neda,4,4,2011-10-11,2,2,0,0
Khalaf Al-Salamah,1,1,2004-06-09,1,0,0,0
Ali Nasseredine,4,3,2004-10-13,2,2,0,0
Badar Al-Maimani,5,2,2007-07-08,4,1,0,0
Khalifa Ayil,2,1,2004-06-09,2,0,0,0
Ahmed Hadid Al-Mukhaini,1,1,2004-06-09,1,0,0,0
Waleed Jassem,2,1,2004-06-09,2,0,0,0
Sayed Ali Bechir,3,3,2008-06-22,1,2,0,0
Mohammed Noor,3,3,2011-11-11,2,1,0,2
Kim Do-heon,6,4,2008-06-14,2,4,0,1
Kim Yong-su,2,1,2004-06-09,0,2,0,0
Sin Yong-nam,1,1,2004-06-09,0,1,0,0
Rashid Abdulrahman,1,1,2004-06-09,1,0,0,0
Mohamed Omer,3,2,2004-09-08,2,1,0,0
Bakhtiyor Ashurmatov,1,1,2004-06-09,1,0,0,0
Vladimir Shishelov,2,2,2004-07-30,2,0,0,0
Server Djeparov,14,13,2015-11-17,8,6,0,2
Mohamad Yehya Al Rashed,1,1,2004-06-10,1,0,0,0
Raja Rafe,8,5,2015-06-11,4,4,0,0
Douglas Sequeira,1,1,2004-06-12,0,1,0,0
Álvaro Saborío,21,16,2019-06-24,11,10,0,2
Marlon King,8,5,2008-11-19,5,3,0,1
Angelos Basinas,5,5,2007-11-21,2,3,0,4
Cristiano Ronaldo,108,67,2023-11-16,59,49,0,19
Dennis Purperhart,1,1,2004-06-12,1,0,0,0
Adam Newton,1,1,2004-06-13,0,1,0,0
José Orlando Martínez Peña,1,1,2004-06-13,1,0,0,0
Víctor Velásquez,2,2,2004-08-18,2,0,0,0
Frank Lampard,19,17,2013-03-22,10,9,0,8
Renson Haynes,2,2,2004-11-17,0,2,0,0
Emilio Palacios,2,2,2004-06-20,1,1,0,0
Shandel Samuel,5,4,2016-03-25,3,2,0,0
Rudel Calero,1,1,2004-06-13,1,0,0,0
Luis Tejada,24,21,2016-09-06,15,9,0,1
Ricardo Phillips,3,2,2005-07-21,1,2,0,0
Greg Vanney,1,1,2004-06-13,1,0,0,0
Marek Heinz,4,4,2005-10-12,2,2,0,0
Torsten Frings,3,3,2007-06-02,3,0,0,1
Maniche,6,6,2007-09-08,5,1,0,0
Igor Tudor,4,4,2005-06-04,2,2,1,0
Antonio Cassano,9,8,2012-06-18,7,2,0,0
Jaime Lozano,11,6,2005-10-12,6,5,0,0
Edgar Alvarez,1,1,2004-06-19,1,0,0,0
Wilfred Bouma,2,2,2004-10-09,1,1,0,0
Abedi Saïd,3,2,2004-10-09,3,0,0,0
Jimmy Mulisa,1,1,2004-06-19,1,0,0,0
Darryl Gomez,1,1,2004-06-19,1,0,0,0
Calum Willock,2,1,2004-06-19,2,0,0,0
Kenroy Skinner,1,1,2004-06-19,0,1,0,0
Mouritala Ogunbiyi,2,2,2004-07-04,2,0,0,0
Amar Ramadan,1,1,2004-06-20,0,1,0,0
Michel Bouanga,2,2,2004-10-10,2,0,0,0
Armel Disney,4,4,2005-10-08,4,0,0,0
Gervais Batota,2,2,2008-06-14,1,1,0,0
Alain Cervantes,2,2,2005-07-12,0,2,0,0
Marcel Kimemba Mbayo,1,1,2004-06-20,1,0,0,0
Mbala Mbuta Biscotte,1,1,2004-06-20,1,0,0,0
Dikilu Bageta,1,1,2004-06-20,1,0,0,1
Sulley Muntari,12,12,2013-10-15,8,4,0,1
Gino Brandon,1,1,2004-06-20,0,1,0,0
Kaba Diawara,7,6,2006-02-03,5,2,0,0
Dmitri Kirichenko,3,2,2005-10-08,3,0,0,0
Alberto Blanco,1,1,2004-06-20,0,1,0,0
Carlos Alonso,1,1,2004-06-20,1,0,1,0
Yao Junior Sènaya,2,1,2004-06-20,2,0,0,0
Jason Scotland,1,1,2004-06-20,1,0,0,0
Densill Theobald,1,1,2004-06-20,1,0,0,0
Scott Sealy,1,1,2004-06-20,1,0,0,0
Slimane Raho,1,1,2004-06-20,1,0,1,0
Johan Vonlanthen,5,3,2004-10-09,4,1,0,0
Simone Perrotta,2,2,2006-10-11,1,1,0,0
Hélder Postiga,18,16,2013-10-15,12,6,0,0
David Oteo,1,1,2004-06-27,1,0,0,0
Héctor Altamirano,4,4,2004-11-17,3,1,0,2
Jorge Andrade,2,2,2005-09-03,1,1,1,0
Traianos Dellas,1,1,2004-07-01,1,0,0,0
Dioko Kaluyituka,4,3,2011-11-15,2,2,0,0
Jimmy Modeste,1,1,2004-07-03,1,0,0,0
Thierry Issiémou,2,2,2004-10-09,2,0,0,0
Marco Paulo Rebelo Lopes,1,1,2004-07-03,0,1,0,0
Albert Mpinganjira,1,1,2004-07-03,1,0,0,0
Tinashe Nengomasha,1,1,2004-07-03,0,1,0,0
Babacar Gueye,1,1,2004-07-03,1,0,0,0
Steven Pienaar,2,2,2005-03-26,2,0,0,0
Nader Kara,3,3,2004-10-08,2,1,0,0
Jocelyn Ahouéya,2,2,2008-06-22,2,0,0,0
Hassan Mostafa,1,1,2004-07-04,0,1,0,0
Guy Feutchine,1,1,2004-07-04,1,0,0,0
Lorgio Álvarez,1,1,2004-07-06,0,1,0,0
Javier Saviola,6,4,2006-06-10,6,0,0,0
Lucho González,4,4,2009-04-01,3,1,0,0
Ricardo Osorio,2,2,2008-11-19,2,0,1,0
Julio dos Santos,1,1,2004-07-08,0,1,0,1
Edixon Perea,2,2,2007-07-02,1,1,0,0
Santiago Acasiete,2,2,2005-10-12,2,0,0,0
Massimo Margiotta,1,1,2004-07-09,0,1,0,0
Ramón Morales,3,3,2007-06-27,0,3,0,0
Juan,6,6,2010-06-28,4,2,0,0
Sebastián González,2,2,2004-11-17,0,2,0,0
Ernesto Cristaldo,1,1,2004-07-11,1,0,0,0
Abel Aguilar,5,5,2016-10-11,3,2,0,0
Fabián Estoyanoff,2,2,2004-07-24,0,2,0,0
Luciano Figueroa,9,5,2005-06-26,4,5,0,0
Julio Valentín González,1,1,2004-07-14,0,1,0,0
Fredy Bareiro,1,1,2004-07-14,0,1,0,0
Rafael Olarra,1,1,2004-07-14,0,1,0,0
Andy Herron,5,4,2009-07-19,4,1,0,0
Mohamed Hubail,5,4,2004-11-17,3,2,0,0
Zheng Zhi,6,5,2016-09-01,5,1,1,4
Carlos Tevez,7,6,2010-06-27,6,1,0,0
Ricardo Oliveira,3,3,2016-03-29,1,2,0,0
Ponaryo Astaman,1,1,2004-07-18,0,1,0,0
Magid Mohamed,2,2,2008-09-06,2,0,0,0
Basheer Saeed,5,4,2012-02-29,4,1,1,0
Javad Nekounam,17,14,2013-06-11,12,5,0,2
Wesam Rizik,2,2,2004-09-08,0,2,0,1
Shao Jiayi,7,5,2007-07-15,6,1,0,0
Li Yi,1,1,2004-07-21,1,0,0,0
Marcelo Sosa,1,1,2004-07-21,1,0,0,0
Hawar Mulla Mohammed,5,5,2012-02-29,4,1,0,2
Vladimir Bayramov,2,2,2007-11-18,2,0,0,0
Qusay Munir,5,4,2011-11-15,3,2,0,0
Alexander Geynrikh,16,15,2016-09-01,11,5,0,1
Khaled Saad,1,1,2004-07-23,1,0,0,0
Anas Al-Zboun,1,1,2004-07-23,1,0,0,0
Amad Al-Hosni,10,8,2015-09-03,8,2,0,1
Mohammad Nosrati,2,2,2005-06-08,1,1,0,0
Luisão,2,2,2009-09-05,0,2,0,0
Nashat Akram,9,8,2012-06-03,3,6,0,1
Hamad Al-Montashari,2,2,2009-09-09,2,0,0,0
Younis Mahmoud,20,17,2015-11-17,11,9,0,2
Rangsan Viwatchaichok,1,1,2004-07-28,1,0,1,0
Park Jin-seop,1,1,2004-07-31,0,1,1,0
Kim Nam-il,1,1,2004-07-31,1,0,0,0
Koji Nakata,2,2,2004-08-07,0,2,0,0
Keiji Tamada,7,6,2008-11-19,3,4,0,0
Mohammad Alavi,1,1,2004-08-03,0,1,0,0
Saleh Ahmed Farhan,1,1,2004-08-06,0,1,0,0
Brian Ching,8,7,2009-07-08,7,1,0,0
Fabio D'Elia,1,1,2004-08-18,1,0,0,0
Joel Lindpere,3,3,2013-03-26,1,2,0,0
Goran Pandev,16,15,2021-06-13,6,10,0,2
Veliče Šumulikoski,1,1,2004-08-18,1,0,0,0
Alexei Eremenko,10,8,2007-08-22,6,4,0,0
Errol McFarlane,4,3,2007-06-12,1,3,0,0
Vratislav Greško,1,1,2004-08-18,1,0,0,0
Younes Al Shibani,2,2,2008-06-20,2,0,0,0
Bachirou Osseni,1,1,2004-09-03,0,1,0,0
Ahmed Saad Osman,6,5,2012-01-25,5,1,0,0
Marei Al Ramly,1,1,2004-09-03,1,0,0,0
Roland Kollmann,2,2,2004-09-08,2,0,0,0
Rashad Sadygov,6,6,2017-09-04,6,0,3,0
Abdoul-Aziz Nikiema,1,1,2004-09-04,1,0,0,0
Ivan Klasnić,5,5,2009-04-01,3,2,0,0
Gábor Gyepes,1,1,2004-09-04,1,0,1,0
Ingemar Teever,2,2,2004-10-13,1,1,0,0
Manuel Schauls,1,1,2004-09-04,1,0,1,0
Hristo Yanev,2,2,2004-10-13,1,1,0,0
Daniele De Rossi,15,14,2017-03-24,11,4,0,3
Luca Toni,11,7,2007-11-21,7,4,0,0
Damani Ralph,1,1,2004-09-04,1,0,0,0
Maciej Żurawski,8,8,2007-03-28,5,3,0,1
Piotr Włodarczyk,1,1,2004-09-04,0,1,0,0
Jacek Krzynówek,8,7,2007-09-08,2,6,0,0
Mauro Rosales,1,1,2004-09-04,0,1,0,0
Fabricio Coloccini,1,1,2004-09-04,0,1,0,0
Andy Reid,2,2,2006-11-15,2,0,0,0
Aleksandar Vasoski,1,1,2004-09-04,0,1,0,0
Nenad Jestrović,2,1,2004-09-04,0,2,0,0
Fatih Tekke,7,4,2005-06-08,3,4,0,0
Catilina Aubameyang,1,1,2004-09-05,0,1,0,0
Georges Akieremy,1,1,2004-09-05,0,1,0,0
Etienne Bito'o,1,1,2004-09-05,0,1,0,0
Freddy,1,1,2004-09-05,1,0,0,0
Adriano Leite Ribeiro,6,4,2005-10-12,5,1,0,0
Kabamba Musasa,1,1,2004-09-05,1,0,0,0
Mohamed Shawky,3,3,2009-06-15,1,2,0,0
Bill Tchato,1,1,2004-09-05,0,1,0,0
Michael Essien,6,6,2009-09-06,5,1,0,1
Nélson Veiga,1,1,2004-09-05,1,0,1,0
Alonso Solís,3,3,2008-10-11,1,2,0,0
Fodé Mansaré,2,2,2004-10-10,2,0,0,0
Bakari Koné,7,7,2009-06-07,3,4,0,0
Papa Dia,1,1,2004-09-05,0,1,0,0
Joseph Enakarhire,1,1,2004-09-05,0,1,0,0
Florin Cernat,2,1,2004-09-08,0,2,0,0
Marc Pujol,4,4,2021-10-12,3,1,0,3
Martin Stranzl,3,3,2008-10-11,1,2,0,0
Micah Hyde,1,1,2004-09-08,0,1,0,0
Giorgi Demetradze,6,5,2006-09-06,2,4,0,0
Nawaf Humaidan,1,1,2004-09-08,0,1,0,0
Sándor Torghelle,6,6,2009-03-28,3,3,0,0
Indriði Sigurðsson,2,2,2009-04-01,0,2,0,0
Tsuneyasu Miyamoto,1,1,2004-09-08,0,1,0,0
Oleksiy Byelik,2,2,2004-10-13,1,1,0,0
Andrei Karpovich,1,1,2004-09-08,1,0,0,0
Ruslan Rotan,5,5,2016-10-09,3,2,0,0
Emil Kenjisariev,1,1,2004-09-08,1,0,0,0
Nasser Kamil Mubarak,1,1,2004-09-08,0,1,0,0
Meshal Abdullah,1,1,2004-09-08,0,1,0,0
Phutthadavong Chanthalome,1,1,2004-09-08,1,0,0,0
Saad Al-Shammari,2,2,2007-10-28,1,1,0,0
Tomas Danilevičius,9,8,2009-09-09,6,3,0,2
Andrius Gedgaudas,1,1,2004-09-08,1,0,0,0
Gordon Braun,1,1,2004-09-08,1,0,0,0
Alphonse Leweck,3,3,2008-09-10,1,2,0,0
Eric Hoffmann,1,1,2004-09-08,0,1,1,0
Mahmoud Chahoud,1,1,2004-09-08,0,1,0,0
An Yong-hak,2,1,2004-09-08,2,0,0,0
Ri Hyok-chol,4,4,2016-03-29,2,2,0,0
Vidar Riseth,1,1,2004-09-08,1,0,0,0
Marat Bikmaev,4,4,2016-11-15,2,2,0,0
Jermain Defoe,14,9,2017-03-26,9,5,0,0
Arkadiusz Głowacki,1,1,2004-09-08,0,1,1,0
Yousuf Shaaban,1,1,2004-09-08,0,1,0,0
Marek Mintál,9,6,2007-09-12,5,4,0,0
Radoslav Zabavník,1,1,2004-09-08,1,0,0,0
Ilham Jaya Kesuma,5,3,2004-11-17,4,1,0,0
Dudley Steinwall,1,1,2004-09-08,1,0,0,0
Chandradasa Karunaratne,1,1,2004-09-08,1,0,0,0
Salih Sadir,2,1,2004-09-08,0,2,0,0
Saad Attiya,1,1,2004-09-08,0,1,0,0
Lee Chun-soo,2,2,2006-06-13,1,1,0,0
Radwan Abduljabar,1,1,2004-09-08,1,0,0,0
Sergio Santana,4,3,2004-11-17,2,2,0,0
Amr Zaki,17,13,2013-11-19,13,4,0,0
Cristian Rodríguez,8,8,2016-10-11,4,4,0,0
Tomasz Frankowski,7,5,2005-10-12,3,4,0,0
Sergei Omelyanchuk,1,1,2004-10-09,1,0,0,0
Maksim Romaschenko,7,5,2007-11-17,3,4,0,1
Diego Gavilán,1,1,2004-10-09,0,1,0,0
Carlos Hernández,5,4,2005-10-08,4,1,0,0
Claus Bech Jørgensen,1,1,2004-10-09,0,1,0,0
Eddie Johnson,16,13,2013-09-10,11,5,0,1
Atiba Hutchinson,6,6,2022-02-02,4,2,1,0
Franz Burgmeier,6,5,2014-11-15,3,3,1,0
Thomas Beck,5,4,2007-10-17,5,0,0,0
Andrey Arshavin,13,13,2009-10-14,5,8,0,0
Russel Mwafulirwa,4,4,2010-01-18,3,1,0,0
Emmanuel Chipatala,2,2,2005-06-04,1,1,0,0
Dirk Kuyt,15,13,2011-10-11,10,5,0,2
Boštjan Cesar,7,7,2016-09-04,2,5,0,0
Albert Luque,2,2,2005-06-04,2,0,0,0
Döwlet Baýramow,1,1,2004-10-09,0,1,0,0
Isuru Perera,1,1,2004-10-09,1,0,0,0
Rathnayake Mudyanselage,1,1,2004-10-09,1,0,0,0
Artýom Nazarow,1,1,2004-10-09,0,1,0,0
Faisal Agab,3,3,2008-10-11,2,1,0,1
Flávio Amado,13,11,2010-01-14,8,5,0,1
Collins Mbesuma,10,8,2016-11-12,5,5,0,0
Alexander Riley,1,1,2004-10-10,1,0,1,0
Cornell Glen,4,4,2009-08-12,2,2,0,0
Marc Bernaus,1,1,2004-10-13,1,0,0,0
Chavdar Yankov,3,3,2007-06-06,2,1,0,0
Wong Chun Yue,1,1,2004-10-13,1,0,0,0
Christian Wilhelmsson,7,6,2011-09-06,1,6,0,0
Alberto Gilardino,10,8,2013-09-06,8,2,0,0
Waleed Ali,2,2,2011-07-28,1,1,0,0
Visay Phaphouvanin,4,4,2011-07-28,3,1,0,0
Abdel-Hadi Al-Maharmeh,1,1,2004-10-13,0,1,0,0
Sengphet Thongphachan,1,1,2004-10-13,1,0,0,0
Martin Stocklasa,1,1,2004-10-13,0,1,0,0
Sinha,5,5,2006-06-11,3,2,0,0
Steven Thompson,1,1,2004-10-13,0,1,0,0
Ri Han-jae,1,1,2004-10-13,1,0,0,0
Fathi Jaber,1,1,2004-10-13,0,1,0,0
Colin Murdock,1,1,2004-10-13,1,0,0,0
Morten Gamst Pedersen,7,6,2011-10-11,4,3,0,0
Alexander Ødegaard,1,1,2004-10-13,1,0,0,0
Deco,4,4,2008-09-10,3,1,0,1
Simão Sabrosa,12,9,2010-06-21,11,1,0,1
Petit,3,2,2006-07-08,3,0,1,0
Vahid Hashemian,4,2,2005-03-25,2,2,0,0
Bilal Mohammed,2,2,2011-01-16,2,0,0,0
Arash Borhani,2,2,2004-11-17,1,1,0,0
Ognjen Koroman,1,1,2004-10-13,1,0,0,0
Khairul Amri,3,3,2015-10-08,2,1,0,0
Jehad Al-Hussain,5,4,2008-06-22,3,2,0,1
Sayed Mahfoodh,1,1,2004-10-13,0,1,0,0
Mansurdzhon Hakimov,1,1,2004-10-13,1,0,0,0
Nontapan Jeansatawong,1,1,2004-10-13,1,0,0,0
Anon Nanok,1,1,2004-10-13,1,0,0,0
José Anthony Torres,1,1,2004-10-13,1,0,1,0
Marlon Ayoví,2,2,2005-03-27,1,1,0,2
Francisco Fonseca,13,8,2006-06-21,8,5,0,0
Imad Zatara,1,1,2004-11-16,0,1,0,0
Juan Román Riquelme,15,11,2007-11-17,12,3,0,4
Leonel Vielma,1,1,2004-11-17,0,1,0,0
Ciprian Marica,17,15,2014-09-07,11,6,0,3
Karen Dokhoyan,1,1,2004-11-17,1,0,0,0
Adoram Keisi,2,2,2005-09-03,0,2,0,0
Kostas Katsouranis,4,4,2008-10-11,3,1,0,0
Edwin Mukenya,1,1,2004-11-17,1,0,0,0
Mohd Amri Yahyah,1,1,2004-11-17,0,1,0,0
Fahad Al Hamad,1,1,2004-11-17,1,0,0,0
Ben Federspiel,1,1,2004-11-17,0,1,1,0
Péter Kovács,1,1,2004-11-17,0,1,0,0
Luis Ernesto Pérez,5,3,2005-09-07,5,0,0,0
Felipe Baloy,4,4,2018-06-24,3,1,1,0
José Luis Garcés,4,4,2008-06-22,3,1,0,0
Paolo Guerrero,25,20,2019-07-07,13,12,0,1
Mohammed Salem Al-Mal,1,1,2004-11-17,1,0,0,0
Nayef Mubarak Al Khater,1,1,2004-11-17,1,0,0,0
Marat Izmailov,2,2,2005-10-08,2,0,0,0
Dmitri Loskov,2,2,2005-06-04,2,0,0,2
Saad Al-Harthi,6,6,2008-09-06,5,1,0,0
Fahad Fallata,1,1,2004-11-17,1,0,0,0
Vyacheslav Amin,1,1,2004-11-17,0,1,0,0
Saleh Al-Shehri,9,8,2022-11-22,4,5,0,1
Hector Sam,1,1,2004-11-17,1,0,0,0
Oleh Husyev,7,6,2013-03-22,3,4,0,0
Saleh Obaid,1,1,2004-11-17,1,0,0,0
Andriy Rusol,3,3,2006-09-06,1,2,0,0
Nam Song-Chol,1,1,2005-02-09,0,1,0,0
Masashi Oguro,5,5,2005-08-17,3,2,0,0
Mounir Diane,1,1,2005-02-09,1,0,0,0
Fernando Torres,28,17,2014-06-23,14,14,0,3
Asier del Horno,1,1,2005-02-09,1,0,0,0
Pak Song-Gwan,1,1,2005-03-25,1,0,0,0
Saud Khariri,1,1,2005-03-25,1,0,0,0
Ara Hakobyan,4,3,2005-10-12,1,3,0,0
Fernando Silva,2,2,2007-08-22,0,2,0,0
Romik Khachatryan,1,1,2005-03-26,1,0,0,0
Koen Daerden,3,2,2005-09-07,3,0,0,0
Luciano Galletti,1,1,2005-03-26,0,1,0,0
Erik Edman,1,1,2005-03-26,0,1,0,0
Carlos Morais Caló,3,2,2005-09-04,0,3,0,0
Mario Regueiro,1,1,2005-03-26,0,1,0,0
Whayne Wilson,1,1,2005-03-26,1,0,0,1
Roy Myrie,4,3,2008-11-19,1,3,0,0
Jan Polák,5,4,2006-10-07,5,0,0,0
Christian Poulsen,4,4,2009-04-01,3,1,0,0
Joe Cole,6,5,2008-09-06,1,5,0,0
Michalis Kapsis,1,1,2005-03-26,0,1,0,0
Carlos Edwards,3,3,2009-06-06,1,2,0,0
Abbas Souan,1,1,2005-03-26,1,0,0,0
Andrea Pirlo,10,9,2013-06-16,6,4,0,3
Aftandil Hacıyev,1,1,2005-03-26,1,0,1,0
Marek Saganowski,4,3,2009-04-01,3,1,0,0
Ryan Babel,4,3,2019-09-09,0,4,0,0
Abdoulaye Faye,3,3,2008-05-31,3,0,0,0
Haykel Guemamdia,4,4,2005-09-03,2,2,0,1
Necati Ateş,2,2,2005-11-16,2,0,0,2
Geremi Njitap,6,6,2010-01-17,4,2,0,0
Pierre Webó,8,6,2013-11-17,3,5,0,0
Salvador Cabañas,10,9,2009-10-10,4,6,0,1
Antonio Valencia,8,7,2016-10-06,6,2,0,0
Othman Ferjani,1,1,2005-03-27,0,1,0,0
Emad Moteab,11,8,2010-01-20,11,0,0,0
Chérif Touré Mamam,4,4,2006-01-29,2,2,0,0
Alejandro Cichero,2,2,2007-06-30,2,0,1,0
Giancarlo Maldonado,10,9,2009-09-05,8,2,0,0
Joselito Vaca,1,1,2005-03-29,1,0,0,0
Tolga Seyhan,1,1,2005-03-30,0,1,0,0
Aleksandr Amisulashvili,1,1,2005-03-30,1,0,0,0
Koray Avcı,1,1,2005-03-30,0,1,0,0
Tuncay,12,8,2009-09-05,6,6,0,0
Péter Rajczi,2,2,2005-09-03,2,0,0,0
Romeo Castelen,1,1,2005-03-30,1,0,0,0
Nicolae Mitea,2,1,2005-03-30,0,2,0,0
Goran Maznov,4,4,2007-11-17,3,1,0,0
Timmy Simons,6,6,2011-10-07,4,2,0,6
Aleksander Rodić,1,1,2005-03-30,1,0,0,0
Aliaksandr Kulchiy,1,1,2005-03-30,0,1,0,0
Émerson Ferreira da Rosa,1,1,2005-03-30,0,1,0,0
Rahman Rezaei,2,2,2007-07-11,1,1,1,0
Park Chu-young,14,12,2011-11-11,6,8,1,2
Vladimir Burduli,1,1,2005-06-04,0,1,0,0
Edgar Manucharyan,2,2,2010-09-07,1,1,0,0
Coffi Agbessi,1,1,2005-06-04,1,0,0,0
Mogogi Gabonamong,1,1,2005-06-04,1,0,0,0
Mehdi Nafti,1,1,2005-06-04,0,1,0,0
Wisam El Abdy,1,1,2005-06-04,0,1,0,0
Marko Babić,1,1,2005-06-04,0,1,0,0
Niko Kranjčar,10,8,2013-10-11,3,7,0,1
Luis Fuentes,2,1,2005-06-04,2,0,0,0
Luis Gabriel Rey,3,3,2005-10-12,2,1,0,0
Elkin Soto,2,2,2005-09-04,1,1,0,0
Edixon Perea Valencia,1,1,2005-06-04,1,0,0,0
Gabriel Riera,1,1,2005-06-04,0,1,0,0
Tomáš Galásek,1,1,2005-06-04,1,0,0,0
Christian Lara,1,1,2005-06-04,1,0,0,0
Andrei Stepanov,1,1,2005-06-04,1,0,0,0
Raphaël Wicky,1,1,2005-06-04,0,1,0,0
Gustavo Adolfo Cabrera,2,2,2011-09-06,0,2,1,0
Kristján Örn Sigurðsson,2,2,2009-06-06,2,0,0,0
Szabolcs Huszti,3,3,2009-09-05,1,2,0,2
Houssine Kharja,7,6,2012-06-09,3,4,0,2
Fernando Meira,1,1,2005-06-04,1,0,0,0
Avi Yehiel,1,1,2005-06-04,0,1,0,0
Johan Elmander,8,7,2013-09-06,2,6,0,0
Dennis Lawrence,2,2,2005-11-16,1,1,0,0
Robinho,18,14,2015-06-27,10,8,0,2
Ngasanya Ilongo,1,1,2005-06-05,1,0,0,0
Zola Matumona,4,3,2008-06-13,2,2,0,1
Ahmed Eid Abdel Malek,3,3,2008-06-06,2,1,0,0
Matthew Amoah,9,8,2009-11-15,5,4,0,0
Souleymane Diamouténé,1,1,2005-06-05,1,0,0,1
Arcadia Martin Wesay Toe,1,1,2005-06-05,0,1,0,0
Jimmy Gatete,1,1,2005-06-05,1,0,0,0
Luis Antonio Jiménez,2,1,2005-06-08,2,0,0,0
Martín Arzuaga,1,1,2005-06-08,1,0,0,0
Edwin Villatoro,1,1,2005-06-08,0,1,0,0
Mario Rafael Rodríguez,6,5,2011-10-07,3,3,0,0
Søren Larsen,10,6,2009-04-01,7,3,0,0
Erjon Bogdani,11,10,2012-09-07,7,4,0,0
Robin van Persie,36,26,2015-10-13,23,13,1,4
Gunnar Heiðar Þorvaldsson,2,2,2006-09-02,1,1,0,0
Veigar Páll Gunnarsson,2,2,2008-10-15,2,0,0,0
İbrahim Toraman,1,1,2005-06-08,0,1,0,0
Halil Altıntop,4,4,2009-10-14,2,2,0,0
Chung Kyung-ho,1,1,2005-06-08,0,1,0,0
Karol Kisel,1,1,2005-06-08,0,1,0,0
Julio César Cáceres,1,1,2005-06-08,1,0,0,0
Jorge Martín Núñez,1,1,2005-06-08,1,0,0,0
Ovidiu Petre,1,1,2005-06-08,1,0,0,0
Gheorghe Bucur,4,3,2009-10-14,4,0,0,0
Zvjezdan Misimović,19,14,2013-10-11,11,8,0,4
Carlos Marchena,1,1,2005-06-08,1,0,0,0
Adel Chedli,2,2,2005-10-08,2,0,0,0
Per Mertesacker,3,3,2013-09-10,2,1,0,0
Lukas Podolski,29,22,2012-06-17,18,11,0,0
Juninho Pernambucano,3,3,2006-06-22,1,2,0,0
Saïdou Panandétiguiri,2,2,2009-09-05,2,0,1,0
Etienne Alain Djissikadie,1,1,2005-06-18,1,0,0,0
Dieudonné Londo,1,1,2005-06-18,1,0,0,0
Bastian Schweinsteiger,14,12,2016-06-12,7,7,0,1
Mike Hanke,1,1,2005-06-18,1,0,0,0
Tshepo Motlhabankwe,1,1,2005-06-18,0,1,0,0
Paulo Figueiredo,1,1,2005-06-18,0,1,0,0
Adékambi Olufadé,4,4,2008-10-11,2,2,0,0
Geoffrey Sserunkuma,2,2,2005-10-08,2,0,0,0
Linos Chalwe,1,1,2005-06-18,1,0,0,0
Antar Yahia,4,4,2009-11-18,4,0,0,0
Sofiane Daoud,1,1,2005-06-19,1,0,0,0
Rudy Bhebey,2,1,2005-06-19,0,2,0,0
Gerald Asamoah,1,1,2005-06-21,1,0,0,0
Esteban Cambiasso,3,3,2008-09-10,1,2,0,0
Carlos Salcido,6,6,2012-09-07,3,3,0,0
Robert Huth,1,1,2005-06-29,1,0,0,0
Chris Birchall,2,2,2005-11-12,2,0,0,0
Maynor Figueroa,2,2,2013-10-15,0,2,0,0
Clint Dempsey,41,34,2017-07-22,30,11,0,4
Luton Shelton,11,8,2012-10-12,9,2,0,2
Ricardo Fuller,3,3,2008-10-11,1,2,0,0
Jermaine Hue,2,2,2005-07-10,1,1,0,0
Phil Evans,1,1,2005-07-08,1,0,0,0
Elrio van Heerden,3,3,2008-01-31,2,1,0,0
Francisco Javier Rodríguez,1,1,2005-07-08,0,1,0,0
Randall Brenes,6,4,2013-09-10,5,1,0,1
Maykel Galindo,1,1,2005-07-09,0,1,0,0
Abram Raselemane,1,1,2005-07-10,0,1,0,0
Lungisani Ndlela,2,2,2005-07-17,1,1,0,0
Damion Stewart,1,1,2005-07-10,1,0,0,0
Teafore Bennett,1,1,2005-07-10,1,0,0,0
Gerardo Galindo,1,1,2005-07-10,1,0,0,0
Ali Gerba,12,9,2009-07-07,8,4,0,0
Héctor Hurtado,1,1,2005-07-12,1,0,0,0
Gonzalo Romero,5,4,2008-06-21,2,3,0,0
Siyabonga Nkosi,1,1,2005-07-13,0,1,0,0
Alberto Medina,1,1,2005-07-13,1,0,0,0
Christian Bolaños,6,5,2016-11-15,4,2,0,0
Bryan Ruiz,20,18,2022-01-27,11,9,0,1
Jaime Castrillón,3,3,2007-07-05,1,2,0,0
Gonzalo Pineda,1,1,2005-07-17,1,0,0,0
Oguchi Onyewu,2,2,2008-10-11,2,0,0,0
Choe Chol-Man,1,1,2005-08-17,0,1,0,0
Kim Chol-Ho,1,1,2005-08-17,0,1,0,0
Salman Isa,4,4,2008-09-06,3,1,0,0
An Chol-Hyok,2,2,2008-09-06,0,2,0,0
Asimakis Krassas,1,1,2005-08-17,0,1,0,0
Akira Kaji,1,1,2005-08-17,1,0,0,0
Daniar Kenzhekhanov,1,1,2005-08-17,1,0,0,0
Paulus Roiha,1,1,2005-08-17,0,1,0,0
Mohammed Al-Anbar,1,1,2005-08-17,0,1,0,0
Florian Myrtaj,1,1,2005-09-03,1,0,0,0
Maksim Nizovtsev,1,1,2005-09-03,0,1,0,0
Jason Culina,1,1,2005-09-03,1,0,0,0
Doyle Vaca,1,1,2005-09-03,1,0,0,0
Abdoulaye Cissé,2,1,2005-09-03,2,0,0,0
Yahia Kébé,2,2,2005-10-08,1,1,0,0
Ákos Takács,1,1,2005-09-03,1,0,0,0
Issam Jemâa,9,9,2012-06-09,4,5,0,0
Abdoulai Demba,1,1,2005-09-03,1,0,0,0
Serghei Rogaciov,5,3,2006-10-07,5,0,0,1
Warren Feeney,4,4,2009-04-01,4,0,0,0
Euzebiusz Smolarek,12,8,2008-10-15,8,4,0,0
Roland Linz,3,2,2010-09-07,1,2,0,0
Ricardo Carvalho,4,4,2015-03-29,3,1,1,0
Fabio Grosso,4,4,2009-09-09,2,2,0,0
Anton Žlogar,1,1,2005-09-03,1,0,0,0
José Torrealba,2,1,2005-09-03,2,0,0,0
Hamza Yacef,1,1,2005-09-04,1,0,0,0
Christian Obodo,3,3,2008-10-11,2,1,0,0
René Nsi-Akoue,1,1,2005-09-04,1,0,1,0
Mantorras,2,2,2008-06-14,1,1,0,0
Zé Kalanga,2,2,2008-10-12,2,0,0,0
Cyrille Mubiala Kitambala,1,1,2005-09-04,1,0,0,0
Trésor Mputu,9,8,2013-01-20,4,5,0,0
Stéphane Sessègnon,4,4,2015-11-12,2,2,0,1
Noel Mkandawire,4,3,2008-05-31,3,1,0,0
Zvenyika Makonese,1,1,2005-09-04,0,1,1,0
Ashley Rambanapasi,1,1,2005-09-04,1,0,0,0
Mauro Camoranesi,3,3,2009-10-10,0,3,0,0
Mbo Mpenza,2,1,2005-09-07,2,0,0,0
Kevin Vandenbergh,2,2,2006-10-11,2,0,0,0
Grétar Steinsson,1,1,2005-09-07,0,1,0,0
Georgi Iliev,1,1,2005-09-07,1,0,0,0
Efstathios Aloneftis,9,8,2012-10-16,7,2,0,0
Philippe Senderos,5,4,2009-10-10,2,3,0,0
Daniel Gygax,1,1,2005-09-07,0,1,0,0
Daniel Agger,7,6,2013-10-15,6,1,1,5
Maksim Zhalmagambetov,1,1,2005-09-07,1,0,0,0
Benjamin Fischer,2,2,2005-10-08,1,1,0,0
Stephen Wellman,1,1,2005-09-07,1,0,0,0
Klemen Lavrič,5,4,2007-09-12,1,4,0,1
Matej Mavrič,1,1,2005-09-07,0,1,0,0
Ole Martin Årst,1,1,2005-09-07,1,0,0,0
Ignatius Lwipa,2,1,2005-10-01,0,2,0,0
Nchimunya Mweetwa,2,1,2005-10-01,0,2,0,0
Ousmane Bangoura,4,3,2006-01-30,0,4,0,0
Zdravko Lazarov,1,1,2005-10-08,1,0,0,0
Roudolphe Douala,1,1,2005-10-08,1,0,0,0
Joetex Asamoah Frimpong,1,1,2005-10-08,0,1,0,0
Godwin Attram,1,1,2005-10-08,0,1,0,0
Ricardo Francisco Rojas,1,1,2005-10-08,0,1,0,0
Bertrand Bouity,1,1,2005-10-08,1,0,0,0
Stephen Elliott,1,1,2005-10-08,0,1,0,0
Barry Opdam,1,1,2005-10-08,0,1,0,0
Michael Gravgaard,4,4,2007-03-24,1,3,0,0
Michael Zandberg,1,1,2005-10-08,1,0,0,0
Símun Samuelsen,1,1,2005-10-08,0,1,0,0
Cristian Zaccardo,2,2,2006-06-17,1,1,1,0
Jimmy Zakazaka,1,1,2005-10-08,1,0,0,0
Guillermo Franco,5,5,2009-09-05,2,3,0,0
Selvyn Ponciano,1,1,2005-10-08,0,1,0,0
Ayila Yussuf,1,1,2005-10-08,1,0,0,0
Peter Odemwingie,6,5,2014-06-21,6,0,0,0
Carl Robinson,1,1,2005-10-08,0,1,0,0
Steven Davis,10,9,2019-03-21,8,2,0,3
Claude Reiter,1,1,2005-10-08,0,1,0,1
Roman Pavlyuchenko,16,12,2012-06-08,13,3,0,5
Peter Hlinka,1,1,2005-10-08,1,0,0,0
Kanga Akalé,2,2,2008-06-14,0,2,0,0
Simon Masaba,1,1,2005-10-08,1,0,0,1
Florent Rouamba,1,1,2005-10-08,0,1,0,0
Nelson Valdez,8,8,2015-06-13,4,4,0,0
Luis Guadalupe,1,1,2005-10-09,1,0,1,0
Rachad Chitou,1,1,2005-10-09,1,0,0,0
Óscar Sonejee,2,2,2009-09-09,1,1,1,0
Tomas Jun,1,1,2005-10-12,0,1,0,0
Vikash Dhorasoo,1,1,2005-10-12,1,0,0,0
Dimitris Papadopoulos,1,1,2005-10-12,1,0,0,0
Élmer Ponciano,1,1,2005-10-12,1,0,0,0
Alexandru Gațcan,2,2,2016-11-12,0,2,0,0
Aleksandr Kuchma,2,2,2008-10-11,2,0,1,0
Karel Geraerts,3,3,2007-10-17,1,2,0,0
Olivier Deschacht,1,1,2005-10-12,1,0,1,0
Etienne Barbara,1,1,2005-10-12,1,0,0,0
Gustavo Vassallo,1,1,2005-10-12,1,0,0,0
Hugo Viana,1,1,2005-10-12,1,0,0,0
Antonio López Guerrero,1,1,2005-10-12,0,1,0,0
Sergio Ramos,18,16,2020-09-06,11,7,0,6
Paul Hartley,1,1,2005-10-12,0,1,0,0
Kári Árnason,4,4,2017-10-06,2,2,0,0
Kyle Martino,1,1,2005-10-12,1,0,0,0
Taylor Twellman,2,2,2007-06-12,2,0,0,0
Valon Behrami,1,1,2005-11-12,1,0,0,0
Salman Ghuloom,2,2,2008-06-07,1,1,0,0
Filip Hološko,5,5,2010-09-03,3,2,0,0
David Villa,41,29,2014-06-23,26,15,0,4
Marco Streller,2,2,2010-10-12,1,1,0,0
Lomana LuaLua,2,2,2008-10-11,0,2,0,0
James Chamanga,4,4,2012-02-04,1,3,0,0
Riadh Bouazizi,1,1,2006-01-22,1,0,0,0
Taye Taiwo,1,1,2006-01-23,1,0,0,0
Issa Ba,1,1,2006-01-23,0,1,0,0
Abdesalam Kames,1,1,2006-01-24,1,0,0,0
Yaya Touré,13,12,2015-02-04,5,8,0,1
Albert Meyong,4,3,2008-10-11,4,0,0,0
Mikel John Obi,5,5,2017-09-01,5,0,0,0
Arouna Koné,1,1,2006-01-28,0,1,0,0
Norberto Maurito,1,1,2006-01-29,1,0,0,0
Christopher Katongo,10,10,2013-06-08,5,5,0,2
Issah Gabriel Ahmed,1,1,2006-01-31,0,1,1,0
Baba Adamu,1,1,2006-01-31,1,0,0,0
Victor Obinna,7,6,2013-11-16,7,0,0,1
Philipp Lahm,3,3,2012-06-22,3,0,0,0
Vincenzo Iaquinta,4,4,2010-06-20,4,0,0,1
Xabi Alonso,7,6,2014-06-13,4,3,0,3
Peter Crouch,10,8,2009-10-14,8,2,0,0
Maxi Rodríguez,7,5,2013-10-15,4,3,0,0
Lionel Messi,55,44,2024-07-09,40,15,0,14
Fred,8,6,2014-06-23,8,0,0,0
Maksym Kalynychenko,3,2,2007-10-17,2,1,0,0
Tranquillo Barnetta,4,3,2012-10-16,0,4,0,0
Bartosz Bosacki,2,1,2006-06-20,0,2,0,0
Brent Sancho,1,1,2006-06-20,1,0,1,0
Nikola Žigić,14,13,2010-10-08,9,5,0,0
Craig Moore,1,1,2006-06-22,0,1,0,1
Marco Materazzi,2,2,2006-07-09,1,1,0,0
Haminu Draman,2,2,2008-02-09,2,0,0,0
Gilberto,2,2,2024-01-20,0,2,0,0
Franck Ribéry,10,9,2013-10-15,5,5,0,1
Gianluca Zambrotta,1,1,2006-06-30,1,0,0,0
Davit Mujiri,1,1,2006-08-16,0,1,0,0
Timofei Kalachev,10,8,2015-03-27,6,4,0,0
David Lafata,4,3,2014-10-13,2,2,0,0
Martin Jiránek,1,1,2006-09-02,0,1,1,0
Roberto Colautti,6,5,2007-06-06,3,3,0,0
Florent Malouda,5,5,2011-10-07,1,4,0,0
Louis Saha,2,2,2006-10-11,1,1,0,0
Fredrik Strømstad,2,2,2006-09-06,1,1,0,0
Joris Mathijsen,2,2,2008-10-11,1,1,0,0
Jamie Pace,2,2,2010-09-02,1,1,0,0
Mirko Hrgović,2,2,2007-10-13,0,2,0,0
Mladen Bartolović,1,1,2006-09-02,0,1,0,0
Zlatan Muslimović,8,7,2009-09-05,5,3,0,0
Mika Väyrynen,3,3,2010-11-17,2,1,0,0
Łukasz Garguła,1,1,2006-09-02,1,0,0,0
Kris Boyd,4,3,2007-09-08,4,0,0,1
Garry O'Connor,2,2,2007-06-06,1,1,0,0
Martin Škrtel,7,7,2017-10-05,6,1,2,0
Filip Šebo,3,2,2011-03-26,2,1,0,0
Nicolae Dică,4,3,2007-11-21,2,2,0,1
Andrezinho,1,1,2006-09-06,1,0,0,0
Valeri Bojinov,1,1,2006-09-06,1,0,0,0
Dimitar Telkiyski,3,3,2009-09-05,3,0,0,0
Amit Ben-Shushan,2,2,2006-10-07,1,1,0,0
Toto Tamuz,2,2,2007-06-06,1,1,0,0
Juli Fernandez,1,1,2006-09-06,0,1,0,0
Darius Miceika,1,1,2006-09-06,1,0,0,0
Xavi,8,8,2013-10-11,4,4,0,0
Radosław Matusiak,3,3,2007-11-21,1,2,0,0
Danko Lazović,5,5,2010-09-03,2,3,0,0
Thomas Hitzlsperger,5,4,2008-09-06,2,3,0,0
Manuel Friedrich,1,1,2006-09-06,0,1,0,0
Libor Sionko,5,4,2008-10-15,2,3,0,0
Markus Rosenberg,2,2,2007-06-06,2,0,0,0
Mladen Petrić,10,6,2010-09-03,6,4,0,0
Luka Modrić,22,22,2024-06-24,13,9,0,8
Stephen Ireland,4,4,2007-09-08,1,3,0,0
Alexandros Garpozis,1,1,2006-10-07,1,0,0,0
Constantinos Charalambides,6,4,2015-10-13,6,0,0,0
Marek Kulič,2,2,2007-11-17,2,0,0,0
David Jarolím,1,1,2006-10-07,1,0,0,0
Andrius Skerla,1,1,2006-10-07,0,1,0,0
Massimo Oddo,1,1,2006-10-07,1,0,0,1
Ģirts Karlsons,4,4,2009-03-28,2,2,0,0
Aleksejs Višņakovs,6,6,2015-03-28,4,2,0,0
Ivica Grlić,1,1,2006-10-07,0,1,0,0
Sergei Kornilenko,10,8,2015-09-05,5,5,0,2
Dorin Goian,3,3,2008-10-11,3,0,0,0
Gary Caldwell,1,1,2006-10-07,1,0,0,0
Milivoje Novaković,21,17,2017-06-10,14,7,0,2
Robert Koren,4,3,2010-06-13,3,1,0,0
Dušan Švento,1,1,2006-10-07,0,1,0,0
Gareth Bale,35,28,2022-11-21,20,15,0,7
Nikolče Noveski,3,3,2012-09-11,1,2,0,0
Ilčo Naumoski,6,6,2010-10-08,4,2,0,1
Denis Kovba,1,1,2006-10-11,1,0,0,0
Vladimir Korytko,2,2,2007-11-21,2,0,0,0
Mousa Dembélé,5,4,2009-03-28,5,0,0,0
Christos Patsatzoglou,1,1,2006-10-11,0,1,0,0
Georgios Samaras,6,6,2014-06-24,4,2,0,2
Eduardo da Silva,18,14,2013-03-26,9,9,0,0
Gary Neville,1,1,2006-10-11,1,0,1,0
Giorgi Shashiashvili,1,1,2006-10-11,1,0,0,0
Arnar Viðarsson,1,1,2006-10-11,1,0,0,0
Daniel Jensen,2,2,2008-09-10,0,2,0,0
Aleksandar Tunchev,1,1,2006-10-11,0,1,0,0
Andre Schembri,3,2,2007-09-08,3,0,0,0
Arjan Beqaj,1,1,2006-10-11,1,0,1,0
Debatik Curri,1,1,2006-10-11,0,1,0,0
Pavel Pogrebnyak,4,3,2010-09-03,2,2,0,1
Stanislav Varga,1,1,2006-10-11,1,0,0,0
Oleksandr Kucher,1,1,2006-10-11,1,0,0,0
Jason Koumas,4,3,2007-11-17,4,0,0,2
Vladimir Bystrov,2,2,2007-03-24,0,2,0,0
Kevin Doyle,9,9,2012-09-07,3,6,0,0
Manuel Marani,1,1,2007-02-07,1,0,0,0
Martin Jakubko,6,6,2013-10-15,3,3,0,0
Volodymyr Yezerskiy,1,1,2007-03-24,0,1,0,0
Sotirios Kyrgiakos,3,2,2007-09-12,1,2,0,0
Gökhan Ünal,2,2,2007-09-12,1,1,0,0
Kairat Ashirbekov,1,1,2007-03-24,1,0,0,0
Nurbol Zhumaskaliyev,1,1,2007-03-24,1,0,0,0
Grant McCann,3,3,2009-02-11,1,2,0,0
Chris Sagramola,1,1,2007-03-24,1,0,0,0
Alexandru Epureanu,3,3,2014-10-12,1,2,0,0
Jacek Bąk,1,1,2007-03-24,1,0,0,0
Dariusz Dudka,1,1,2007-03-24,1,0,0,0
Wojciech Łobodziński,1,1,2007-03-24,1,0,0,0
Przemysław Kaźmierczak,1,1,2007-03-24,1,0,0,0
Ricardo Quaresma,5,5,2018-06-25,2,3,0,0
Craig Beattie,1,1,2007-03-24,1,0,0,0
David Nugent,1,1,2007-03-28,0,1,0,0
Emin Imamaliev,1,1,2007-03-28,1,0,0,0
Radoslav Kováč,2,2,2008-11-19,1,1,0,0
David Siradze,5,5,2010-10-12,4,1,0,0
Tamás Priskin,4,4,2015-11-15,3,1,0,0
Ben Sahar,5,3,2009-09-09,5,0,0,0
Tiago Mendes,3,2,2010-06-21,2,1,0,0
Boško Janković,3,3,2007-10-17,1,2,0,0
Andrés Iniesta,8,8,2015-09-05,3,5,0,1
Simen Brenne,1,1,2007-03-28,0,1,0,0
Martin Andresen,1,1,2007-03-28,0,1,0,0
Hamit Altıntop,4,3,2010-09-07,3,1,0,0
Edmond Kapllani,5,4,2007-11-21,2,3,0,0
Branimir Subašić,1,1,2007-06-02,1,0,0,0
Nani,16,14,2017-06-24,10,6,0,0
Marouane Fellaini,11,10,2018-07-02,9,2,0,0
Sabri Sarıoğlu,1,1,2007-06-02,0,1,0,0
Edin Džeko,50,38,2023-09-08,30,20,0,2
Adnan Ćustović,1,1,2007-06-02,1,0,0,0
Milan Jovanović,8,7,2011-09-06,3,5,0,0
Marcell Jansen,3,3,2010-07-10,2,1,0,0
Mario Gómez,15,12,2017-09-04,6,9,0,0
Clemens Fritz,2,2,2007-11-17,2,0,0,0
Theofanis Gekas,19,13,2013-03-22,12,7,0,1
Giourkas Seitaridis,1,1,2007-06-02,1,0,0,0
Raphael Rohrer,1,1,2007-06-02,0,1,0,0
Robert Arzumanyan,4,4,2014-10-11,3,1,0,0
Sargis Hovsepyan,2,2,2009-09-09,1,1,0,1
Saulius Mikoliūnas,4,4,2014-10-09,3,1,0,0
Barak Yitzhaki,1,1,2007-06-02,0,1,0,0
Kristofer Hæstad,1,1,2007-06-02,1,0,0,0
Gabriel Tamaş,2,2,2007-11-21,1,1,0,0
Bănel Nicoliţă,1,1,2007-06-02,0,1,0,0
Dare Vršič,2,2,2011-10-11,2,0,0,0
Hamlet Mkhitaryan,1,1,2007-06-06,1,0,0,0
Julian de Guzman,3,2,2008-08-20,1,2,0,0
Shaun Maloney,7,6,2015-10-11,3,4,0,2
Samir Nasri,4,4,2013-09-10,3,1,0,1
Ján Ďurica,6,6,2013-06-07,3,3,3,1
Christoph Metzelder,1,1,2007-06-06,0,1,1,0
Monès Chéry,2,2,2009-07-11,0,2,0,1
Cédrick Fiston,1,1,2007-06-06,1,0,0,0
Vüqar Nadirov,3,3,2011-10-07,1,2,0,0
Fabio Quagliarella,6,4,2019-03-26,3,3,0,2
Daniel Braaten,2,2,2013-10-15,2,0,0,0
Silvio Spann,1,1,2007-06-07,0,1,0,0
Ramón Sánchez,1,1,2007-06-07,1,0,0,0
Dennis Alas,1,1,2007-06-07,1,0,0,0
Reynier Alcántara,2,2,2007-06-10,0,2,0,0
Nery Castillo,6,5,2009-04-01,4,2,0,2
Carlos Rivera,1,1,2007-06-08,1,0,0,0
Blas Pérez,24,19,2017-06-13,16,8,0,0
Carlo Costly,22,15,2014-06-20,15,7,0,0
Jocelyn Angloma,2,2,2007-06-17,0,2,0,0
David Fleurival,2,2,2009-07-05,0,2,0,0
José Manuel Contreras,2,2,2008-09-10,2,0,0,0
Alexandre Boucicaut,1,1,2007-06-09,1,0,0,0
Jaime Colomé,4,3,2008-10-15,1,3,0,1
Richard Socrier,1,1,2007-06-17,0,1,0,0
Iain Hume,5,4,2012-10-16,0,5,0,0
Andrés Guardado,20,17,2019-06-19,11,9,0,4
Benny Feilhaber,1,1,2007-06-24,1,0,0,0
Miguel Villalta,1,1,2007-06-26,0,1,0,0
Juan Carlos Mariño,3,3,2012-10-12,1,2,0,0
Juan Carlos Arce,10,9,2021-11-16,7,3,0,3
Humberto Suazo,15,12,2011-10-11,6,9,0,4
Christian Benítez,8,8,2013-03-26,7,1,0,0
Carlos Villanueva,1,1,2007-06-27,0,1,0,0
Daniel Arismendi,3,2,2007-11-20,3,0,0,0
Diego Milito,1,1,2007-07-02,1,0,0,0
Édgar Barreto,1,1,2007-07-02,0,1,0,0
Óscar Cardozo,5,5,2019-06-16,2,3,0,1
Jhasmani Campos,3,3,2016-06-10,1,2,0,0
Javier Mascherano,2,2,2007-07-08,2,0,0,0
Júlio Baptista,5,5,2009-09-09,2,3,0,0
Josué Anunciado de Oliveira,1,1,2007-07-07,0,1,0,0
Vágner Love,2,2,2007-10-17,1,1,0,0
Fernando Arce,4,3,2008-09-06,4,0,0,0
Huỳnh Quang Thanh,3,2,2011-07-03,1,2,0,0
Lê Công Vinh,11,5,2016-03-24,7,4,0,1
Sebastián Soria,14,13,2016-10-06,8,6,0,2
Sayed Mahmood Jalal,1,1,2007-07-10,0,1,0,0
Han Peng,2,1,2007-07-10,0,2,0,0
Wang Dong,2,1,2007-07-10,0,2,0,0
Indra Putra Mahayuddin,1,1,2007-07-10,1,0,0,0
Jalal Hosseini,5,5,2016-10-06,2,3,0,0
Javad Kazemian,1,1,2007-07-11,1,0,0,0
Gabriel Heinze,3,3,2010-06-12,1,2,1,0
Choi Sung-kuk,1,1,2007-07-11,1,0,0,0
Pipat Thonkanya,2,1,2007-07-12,2,0,0,0
Phan Thanh Bình,1,1,2007-07-12,1,0,0,0
Karrar Jassim,3,3,2012-02-29,3,0,0,0
Timur Kapadze,6,6,2011-11-11,4,2,0,0
Aziz Ibrahimov,2,2,2008-06-02,0,2,0,0
Ismail Abdullatif,16,10,2021-06-15,13,3,0,3
Dani Alves,5,5,2019-06-22,2,3,0,0
Mao Jianqing,1,1,2007-07-15,1,0,0,0
Ferydoon Zandi,2,2,2008-06-07,0,2,0,0
Michael Beauchamp,1,1,2007-07-16,0,1,0,0
Keita Suzuki,1,1,2007-07-16,1,0,1,0
Seiichiro Maki,3,2,2008-02-06,1,2,0,0
Yasuhito Endō,6,6,2015-01-12,2,4,0,2
Kim Jung-woo,2,2,2011-09-02,1,1,0,0
Andranik Teymourian,4,4,2015-09-08,2,2,0,0
Ahmed Al-Mousa,2,2,2007-07-22,2,0,0,0
Abdulrahman Al-Qahtani,1,1,2007-07-18,1,0,0,0
Taisir Al-Jassim,8,7,2016-10-06,6,2,0,0
Pavel Solomin,1,1,2007-07-22,0,1,0,0
Malek Mouath,5,3,2008-06-22,3,2,0,0
Yuki Abe,1,1,2007-07-25,1,0,0,0
Kevin Mirallas,4,4,2013-09-06,1,3,0,0
Zdravko Kuzmanović,4,3,2011-09-06,2,2,0,0
Kyle Lafferty,15,13,2016-11-11,9,6,0,0
Shaun Wright-Phillips,3,3,2009-10-14,3,0,0,0
Micah Richards,1,1,2007-09-08,1,0,0,0
Oleh Shelayev,1,1,2007-09-08,0,1,0,0
Emil Hallfreðsson,1,1,2007-09-08,1,0,0,0
Chris Baird,1,1,2007-09-08,1,0,1,0
Servet Çetin,2,2,2009-10-14,1,1,0,0
Mariusz Lewandowski,3,3,2009-09-05,2,1,0,0
Vasili Berezutski,4,4,2016-06-11,3,1,0,0
Stephen McManus,2,2,2010-09-07,2,0,0,0
Maroš Klimpl,1,1,2007-09-08,1,0,0,0
Marek Čech,5,3,2009-06-06,3,2,0,0
Ivan Rakitić,9,8,2018-06-21,5,4,0,2
Igor Bugaiov,5,5,2016-10-09,3,2,0,1
Constantinos Makrides,4,4,2014-10-10,3,1,0,0
Morten Nordstrand,3,2,2009-03-28,2,1,0,0
Ármann Björnsson,1,1,2007-09-12,1,0,0,0
Samat Smakov,2,2,2014-11-16,1,1,0,2
Branislav Ivanović,7,7,2016-10-06,3,4,0,0
Freddy Eastwood,1,1,2007-09-12,0,1,0,0
Mehmet Aurélio,1,1,2007-09-12,1,0,0,0
Antonio Di Natale,6,4,2012-06-10,0,6,0,0
Zumratul Hossain Mithu,1,1,2007-10-08,1,0,0,0
Sunil Chhetri,13,10,2021-06-07,5,8,0,2
Mohammed Ghaddar,7,5,2015-06-16,3,4,0,2
Mahmoud El Ali,5,5,2012-02-29,2,3,0,0
Hassan Mudhafar,1,1,2007-10-08,1,0,0,1
Shi Jiayi,4,3,2011-07-28,1,3,0,0
John Wilkinson,3,3,2008-06-22,1,2,0,0
Mohamed Al Zeno,4,3,2011-01-17,2,2,0,1
Teerasil Dangda,11,9,2019-10-15,7,4,0,1
Kin Seng Chan,2,2,2007-10-15,1,1,0,0
Teeratep Winothai,3,3,2008-06-02,2,1,0,1
Patiparn Phetphun,1,1,2007-10-08,1,0,0,0
Datsakorn Thonglao,5,4,2011-07-28,1,4,0,0
Mohammed Salem,1,1,2007-10-08,1,0,0,0
Fekri Al-Hubaishi,1,1,2007-10-08,1,0,0,0
Haitham Thabit,1,1,2007-10-08,1,0,0,0
Mamedaly Karadanov,2,2,2007-10-28,1,1,0,0
Bruno Alves,8,8,2016-11-13,3,5,0,0
Hugo Almeida,8,8,2013-03-26,3,5,0,0
James Collins,3,3,2021-03-24,1,2,0,0
Raúl Tamudo,1,1,2007-10-13,0,1,0,0
Albert Riera,2,2,2009-04-01,0,2,0,0
Taavi Rähn,1,1,2007-10-13,1,0,1,0
Karim Benzema,22,17,2022-06-03,12,10,0,2
Jérôme Rothen,1,1,2007-10-13,0,1,0,0
Hatem Ben Arfa,1,1,2007-10-13,0,1,0,0
Vedad Ibišević,18,15,2017-03-25,9,9,0,0
Róbert Feczesin,1,1,2007-10-13,1,0,0,0
Dániel Tőzsér,1,1,2007-10-13,1,0,0,0
Oskars Kļava,1,1,2007-10-13,0,1,0,0
Ümit Karan,1,1,2007-10-13,0,1,0,0
Lee McCulloch,1,1,2007-10-13,1,0,0,0
Marek Hamšík,19,16,2020-10-14,10,9,0,2
Stanislav Šesták,9,7,2014-10-12,5,4,0,0
Marek Sapara,4,4,2012-10-12,3,1,0,0
Luis Suárez,47,37,2024-07-13,28,19,0,9
Victor Karpenko,3,3,2011-07-28,1,2,0,0
Shavkat Salomov,1,1,2007-10-13,1,0,0,0
Daoud Midtadi,1,1,2007-10-14,0,1,0,0
Faneva Imà Andriatsima,6,3,2019-07-07,6,0,0,1
Bakar Ibor,1,1,2007-10-14,0,1,0,1
Rija Rakotomandimby,2,2,2007-11-17,1,1,0,0
Jean Tsaralaza,1,1,2007-10-14,1,0,0,0
Suree Sukha,1,1,2007-10-15,0,1,0,0
Gabriel Milito,1,1,2007-10-16,0,1,0,0
Radostin Kishishev,2,2,2009-09-05,2,0,1,0
Duško Tošić,1,1,2007-10-17,0,1,0,0
Samir Aliyev,1,1,2007-10-17,1,0,0,0
Milan Smiljanić,1,1,2007-10-17,0,1,0,0
Erik Hagen,2,2,2007-11-17,1,1,0,0
Bjørn Helge Riise,1,1,2007-10-17,0,1,0,0
Elano,3,3,2010-06-20,3,0,0,0
Matías Fernández,7,7,2012-09-11,3,4,0,0
Ulrik Laursen,1,1,2007-10-17,1,0,0,0
Kaspars Gorkšs,6,6,2012-09-11,1,5,0,0
Shane Smeltz,14,11,2012-10-12,5,9,0,1
Levan Mchedlidze,1,1,2007-10-17,1,0,0,0
Marek Matějovský,1,1,2007-10-17,0,1,0,0
Jaroslav Plašil,5,5,2011-09-03,1,4,0,0
Ariza Makukula,1,1,2007-10-17,0,1,0,0
Terence Scerri,1,1,2007-10-17,1,0,0,0
Klaas-Jan Huntelaar,26,20,2015-10-13,19,7,0,2
Stelios Okkarides,1,1,2007-10-17,0,1,0,0
Steve Finnan,1,1,2007-10-17,1,0,0,0
Joe Ledley,2,2,2008-09-10,0,2,0,0
Kewullay Conteh,2,2,2008-09-06,2,0,0,0
Ioannis Amanatidis,2,2,2007-11-17,1,1,0,0
Cholponbek Esenkul Uulu,1,1,2007-10-18,1,0,0,0
Aibek Bokoev,1,1,2007-10-18,1,0,0,0
Abdulla Baba Fatadi,2,2,2008-09-10,1,1,0,0
Jesse John,1,1,2007-10-21,1,0,0,0
Mohd Bunyamin Omar,1,1,2007-10-21,0,1,0,0
Mahmood Abdulrahman,5,4,2012-02-29,4,1,0,1
Du Zhenyu,1,1,2007-10-21,1,0,0,0
Yang Lin,1,1,2007-10-21,1,0,0,0
Liu Jian,2,2,2007-10-28,1,1,0,0
Pak Chol-min,3,2,2007-10-28,2,1,0,0
Jong Chol-min,4,2,2007-10-28,1,3,0,0
Odkhuu Selenge,1,1,2007-10-21,1,0,0,0
Cheng Siu Wai,4,2,2007-10-28,2,2,0,0
Alfredo Esteves,1,1,2007-10-21,0,1,1,0
Emílio da Silva,3,2,2007-10-28,2,1,0,0
Mahdi Karim,4,1,2007-10-22,0,4,0,0
Jassim Mohammed Ghulam,1,1,2007-10-22,0,1,0,0
Obaidullah Karimi,1,1,2007-10-26,1,0,0,0
Aatef Jenyat,1,1,2007-10-26,0,1,0,0
Firas Issmael,1,1,2007-10-26,0,1,0,0
Lo Kwan Yee,2,2,2015-06-11,2,0,0,0
Chan Siu Ki,4,2,2015-10-13,3,1,0,0
Cheung Sai Ho,1,1,2007-10-28,1,0,0,0
Lam Ka Wai,3,3,2015-06-16,3,0,0,1
Shamveel Qasim,1,1,2007-10-28,1,0,0,0
Wu Wei'an,1,1,2007-10-28,0,1,0,0
Zheng Bin,1,1,2007-10-28,0,1,0,0
Zhang Yaokun,1,1,2007-10-28,0,1,0,1
Hashim Saleh,1,1,2007-10-28,0,1,0,0
Kim Kuk-jin,1,1,2007-10-28,1,0,0,0
Donorovyn Lkhümbengarav,1,1,2007-10-28,0,1,0,0
Jon Kwang-ik,1,1,2007-10-28,1,0,0,0
Seyd Bechir,2,1,2007-10-28,2,0,0,0
Islom Inomov,1,1,2007-10-28,0,1,0,0
Ilhomjon Suyunov,1,1,2007-10-28,0,1,0,0
Dzhomikhon Mukhiddinov,1,1,2007-10-28,1,0,0,0
Dilshod Vasiev,1,1,2007-10-28,1,0,0,0
Mekan Nasyrow,2,2,2007-11-18,2,0,0,0
Artur Geworkýan,3,2,2015-11-17,3,0,0,0
Ismail Matar,10,9,2016-11-15,4,6,0,1
Ahmed Mohammed Al-Mahri,1,1,2007-10-28,1,0,0,0
Mohamed Al-Shehhi,5,5,2011-07-28,3,2,0,1
Nawaf Mubarak,1,1,2007-10-28,1,0,0,0
Steven Dias,1,1,2007-10-30,1,0,0,0
Feras Esmaeel,1,1,2007-11-09,0,1,0,0
Zyad Chaabo,5,3,2008-03-26,4,1,0,0
Aleksandar Đurić,7,5,2011-09-02,6,1,0,0
Hussein Yassin,1,1,2007-11-16,1,0,0,0
Sergio Agüero,20,19,2019-07-06,15,5,0,1
Velizar Dimitrov,1,1,2007-11-17,1,0,0,0
Rubén Darío Bustos,2,2,2007-11-20,2,0,0,0
Lalaïna Nomenjanahary,3,2,2019-06-30,1,2,0,0
Hubert Robson,1,1,2007-11-17,0,1,0,0
Zdeněk Grygera,1,1,2007-11-17,1,0,0,0
Michal Kadlec,5,4,2011-10-11,1,4,1,3
Valerio Nawatu,1,1,2007-11-17,1,0,0,0
Osea Vakatalesau,2,1,2007-11-17,2,0,0,0
Ramon Gjamaci,1,1,2007-11-17,0,1,0,0
Mael Kaudre,1,1,2007-11-17,0,1,0,0
Mahmud Qurbanov,1,1,2007-11-17,0,1,0,0
Elyaniv Barda,9,6,2011-03-26,8,1,0,0
Diniyar Bilyaletdinov,4,3,2011-10-11,3,1,0,0
Omer Golan,5,5,2009-09-09,3,2,0,0
Dzintars Zirnis,1,1,2007-11-17,0,1,1,0
Mantas Savėnas,2,2,2010-06-20,2,0,0,0
Nicolae Josan,2,2,2010-10-12,1,1,0,0
Serghei Alexeev,3,3,2011-09-02,2,1,0,0
Danny Koevermans,1,1,2007-11-17,1,0,0,0
Nicklas Bendtner,17,13,2017-11-14,9,8,0,1
Cristian Riveros,8,7,2016-11-10,6,2,0,0
Néstor Ayala,1,1,2007-11-17,1,0,0,0
Joan Capdevila,2,2,2008-09-10,2,0,0,0
Jean Nako Naprapol,3,3,2012-06-03,3,0,0,0
David Mulligan,3,2,2007-11-21,2,1,0,0
Juan Manuel Vargas,3,3,2011-07-16,2,1,0,0
Jamshed Ismailov,1,1,2007-11-18,1,0,0,0
Arif Mirzoyev,1,1,2007-11-18,1,0,0,0
Dayro Moreno,1,1,2007-11-20,1,0,0,0
Marcelo Martins Moreno,25,21,2022-02-01,15,10,0,6
Alejandro Guerra,1,1,2007-11-20,1,0,0,0
Sergei Ostapenko,6,5,2011-09-06,4,2,1,0
Luigi Pieroni,1,1,2007-11-21,0,1,0,0
Paulo da Silva,3,2,2016-09-01,1,2,0,0
Daniel Pudil,2,2,2009-09-05,0,2,0,0
Thomas Kahlenberg,4,4,2014-09-07,3,1,0,0
Walter Ayoví,3,2,2009-06-10,3,0,0,0
Andrés Augusto Mendoza,1,1,2007-11-21,0,1,0,0
Audrius Kšanavičius,2,1,2007-11-21,0,2,0,0
Ákos Buzsáky,2,2,2009-10-14,1,1,0,0
Vilmos Vanczák,3,3,2013-03-22,1,2,1,0
Fróði Benjaminsen,4,4,2013-09-06,2,2,1,1
Giorgio Chiellini,8,6,2017-10-06,6,2,1,0
Marius Mapou,1,1,2007-11-21,1,0,0,0
Francois Sakama,2,2,2008-09-10,1,1,0,0
Daniel Niculae,2,1,2007-11-21,2,0,0,0
Ľubomír Michalík,1,1,2007-11-21,0,1,0,0
Rafał Murawski,1,1,2007-11-21,0,1,0,0
Blagoy Georgiev,2,2,2008-09-06,0,2,0,0
Oumar Kalabane,2,2,2009-09-05,0,2,0,0
Soufiane Alloudi,3,1,2008-01-21,0,3,0,0
Brian Brendell,2,2,2008-01-28,1,1,0,0
Tarik Sektioui,2,2,2008-06-07,0,2,0,1
Monsef Zerka,1,1,2008-01-21,0,1,0,0
Salomon Kalou,13,12,2013-11-16,9,4,0,1
Hosny Abd Rabo,9,8,2013-03-26,6,3,0,6
Mohamed Zidan,6,4,2012-06-01,3,3,0,0
Felix Katongo,2,2,2008-09-10,1,1,0,0
Manucho,9,7,2012-01-26,2,7,0,2
Moustapha Bayal Sall,1,1,2008-01-23,0,1,0,0
Diomansy Kamara,1,1,2008-01-23,0,1,0,0
Mejdi Traoui,1,1,2008-01-23,1,0,0,0
Junior Agogo,7,6,2008-10-11,5,2,0,0
Ismaël Bangoura,6,4,2008-10-12,5,1,0,0
Hicham Aboucherouane,1,1,2008-01-24,0,1,0,0
Razak Omotoyossi,13,11,2013-06-16,6,7,0,2
Achille Emaná,5,5,2010-01-25,2,3,0,0
Chaouki Ben Saada,4,4,2008-06-21,3,1,0,1
Katlego Mphela,5,4,2012-06-03,4,1,0,0
Marc Zoro,1,1,2008-01-29,1,0,0,0
Boubacar Sanogo,6,4,2008-10-11,4,2,0,0
Mohammed Ali El Khider,1,1,2008-01-30,1,0,1,0
Tyrell Burgess,2,2,2015-03-29,2,0,0,0
Allean Richard Grant Velasquez,1,1,2008-02-03,0,1,0,0
Stéphane Mbia,3,2,2015-11-13,0,3,0,0
Yassine Chikhaoui,3,3,2015-11-13,1,2,0,0
George Dublin,2,2,2011-09-06,0,2,0,0
Dario Sierra,1,1,2008-02-06,0,1,1,0
Joshua Kennedy,8,7,2013-06-18,6,2,0,0
Deon McCaulay,18,12,2021-03-30,8,10,0,1
Gerard Williams,1,1,2008-02-06,0,1,0,0
Harrison Róchez,4,4,2015-06-14,2,2,0,0
Richard Pacquette,1,1,2008-02-06,1,0,0,0
Rashida Williams,1,1,2008-02-06,0,1,0,0
Shawn Martin,3,2,2008-09-10,2,1,0,0
Rudis Corrales,8,4,2009-09-09,7,1,0,0
Eliseo Quintanilla,7,6,2011-06-12,7,0,0,2
Emerson Umaña,1,1,2008-02-06,1,0,0,0
Yoshito Ōkubo,2,2,2008-06-02,2,0,0,0
Odil Ahmedov,15,14,2021-06-07,8,7,0,0
Anton Jongsma,1,1,2008-02-06,0,1,0,0
Kwak Tae-hwi,3,3,2012-06-08,2,1,0,0
David Lowery,1,1,2008-02-06,1,0,0,0
Gavin Glinton,1,1,2008-02-06,1,0,0,0
Gilbert Nyhime,1,1,2008-02-06,0,1,0,0
Alain N'Kong,1,1,2008-02-07,0,1,0,0
Ahmed Fathy,2,2,2018-06-19,1,1,1,0
Quincy Owusu-Abeyie,1,1,2008-02-09,1,0,0,0
Carlos Monteagudo,1,1,2008-03-26,0,1,0,0
William Antonio Torres,1,1,2008-03-26,0,1,0,0
Okeem Challenger,1,1,2008-03-26,1,0,0,0
Lesly St. Fleur,7,2,2011-07-09,7,0,1,0
Rohan Lennon,1,1,2008-03-26,0,1,0,0
Dwayne Stanford,1,1,2008-03-26,1,0,0,0
Tyrone Loran,1,1,2008-03-26,1,0,0,0
Angelo Zimmerman,3,2,2011-09-06,2,1,1,0
Shane Rennie,3,3,2011-11-15,2,1,0,1
Dorset Langiagne,1,1,2008-03-26,1,0,0,0
Dwight Ferguson,1,1,2008-03-26,1,0,1,0
Ahmad Ajab,6,3,2008-06-14,6,0,0,0
Fahad Al-Rashidi,1,1,2008-03-26,1,0,0,0
Wensley Christoph,5,3,2008-11-19,1,4,0,0
Cleon Wondel,1,1,2008-03-26,0,1,0,0
Vladimir Farrell,1,1,2008-03-26,1,0,0,0
Melvin Valies,1,1,2008-03-26,0,1,0,0
Kenzo Huur,2,1,2008-03-26,0,2,0,0
Raydell Schuurman,1,1,2008-03-26,0,1,0,0
Petter Villegas,2,2,2008-06-14,2,0,0,1
Fábio César Montezine,4,3,2011-01-21,4,0,0,0
Elroy Smith,1,1,2008-03-26,0,1,0,0
Orlando Mitchum,5,4,2015-06-11,4,1,0,0
Kenwin McPhee,2,2,2008-06-21,2,0,0,0
Fazrul Nawaz,4,4,2016-03-29,2,2,0,0
Ismail Al-Ajmi,4,4,2013-06-04,2,2,0,0
Waseem Al-Bzour,1,1,2008-03-26,0,1,0,0
Tha'er Bawab,2,2,2012-10-16,0,2,0,0
Michael Bethel,1,1,2008-03-30,1,0,0,0
Demont Mitchell,1,1,2008-03-30,1,0,0,0
Devaun DeGraff,2,1,2008-03-30,0,2,0,0
Kwame Steede,2,2,2011-11-11,1,1,0,0
Marshall Forbes,1,1,2008-03-30,1,0,0,1
Valerijus Mižigurskis,1,1,2008-05-31,0,1,0,0
Elvis Kafoteka,2,2,2010-01-11,2,0,0,0
Ahmed Daher,1,1,2008-05-31,0,1,0,0
Joseph Kamwendo,1,1,2008-05-31,1,0,0,0
Moses Chavula,3,3,2013-06-12,1,2,1,0
Robert Ng'ambi,3,3,2013-06-12,3,0,0,0
Wilko Risser,3,2,2008-10-11,3,0,0,0
Austin Makacha,1,1,2008-05-31,0,1,0,0
Costa Khaiseb,1,1,2008-05-31,1,0,0,0
Labama Bokota,4,4,2012-06-10,4,0,0,1
Hassan Abdel-Fattah,17,10,2015-10-13,10,7,0,2
Wesley Marquette,2,2,2008-09-06,1,1,0,0
Danny Mrwanda,2,2,2008-06-21,1,1,0,0
Job,2,2,2013-06-15,1,1,0,0
António Mendonça,1,1,2008-06-01,1,0,0,0
Selemani Ndikumana,2,2,2011-11-15,2,0,0,1
Hérita Ilunga,1,1,2008-06-01,0,1,0,0
Ronan Carolino Falcão,1,1,2008-06-01,1,0,0,0
Juan Ramón Epitié,1,1,2008-06-01,1,0,0,0
Prince Tagoe,3,3,2009-03-29,3,0,0,0
Laryea Kingston,2,2,2008-06-08,1,1,0,0
Sekou Cissé,3,2,2008-06-22,3,0,0,0
Vidas Alunderis,1,1,2008-06-01,1,0,1,0
Ričardas Beniušis,1,1,2008-06-01,0,1,0,0
Mustapha Jarju,3,2,2013-09-07,2,1,0,0
Lys Mouithys,2,1,2008-06-01,0,2,0,0
Adama Coulibaly,1,1,2008-06-01,1,0,0,0
Ikechukwu Uche,5,5,2012-06-03,4,1,0,0
Obinna Nwaneri,1,1,2008-06-01,1,0,0,0
Tijani Belaid,1,1,2008-06-01,1,0,0,0
Yssouf Koné,3,2,2008-06-21,1,2,0,0
Osama Hawsawi,3,3,2015-11-17,1,2,0,0
Redha Tukar,3,2,2008-06-07,3,0,0,0
Fahrudin Mustafić,2,2,2011-07-23,2,0,0,1
Vitaliy Denisov,1,1,2008-06-02,0,1,0,0
Sayed Mohamed Adnan,3,3,2015-10-13,1,2,0,0
Wilson Palacios,3,3,2013-09-10,2,1,0,0
Rafik Djebbour,2,2,2009-06-07,2,0,0,0
Karim Ziani,3,2,2009-10-11,3,0,0,2
Elvis Macedo Babanco,1,1,2008-06-07,1,0,0,0
Hilaire Kédigui,2,2,2008-06-14,2,0,0,0
Bruno Ecuele Manga,4,4,2013-06-15,3,1,1,0
Abdessalam Benjelloun,1,1,2008-06-07,0,1,0,0
Dominique da Silva,1,1,2008-06-07,1,0,0,1
Choe Kum-chol,2,2,2008-09-06,1,1,0,0
Pepe,6,6,2022-12-06,3,3,0,0
Raul Meireles,5,5,2010-10-12,3,2,0,0
Kagiso Dikgacoi,2,1,2008-06-07,2,0,0,0
Surprise Moriri,1,1,2008-06-07,1,0,0,0
Thembinkosi Fanteni,1,1,2008-06-07,1,0,0,0
Juvenal Edjogo-Owono,6,5,2013-09-07,4,2,0,3
Václav Svěrkoš,3,2,2009-09-09,2,1,0,0
Eugene Ssepuuya,2,2,2008-06-14,1,1,0,0
Wilfried Urbain Elvis Endzanga,2,2,2008-09-07,2,0,0,0
Collen Salelwako,1,1,2008-06-08,1,0,0,0
Anas Al Khouja,1,1,2008-06-08,1,0,1,0
Sello Muso,1,1,2008-06-08,1,0,0,0
Lehlohonolo Seema,1,1,2008-06-08,1,0,0,0
André Bikey,1,1,2008-06-08,0,1,0,0
Gustave Bebbe,1,1,2008-06-08,0,1,0,0
Almiro Lobo,3,3,2011-11-11,2,1,0,1
Boitumelo Mafoko,1,1,2008-06-08,0,1,0,0
Ismael Alassane,1,1,2008-06-08,1,0,0,0
Yamba Asha,1,1,2008-06-08,0,1,0,0
Gilbert Mushangazhike,2,1,2008-06-08,2,0,0,0
Petter Hansson,1,1,2008-06-10,0,1,0,0
Cesc Fàbregas,6,6,2012-06-14,4,2,0,0
Semih Şentürk,6,6,2010-09-07,2,4,0,0
Arda Turan,11,11,2015-09-06,8,3,0,0
Roger Guerreiro,1,1,2008-06-12,0,1,0,0
Dieumerci Mbokani,15,12,2021-11-14,9,6,0,6
Faouzi Mubarak Aaish,4,4,2011-01-14,3,1,0,2
Armand Djerabe,1,1,2008-06-14,1,0,0,0
Zhou Haibin,1,1,2008-06-14,1,0,0,0
Roguy Méyé,4,4,2009-06-06,2,2,0,0
Tijan Jaiteh,2,2,2008-10-11,1,1,0,1
Konstantin Zyryanov,4,4,2009-06-10,1,3,0,0
Armando Alonso,3,3,2008-10-11,1,2,0,0
Victor Núñez,2,2,2008-10-15,1,1,0,0
Abner Trigueros,2,2,2008-06-21,1,1,0,0
McDonald Mariga,2,2,2009-06-20,2,0,0,1
Saif Mohammed Al Bishr,1,1,2008-06-14,0,1,0,0
Chiukepo Msowoya,6,5,2009-09-05,4,2,0,0
Rudolf Bester,4,3,2011-11-11,2,2,0,0
Hugo Rodallega,2,2,2009-10-14,0,2,0,0
Chris Megaloudis,1,1,2008-06-14,1,0,0,0
Don Annacoura,1,1,2008-06-14,1,0,0,0
Ala'a Eldin Yousif,1,1,2008-06-14,1,0,0,0
Muhannad El Tahir,2,2,2008-10-11,2,0,0,1
Gholamreza Rezaei,5,5,2011-11-15,2,3,0,0
Mohsen Khalili,1,1,2008-06-14,0,1,0,0
Marcus Tulio Tanaka,4,4,2009-06-17,1,3,1,0
Kengo Nakamura,3,3,2011-10-11,1,2,0,0
Guvanch Ovekov,1,1,2008-06-14,1,0,0,1
Timothy Batabaire,1,1,2008-06-14,1,0,0,0
Dan Wagalauka,1,1,2008-06-14,1,0,0,0
Diego Lugano,7,6,2013-06-20,4,3,0,0
Ronald Vargas,2,2,2009-09-09,1,1,0,0
Patricio Urrutia,1,1,2008-06-15,0,1,0,0
Rodrigo Palacio,2,2,2013-10-11,2,0,0,0
Carlos Vela,10,10,2018-06-23,5,5,0,1
Gary Medel,6,5,2015-06-29,3,3,1,0
Demar Phillips,6,5,2012-10-16,6,0,0,0
Omar Daley,2,2,2011-06-06,2,0,0,0
Cheikh Gueye,3,2,2008-09-05,1,2,1,0
Dioh Williams,1,1,2008-06-15,1,0,0,0
Guy Mamihasindrahona,1,1,2008-06-15,1,0,0,0
Eduardo Fernando Gomes,3,2,2008-06-22,2,1,0,1
Issey Nakajima-Farran,1,1,2008-06-15,0,1,0,0
Michael Bradley,12,11,2017-06-11,9,3,0,0
Daryl Ferguson,1,1,2008-06-15,1,0,1,0
Kerry Skepple,3,2,2011-11-11,3,0,0,0
Garfield Gonsalves,1,1,2008-06-17,0,1,1,0
Tyio Simon,1,1,2008-06-17,1,0,0,0
Leonel Duarte,1,1,2008-06-17,0,1,0,0
Ronald García Nacho,2,2,2008-10-11,2,0,0,0
Rubén de la Red,1,1,2008-06-18,0,1,0,0
Dani Güiza,4,3,2009-06-28,0,4,0,0
Gonzalo Jara,2,2,2008-09-10,1,1,0,0
Osama Al Fazzani,1,1,2008-06-20,1,0,0,0
Omar Daoud,1,1,2008-06-20,1,0,0,0
Hesham Shaban,1,1,2008-06-20,1,0,0,0
Charles Kaboré,2,2,2013-03-23,2,0,0,0
Mahamoudou Kéré,3,2,2009-03-28,3,0,0,0
Bertrand St. Ange,1,1,2008-06-21,0,1,0,0
Randall Azofeifa,2,2,2016-09-02,1,1,0,0
Trevor Lennen,1,1,2008-06-21,1,0,1,0
Nabil El Zhar,1,1,2008-06-21,1,0,0,0
Dmitri Torbinski,1,1,2008-06-21,0,1,0,0
Patrick Diaike,1,1,2008-06-21,1,0,0,0
Ibrahima Sonko,1,1,2008-06-21,1,0,0,0
Zah Rahan Krangar,1,1,2008-06-21,0,1,0,0
Henri Mbazumutima,2,2,2008-09-06,0,2,0,0
Sun Xiang,1,1,2008-06-22,0,1,0,0
Pascal Anicet,1,1,2008-06-22,1,0,1,0
Darryl Roberts,2,2,2011-09-06,0,2,0,0
Andy Sophie,2,2,2015-10-07,1,1,0,1
Marco Soares,2,2,2012-06-02,1,1,0,0
Franchel Ibara,1,1,2008-06-22,1,0,0,0
Roberto Linares,4,2,2008-09-10,3,1,0,0
Yénier Márquez,5,5,2015-06-14,4,1,0,0
Tsholola Tshinyama,1,1,2008-06-22,1,0,0,0
Moussa Hirir,1,1,2008-06-22,0,1,0,0
Luis Anaya,3,2,2011-09-06,1,2,0,0
Germaine van Dijk,1,1,2008-06-22,0,1,0,0
Nigel Codrington,1,1,2008-06-22,1,0,0,0
Didier Zokora,1,1,2008-06-22,1,0,0,0
Atsuto Uchida,2,2,2013-06-19,2,0,1,0
Baihakki Khaizan,1,1,2008-06-22,1,0,1,0
Ramez Dayoub,1,1,2008-06-22,0,1,1,0
Carlos Chimomole,1,1,2008-06-22,1,0,0,0
Elias Pelembe,1,1,2008-06-22,1,0,0,0
Abdoh Otaif,3,3,2009-04-01,2,1,0,1
Sanharib Malki,4,4,2016-03-24,1,3,0,0
Uğur Boral,1,1,2008-06-25,0,1,0,0
David Silva,20,16,2017-09-05,13,7,0,0
Fabrice Do Marcolino,3,2,2010-01-21,3,0,0,0
Keon Daniel,6,5,2013-07-08,2,4,0,0
Frantz Bertin,1,1,2008-08-20,1,0,0,0
Brunel Fucien,1,1,2008-08-20,1,0,0,0
Roman Uzdenov,1,1,2008-08-20,1,0,0,0
Atusaye Nyondo,1,1,2008-09-05,0,1,0,0
Marc Janko,20,16,2016-10-09,10,10,0,1
Sergei Zenjov,10,9,2022-11-19,6,4,0,0
Steven Defour,2,2,2013-09-06,1,1,0,0
Adrian Serioux,1,1,2008-09-06,1,0,0,0
Lito,1,1,2008-09-06,1,0,0,0
Somen Tchoyi,1,1,2008-09-06,0,1,0,0
Sebastián Eguren,3,3,2012-06-10,2,1,0,0
Froylán Ledezma,3,2,2009-07-23,3,0,0,0
Alejandro Alpízar,2,2,2008-09-10,1,1,0,0
Celso Borges,17,16,2022-03-24,10,7,0,1
Felipe Caicedo,17,15,2017-03-23,8,9,0,6
Rodolfo Zelaya,15,10,2017-07-13,12,3,0,3
César Larios,1,1,2008-09-06,1,0,0,0
Salesh Kumar,1,1,2008-09-06,1,0,0,0
Maciu Dunadamu,3,3,2012-06-06,1,2,0,0
Njogu Demba-Nyrén,2,1,2008-09-06,2,0,0,0
Ousman Jallow,1,1,2008-09-06,1,0,0,0
Glenn Whelan,2,2,2009-10-10,1,1,0,0
Levan Kenia,1,1,2008-09-06,1,0,0,0
Blaise Nkufo,5,5,2009-04-01,3,2,0,0
Jamal Mohamed,1,1,2008-09-06,1,0,0,1
Simon Rolfes,1,1,2008-09-06,0,1,0,0
Heiko Westermann,2,2,2010-09-07,1,1,0,0
Vasilis Torosidis,9,9,2017-10-10,5,4,1,0
Bobo Bola,1,1,2008-09-06,0,1,0,0
Shadrack Nsajigwa,1,1,2008-09-06,0,1,0,0
Nizar Khalfan,1,1,2008-09-06,0,1,0,0
Jerson Tegete,3,2,2008-10-11,1,2,0,0
Jonny Magallón,1,1,2008-09-06,1,0,0,0
Mirko Vučinić,9,9,2015-10-09,7,2,0,1
Stevan Jovetić,24,19,2023-11-16,15,9,0,3
Ben Sigmund,2,2,2012-10-12,0,2,0,0
Zlatko Dedić,4,4,2010-10-08,3,1,0,0
Majdi Siddiq,1,1,2008-09-06,1,0,0,0
Talal Al-Bloushi,1,1,2008-09-06,1,0,0,0
Mindaugas Kalonas,2,2,2009-10-14,1,1,0,1
Jón Rói Jacobsen,1,1,2008-09-06,1,0,1,0
Claude Nahimana,2,2,2008-10-12,1,1,0,0
Sheriff Suma,3,3,2013-06-08,3,0,0,0
Rodolfo Bodipo,1,1,2008-09-06,0,1,0,1
Marius Mbaiam,1,1,2008-09-06,0,1,0,0
Syriakata Hassan,1,1,2008-09-06,0,1,0,0
Carlos Eduardo Gallardo,3,3,2011-10-11,2,1,0,1
Sam Vokes,3,3,2016-09-05,3,0,0,0
Khaled Adénon,1,1,2008-09-07,1,0,0,0
Locó,1,1,2008-09-07,0,1,0,0
Stephan Rabemananjara,1,1,2008-09-07,1,0,0,0
Miro,1,1,2008-09-07,1,0,0,0
Alhassane Issoufou,2,1,2008-09-07,2,0,0,0
Kamilou Daouda,2,2,2013-09-07,2,0,0,0
Armend Dallku,1,1,2008-09-10,1,0,0,0
Dmitry Verkhovtsov,3,3,2013-06-11,2,1,0,0
Vitali Rodionov,3,3,2010-10-12,1,2,0,0
Vyacheslav Hleb,1,1,2008-09-10,0,1,0,0
Senijad Ibričić,3,3,2010-09-03,1,2,0,0
Ahmed Aadil,1,1,2008-09-10,0,1,0,0
Leger Djime,2,2,2008-10-11,1,1,0,0
Saif Eldin Ali Idris Farah,1,1,2008-09-10,0,1,0,0
Ismael Fuentes,1,1,2008-09-10,1,0,0,0
Theo Walcott,7,4,2015-10-09,1,6,0,0
Mario Mandžukić,23,18,2018-07-15,11,12,1,0
Răzvan Cociş,1,1,2008-09-10,0,1,0,0
Daniel Sjölund,1,1,2008-09-10,1,0,0,0
Jean Sony Alcénat,1,1,2008-09-10,1,0,0,0
Kirk Broadfoot,1,1,2008-09-10,0,1,0,0
Serhiy Nazarenko,5,3,2009-10-10,3,2,0,0
Igor Picușceac,1,1,2008-09-10,1,0,0,0
Klemi Saban,1,1,2008-09-10,0,1,0,0
Jeremy Christie,1,1,2008-09-10,1,0,0,0
Ki Sung-yueng,8,7,2017-06-13,2,6,1,2
John Heitinga,2,2,2011-09-02,1,1,0,0
Johan Fano,3,3,2009-10-14,3,0,0,0
Robert Lewandowski,63,40,2024-06-25,33,30,0,13
Marcos Senna,1,1,2008-09-10,1,0,0,0
Samuel Holmén,1,1,2008-09-10,1,0,0,0
Gergely Rudolf,7,6,2011-09-06,4,3,0,0
Ahmed Al-Fraidi,2,2,2011-11-11,1,1,0,0
Derek Malas,2,2,2012-06-03,2,0,0,0
Eugenio Fernando Bila,1,1,2008-10-11,0,1,0,0
Jean Makoun,5,4,2013-11-17,5,0,0,0
Zhambyl Kukeyev,1,1,2008-10-11,0,1,0,0
Siphiwe Tshabalala,3,3,2013-06-08,1,2,0,0
Juan Gutiérrez Moreno,1,1,2008-10-11,0,1,0,0
Bogi Løkin,1,1,2008-10-11,1,0,0,0
Walter Julián Martínez,4,4,2011-06-10,2,2,0,1
Andrew Hainault,1,1,2008-10-11,0,1,0,0
Hendry Thomas,1,1,2008-10-11,1,0,0,0
Roland Juhász,3,3,2012-09-07,2,1,0,0
Salim Tuama,1,1,2008-10-11,0,1,0,0
Sidi Yaya Keita,2,1,2008-10-11,2,0,0,0
Merouane Zemmama,1,1,2008-10-11,1,0,0,0
Dahmed Ould Teguedi,1,1,2008-10-11,0,1,0,0
Cuthbert Malajila,1,1,2008-10-11,0,1,0,0
Chidi Odiah,1,1,2008-10-11,1,0,0,0
Paweł Brożek,1,1,2008-10-11,1,0,0,0
Jakub Błaszczykowski,11,11,2018-10-11,5,6,0,3
Martin Fenin,1,1,2008-10-11,0,1,0,0
Yoann Gourcuff,4,4,2011-03-25,2,2,0,0
Kader Mangane,1,1,2008-10-11,1,0,0,0
Miloš Krasić,2,2,2008-10-15,1,1,0,0
Zlatan Ljubijankić,3,3,2010-06-18,3,0,0,0
Deniss Ivanovs,1,1,2008-10-11,0,1,0,0
Athuman Iddy,1,1,2008-10-11,1,0,0,0
José Filipe Correia Semedo,1,1,2008-10-11,0,1,0,0
Khalfan Ngassa,1,1,2008-10-11,1,0,0,0
Hichem Essifi,2,1,2008-10-11,2,0,0,0
Yassin Mikari,1,1,2008-10-11,1,0,0,0
Saber Ben Frej,1,1,2008-10-11,1,0,0,0
Fahid Ben Khalfallah,1,1,2008-10-11,1,0,0,0
Mevlüt Erdinç,3,3,2013-09-10,1,2,0,0
Jensy Muñoz,1,1,2008-10-11,0,1,0,0
Jozy Altidore,24,19,2019-06-26,20,4,0,2
David Edwards,2,2,2009-06-06,1,1,0,0
Moussa Mallam,1,1,2008-10-12,0,1,0,0
Kassaly Daouda,1,1,2008-10-12,1,0,1,0
Aristide Bancé,9,9,2017-02-01,6,3,0,1
Said Riyad,1,1,2008-10-12,1,0,1,0
Mamadou Bah,3,3,2012-01-28,2,1,0,0
Francis Ouma,1,1,2008-10-12,0,1,0,0
Kamil Zayatte,2,2,2009-03-28,1,1,0,0
Geofrey Massa,3,2,2015-11-15,3,0,0,0
Ivan Obradović,1,1,2008-10-15,0,1,0,0
Pavel Sitko,1,1,2008-10-15,1,0,0,0
Emir Spahić,5,4,2016-10-07,4,1,1,0
Vahagn Minasyan,1,1,2008-10-15,0,1,0,0
Vicente Matías Vuoso,3,2,2015-06-15,0,3,0,0
Fabián Orellana,2,2,2009-10-10,1,1,0,0
Júnior Díaz,1,1,2008-10-15,1,0,0,0
Marco Pappa,4,4,2012-06-12,3,1,0,0
Allianni Urgelles,1,1,2008-10-15,1,0,0,0
Derrik Garden,1,1,2008-10-15,1,0,1,0
Piotr Trochowski,1,1,2008-10-15,1,0,0,0
Jong Tae-Se,1,1,2008-10-15,0,1,0,0
Alberto Aquilani,3,2,2013-10-11,2,1,0,0
Petri Pasanen,1,1,2008-10-15,1,0,1,0
Veli Lampi,1,1,2008-10-15,1,0,1,0
Lee Keun-ho,9,7,2014-06-17,4,5,0,0
Ismail Al Hammadi,4,4,2016-03-24,3,1,0,0
Charlie Davies,4,4,2009-08-12,1,3,0,0
Isaac Mina,1,1,2008-10-15,0,1,0,0
Alejandro Moreno,1,1,2008-10-15,1,0,0,0
Freddy Fernández,1,1,2008-11-19,0,1,0,0
Roy Krishna,11,9,2024-06-30,8,3,0,5
Omar Cummings,2,2,2009-07-10,1,1,0,0
Tatsuya Tanaka,1,1,2008-11-19,0,1,0,0
Zdeněk Pospěch,1,1,2008-11-19,0,1,0,0
Tomáš Necid,6,6,2016-06-17,3,3,0,1
Leonel Saint-Preux,1,1,2008-11-19,0,1,0,0
Kenwyne Jones,11,10,2016-03-29,6,5,1,1
Abdulrahim Jumaa,1,1,2008-11-19,1,0,0,0
Kenny Cooper,3,3,2009-07-23,3,0,0,1
Freddy Adu,2,2,2009-07-04,2,0,0,0
Andy Furtado,2,1,2009-02-11,2,0,0,0
Osael Romero,11,8,2012-09-11,6,5,0,1
Mun In-Guk,2,2,2009-03-28,2,0,0,0
Gareth McAuley,11,10,2016-11-11,5,6,2,0
Chris Brunt,4,4,2017-10-08,3,1,1,0
Henrikh Mkhitaryan,20,19,2021-11-14,12,8,0,5
Konstantin Vassiljev,15,13,2022-06-09,7,8,0,2
Gevorg Ghazaryan,12,12,2020-11-15,7,5,0,0
Sanel Jahić,1,1,2009-03-28,0,1,0,0
Alain Traoré,8,7,2017-10-07,6,2,0,0
Macnelly Torres,3,3,2016-09-01,3,0,0,0
Wason Rentería,1,1,2009-03-28,1,0,0,0
Demetris Christofi,5,4,2017-08-31,3,2,0,1
Cristian Castillo,2,2,2009-09-05,1,1,0,0
Masoud Shojaei,4,4,2015-11-17,2,2,0,1
Naif Hazazi,5,5,2015-11-17,2,3,0,0
Osama Al-Muwallad,2,2,2011-07-23,1,1,0,0
Ammar Jemal,1,1,2009-03-28,0,1,0,0
Aleksandrs Cauņa,10,10,2015-10-10,6,4,0,3
Andrejs Perepļotkins,1,1,2009-03-28,0,1,0,0
Gelson Fernandes,2,2,2010-06-16,0,2,0,0
Giampaolo Pazzini,3,3,2011-09-06,2,1,0,0
Mounir El Hamdaoui,1,1,2009-03-28,1,0,0,0
Pak Nam-Chol,3,3,2011-11-15,3,0,0,0
Ireneusz Jeleń,2,2,2009-04-01,1,1,0,0
Jonny Evans,6,5,2023-09-07,5,1,1,0
Dorel Stoica,2,1,2009-03-28,1,1,1,0
Gerard Piqué,5,5,2016-06-13,4,1,1,0
Mudather El Tahir,4,3,2013-06-07,4,0,0,1
Khaleem Hyland,3,3,2021-06-08,2,1,0,0
Farhod Tadjiyev,3,1,2009-03-28,3,0,0,0
Christian Noboa,3,3,2016-06-12,3,0,0,0
Francis Kasonde,1,1,2009-03-29,0,1,0,0
Romaric,3,3,2010-06-25,1,2,0,0
Alexis Sánchez,30,24,2022-02-01,14,16,0,0
Miku,5,4,2015-06-21,3,2,0,0
Cristian Tănase,2,2,2013-09-06,1,1,0,0
Erwin Hoffer,3,2,2010-09-07,3,0,0,0
Álex da Rosa,1,1,2009-04-01,1,0,0,0
Didi Torrico,1,1,2009-04-01,1,0,0,0
Gill Swerts,1,1,2009-04-01,0,1,0,0
Felipe Melo,2,2,2009-06-18,1,1,0,0
Ivelin Popov,10,10,2019-06-10,6,4,0,0
Dimitar Makriev,1,1,2009-04-01,1,0,0,0
Erik Jendrišek,1,1,2009-04-01,0,1,0,0
Leon Andreasen,2,2,2013-09-06,1,1,0,0
Édgar Benítez,6,6,2016-11-10,2,4,1,0
John Terry,1,1,2009-04-01,1,0,0,0
Sander Puri,1,1,2009-04-01,1,0,0,0
Dimitris Salpingidis,10,10,2013-11-15,6,4,0,1
Tamás Hajnal,3,3,2013-09-10,2,1,0,0
Rinat Abdulin,2,2,2014-10-10,1,1,0,0
Alexander Hleb,1,1,2009-04-01,0,1,0,0
Ihar Stasevich,3,3,2019-03-24,1,2,0,0
Jurijs Žigajevs,1,1,2009-04-01,1,0,0,0
Rafał Boguski,2,1,2009-04-01,2,0,0,0
Ebi Smolarek,4,1,2009-04-01,4,0,0,0
Fares Juma,1,1,2009-04-01,1,0,1,0
Ross McCormack,1,1,2009-04-01,1,0,0,0
Steven Fletcher,10,6,2018-11-17,5,5,0,1
Kim Chi-Woo,2,2,2013-06-04,1,1,0,0
Ashley Williams,2,2,2016-07-01,1,1,1,0
Pablo Herrera Barrantes,2,2,2009-07-19,1,1,0,0
Daniel Díaz,1,1,2009-06-06,1,0,0,0
Gennadi Bliznyuk,2,1,2009-06-06,2,0,0,0
Ronald Rivero,1,1,2009-06-06,0,1,1,0
Oleksiy Gai,1,1,2009-06-06,0,1,0,0
Chrysis Michael,2,2,2009-10-14,1,1,0,1
Dejan Damjanović,7,6,2015-06-14,1,6,0,1
Julio Enrique Martínez,2,2,2009-10-10,1,1,0,0
Moise Brou,1,1,2009-06-06,1,0,0,0
Nigel de Jong,1,1,2009-06-06,0,1,0,0
Gareth Barry,1,1,2009-06-06,0,1,0,0
Nenad Milijaš,2,2,2009-09-09,2,0,0,2
Peter Pekarík,2,2,2015-03-27,2,0,0,0
Miroslav Stoch,3,3,2014-10-09,2,1,0,0
Ľuboš Hanzel,1,1,2009-06-06,1,0,0,0
Collin Samuel,1,1,2009-06-06,1,0,0,0
Wissem Ben Yahia,1,1,2009-06-06,1,0,0,1
Oussama Darragi,5,5,2013-06-16,2,3,0,2
Shinji Okazaki,22,17,2017-03-28,8,14,0,0
Rainford Kalaba,3,3,2012-01-21,1,2,0,0
Karim Matmour,2,2,2010-01-24,1,1,0,0
Abdelkader Ghezzal,2,2,2009-10-11,2,0,0,0
Kwadwo Asamoah,4,4,2013-09-06,2,2,0,0
Jefferson Montero,5,4,2015-11-17,3,2,0,0
David Carney,2,2,2011-01-25,1,1,0,0
Nilmar,5,3,2009-10-11,4,1,0,0
Jean Beausejour,3,3,2014-06-13,2,1,0,0
Marco Estrada,1,1,2009-06-10,1,0,0,0
Radamel Falcao,16,13,2020-10-13,12,4,0,4
Pablo Palacios,1,1,2009-06-10,1,0,0,0
Neven Subotić,1,1,2009-06-10,0,1,0,0
Ahmed Faris Al-Binali,1,1,2009-06-10,1,0,1,0
Ali Afif,1,1,2009-06-10,0,1,0,1
Hayden Tinto,1,1,2009-06-10,0,1,0,0
Óscar Rojas,1,1,2009-06-10,1,0,0,0
Filip Ivanovski,1,1,2009-06-10,1,0,0,0
Daniel Majstorović,1,1,2009-06-10,1,0,0,0
Marcus Berg,18,15,2020-10-11,13,5,0,0
Tanat Nusserbayev,1,1,2009-06-10,0,1,0,0
Giuseppe Rossi,3,2,2011-06-03,1,2,0,0
Bernard Parker,8,5,2013-09-07,6,2,1,1
Homos,1,1,2009-06-18,1,0,0,0
Jonathan Pitroipa,7,7,2015-11-17,6,1,0,1
Mamadou Tall,1,1,2009-06-20,0,1,1,0
Julius Owino,1,1,2009-06-20,1,0,0,0
Domingues,3,3,2013-06-09,1,2,0,1
Fernando Llorente,4,3,2010-10-12,2,2,0,0
Madjid Bougherra,3,3,2013-11-19,1,2,0,0
Andrea Dossena,1,1,2009-06-21,0,1,1,0
Modibo Maïga,3,3,2015-01-28,2,1,0,0
Lúcio,1,1,2009-06-28,0,1,0,0
Warren Granados,1,1,2009-07-03,1,0,0,0
Stuart Holden,3,3,2013-07-09,3,0,0,0
Robbie Rogers,1,1,2009-07-04,1,0,0,0
Luis Miguel Noriega,1,1,2009-07-05,0,1,0,1
Pablo Barrera,5,4,2011-06-25,2,3,0,0
Loïc Loval,1,1,2009-07-05,0,1,0,0
Nelson Barahona,3,3,2012-10-16,2,1,0,0
Fabrice Noël,1,1,2009-07-08,1,0,0,0
James Marcelin,4,4,2016-06-08,2,2,0,0
Santino Quaranta,1,1,2009-07-08,1,0,0,0
Stéphane Auvray,1,1,2009-07-09,1,0,0,0
Ludovic Gotin,1,1,2009-07-09,1,0,0,0
Miguel Sabah,5,4,2009-08-12,5,0,0,0
Patrice Bernier,1,1,2009-07-10,0,1,0,0
Marcel de Jong,1,1,2009-07-10,0,1,0,0
Roger Espinoza,1,1,2009-07-11,1,0,0,0
Melvin Valladares,2,2,2009-08-12,2,0,0,0
Davy Arnaud,1,1,2009-07-11,1,0,0,0
Vaniel Sirin,1,1,2009-07-11,0,1,0,0
Gabriel Enrique Gómez,4,4,2017-03-28,3,1,0,2
Kyle Beckerman,1,1,2009-07-18,1,0,0,0
Alexandre Alphonse,1,1,2009-07-19,1,0,0,0
Giovani dos Santos,9,8,2015-07-09,3,6,0,0
Clarence Goodson,4,3,2013-07-21,3,1,1,0
José Antonio Castro,1,1,2009-07-26,0,1,0,0
André-Pierre Gignac,4,3,2009-10-14,3,1,0,0
Israel Castro,1,1,2009-08-12,1,0,0,0
Erik Huseklepp,3,3,2011-03-26,3,0,0,0
Aleksandar Radosavljević,1,1,2009-08-12,1,0,0,0
Andraž Kirm,2,2,2013-06-07,1,1,0,0
Jesús Dátolo,1,1,2009-09-05,1,0,0,0
Stefan Maierhofer,1,1,2009-09-05,1,0,0,0
Andreas Lava Olsen,1,1,2009-09-05,0,1,0,0
Elvin Mammadov,2,2,2009-10-10,1,1,0,0
Valeri Domovchiyski,1,1,2009-09-05,1,0,0,0
Arturo Vidal,25,20,2020-11-17,15,10,1,6
Rodrigo Millar,2,2,2010-06-25,2,0,0,0
Jackson Martínez,5,4,2014-06-24,2,3,0,0
Teófilo Gutiérrez,9,8,2015-10-08,8,1,0,0
Marios Elia,1,1,2009-09-05,1,0,0,0
Liédson,3,3,2010-06-21,2,1,0,0
Julien Escudé,1,1,2009-09-05,0,1,1,0
Kakha Kaladze,2,1,2009-09-05,0,2,2,0
Kerry Baptiste,3,2,2009-10-14,2,1,0,1
Hernán Rengifo,2,2,2009-10-10,1,1,0,0
Scott Brown,1,1,2009-09-05,1,0,0,0
Stéphane Grichting,1,1,2009-09-05,1,0,0,0
Marco Padalino,1,1,2009-09-05,1,0,0,0
Vladimir Voskoboinikov,2,2,2012-06-03,1,1,0,0
Sercan Yıldırım,1,1,2009-09-05,1,0,0,0
Andriy Yarmolenko,28,25,2023-09-12,15,13,0,3
Artem Milevskyi,2,1,2009-09-05,2,0,0,1
Yevhen Seleznyov,7,6,2015-11-14,3,4,0,3
Mamadou Samassa,5,5,2013-06-16,2,3,0,1
Mohamed Aoudou,2,2,2009-10-11,2,0,0,0
Nabil Taïder,1,1,2009-09-06,0,1,0,0
Michael Eneramo,1,1,2009-09-06,1,0,0,0
Adel Taarabt,2,2,2009-10-10,0,2,0,0
Sergei Khizhnichenko,5,3,2016-09-04,3,2,0,0
Hovhannes Goharyan,1,1,2009-09-09,1,0,0,0
Gerardo Yecerotte,1,1,2009-09-09,1,0,0,0
Sejad Salihović,2,2,2011-09-02,1,1,0,1
Arnbjørn Hansen,3,3,2012-10-16,3,0,0,0
Aviram Baruchyan,1,1,2009-09-09,1,0,0,0
Eren Derdiyok,4,4,2016-11-13,3,1,0,0
Michele Polverino,3,3,2013-03-22,3,0,0,0
Ian Azzopardi,1,1,2009-09-09,0,1,1,0
Valeriu Andronic,1,1,2009-09-09,1,0,0,0
Boban Grnčarov,1,1,2009-09-09,0,1,0,0
Franz Schiemer,3,2,2010-10-12,0,3,0,0
Nasser Al-Shamrani,7,6,2016-10-06,5,2,0,0
Jaycee John Okwunwanne,2,2,2015-01-15,1,1,0,0
Eljero Elia,1,1,2009-09-09,0,1,0,0
Valter Birsa,6,6,2017-09-04,4,2,0,2
Santi Cazorla,4,3,2019-11-15,4,0,0,0
Juan Mata,9,9,2014-06-23,4,5,0,1
Andrés Scotti,1,1,2009-09-09,1,0,0,0
Juan Fuenmayor,1,1,2009-09-09,0,1,1,0
Igor Semshov,2,2,2011-09-02,1,1,0,0
Gonzalo Higuaín,23,16,2016-10-06,18,5,0,0
Maksim Bordachyov,2,2,2020-09-07,1,1,0,0
Leonid Kovel,1,1,2009-10-10,1,0,0,0
Waldo Ponce,2,2,2011-10-11,1,1,0,0
Giovanni Moreno,1,1,2009-10-10,1,0,0,0
Jorge Valdivia,2,2,2014-06-13,1,1,0,0
Julius James,1,1,2009-10-10,1,0,1,0
Jakob Poulsen,2,2,2015-06-13,2,0,0,0
Roni Porokara,2,2,2010-11-17,2,0,0,0
Niklas Moisander,1,1,2009-10-10,1,0,0,0
William Gallas,2,2,2009-11-18,2,0,0,0
Hicham Mahdoufi,1,1,2009-10-10,1,0,1,0
Éric Mouloungui,2,2,2012-02-05,2,0,0,0
Conor Casey,2,1,2009-10-10,0,2,0,0
David Ben Dayan,1,1,2009-10-10,1,0,0,0
Denis Calincov,1,1,2009-10-10,0,1,0,0
Vagif Javadov,5,5,2013-10-15,3,2,0,0
Benjamin Huggel,1,1,2009-10-10,0,1,0,0
Jacob Ngwira,1,1,2009-10-10,1,0,0,0
Radoslav Batak,1,1,2009-10-10,1,0,0,0
Vladimir Dvalishvili,2,2,2009-10-14,0,2,0,0
Andrija Delibašić,6,4,2012-11-14,4,2,0,0
Sean St Ledger,3,3,2012-06-10,2,1,0,0
Marko Pantelić,5,5,2011-09-02,2,3,0,0
Nejc Pečnik,4,4,2015-10-12,1,3,0,0
Patrick Mutesa Mafisango,1,1,2009-10-11,0,1,0,0
Nadir Belhadj,1,1,2009-10-11,1,0,0,0
Edgar Olivares,1,1,2009-10-11,1,0,0,0
Habib Bamogo,1,1,2009-10-11,0,1,0,0
Yaroslav Rakytskiy,2,2,2013-09-06,1,1,0,0
Álvaro Negredo,7,5,2013-10-15,4,3,0,0
Stanislav Angelov,1,1,2009-10-14,1,0,0,0
Avraam Papadopoulos,1,1,2009-10-14,0,1,1,0
Ognjen Vukojević,2,2,2011-09-02,0,2,0,0
Gheorghe Ovseannicov,1,1,2009-10-14,0,1,0,0
Kristaps Grebis,1,1,2009-10-14,1,0,0,0
Veaceslav Sofroni,1,1,2009-10-14,0,1,0,0
David Vaughan,1,1,2009-10-14,0,1,0,0
Aaron Ramsey,19,17,2023-09-11,8,11,0,6
Zoran Tošić,8,8,2015-10-11,6,2,0,0
Adrián Ramos,2,2,2011-07-02,1,1,0,0
Seweryn Gancarczyk,1,1,2009-10-14,0,1,1,0
Miguel Veloso,3,3,2015-09-07,2,1,0,0
Edinho,1,1,2009-10-14,1,0,0,0
Iulian Apostol,1,1,2009-10-14,1,0,0,0
Egil á Bø,1,1,2009-10-14,0,1,0,0
Ionuţ Mazilu,1,1,2009-10-14,1,0,0,0
Dalibor Stevanović,1,1,2009-10-14,0,1,0,0
Marko Šuler,2,2,2012-09-11,0,2,0,0
Hamdi Salihi,6,6,2013-10-11,4,2,0,1
Enrique Esqueda,1,1,2009-10-14,0,1,0,0
Jonathan Bornstein,1,1,2009-10-14,1,0,0,0
Mario Bolatti,1,1,2009-10-14,0,1,0,0
Gervinho,11,10,2016-10-08,8,3,0,0
Siaka Tiéné,2,2,2010-01-15,2,0,0,0
Allan Wanga,1,1,2009-11-14,1,0,0,0
Rory Fallon,4,4,2016-05-31,3,1,0,0
Hassan Korongo,1,1,2009-11-14,1,0,0,1
Djiman Koukou,1,1,2009-11-14,0,1,0,0
Floyd Ayité,1,1,2009-11-14,1,0,0,0
Lassana Fané,1,1,2009-11-15,0,1,0,0
Tenema Ndiaye,1,1,2009-11-15,0,1,0,0
Anthony Annan,1,1,2009-11-15,1,0,0,0
Mustapha Yatabaré,1,1,2010-01-10,0,1,0,0
Davi Banda,1,1,2010-01-11,1,0,0,0
Chinedu Obasi,1,1,2010-01-12,0,1,0,0
Gedo,5,5,2010-01-31,3,2,0,0
Dario Khan,2,2,2010-01-16,1,1,2,0
Carlos Fumo Gonçalves,1,1,2010-01-12,1,0,0,0
Zouheir Dhaouadi,1,1,2010-01-13,0,1,0,0
Rafik Halliche,2,2,2014-06-22,0,2,0,0
Mohammadou Idrissou,1,1,2010-01-17,1,0,0,0
André Ayew,16,16,2022-11-24,8,8,0,4
Ahmed Elmohamady,3,3,2019-06-30,3,0,0,0
Amine Chermiti,1,1,2010-01-21,0,1,0,0
Aurélien Chedjou,2,2,2013-09-08,1,1,1,0
Landry N'Guémo,1,1,2010-01-21,1,0,0,0
Hameur Bouazza,1,1,2010-01-24,0,1,0,0
Mohamed Abdel-Shafy,1,1,2010-01-28,0,1,0,0
Lee Jung-soo,2,2,2010-06-22,1,1,0,0
Thomas Müller,35,24,2022-06-14,21,14,0,2
Cacau,1,1,2010-06-13,1,0,0,0
Antolín Alcaraz,2,2,2011-07-13,1,1,0,0
Keisuke Honda,21,19,2018-06-24,12,9,0,7
Ji Yun-nam,1,1,2010-06-15,0,1,0,0
Winston Reid,1,1,2010-06-15,1,0,0,0
Álvaro Pereira,5,5,2016-06-05,4,1,1,0
Lee Chung-yong,4,4,2016-09-01,2,2,0,0
Javier Hernández,24,19,2018-06-23,10,14,0,2
Kalu Uche,2,2,2010-06-22,1,1,0,0
Brett Holman,6,6,2013-03-26,3,3,0,0
Artūras Rimkevičius,1,1,2010-06-20,1,0,0,0
Enrique Vera,1,1,2010-06-20,0,1,0,0
Martín Demichelis,1,1,2010-06-22,0,1,0,0
Bongani Khumalo,1,1,2010-06-22,1,0,0,0
Mesut Özil,18,16,2017-09-04,12,6,0,4
Kamil Kopúnek,1,1,2010-06-24,1,0,0,0
Kevin-Prince Boateng,2,2,2013-11-19,0,2,0,0
Matthew Upson,1,1,2010-06-27,0,1,0,0
Maxi Pereira,3,3,2013-11-13,2,1,0,0
Edinson Cavani,30,26,2022-02-01,20,10,0,3
Sami Khedira,6,6,2016-11-11,3,3,0,0
Jóan Símun Edmundsson,6,6,2022-09-25,3,3,0,0
Kaimar Saag,2,2,2011-09-06,2,0,0,0
Keith Fahey,1,1,2010-09-03,0,1,0,0
Adam Johnson,2,2,2010-09-07,1,1,0,0
Leonardo Bonucci,5,5,2021-07-11,0,5,0,1
Syarhey Kislyak,1,1,2010-09-03,0,1,0,0
Nikos Spyropoulos,3,3,2012-09-07,1,2,1,0
Brede Hangeland,3,3,2012-10-16,0,3,0,0
Mohammed Abdellaoue,2,2,2011-09-02,1,1,0,1
Miralem Pjanić,13,12,2022-06-14,9,4,0,3
Alexandru Suvorov,5,5,2013-03-26,2,3,0,0
Anatolie Doroș,2,2,2010-10-12,1,1,0,1
Danny,2,2,2011-09-02,1,1,0,0
Andreas Avraam,2,2,2011-10-07,1,1,0,0
Bogdan Stancu,9,8,2017-06-10,2,7,0,3
Gjergji Muzaka,1,1,2010-09-03,0,1,0,0
Corry Evans,2,2,2018-11-18,1,1,0,0
Pontus Wernbloom,2,1,2010-09-03,2,0,0,0
Elsad Zverotić,4,4,2012-11-14,2,2,0,0
Darvydas Šernas,4,4,2013-03-22,1,3,0,1
Holger Badstuber,1,1,2010-09-07,1,0,0,0
Vladimir Koman,5,5,2012-10-16,3,2,0,0
Yura Movsisyan,13,9,2018-11-16,4,9,0,0
Mario Gjurovski,1,1,2010-09-07,1,0,0,0
Cristian Martínez,4,3,2019-11-14,1,3,0,0
Davide Simoncini,2,2,2016-10-11,2,0,2,0
Aldo Junior Simoncini,1,1,2010-09-07,1,0,1,0
Andreas Granqvist,8,7,2018-11-17,4,4,0,6
Xherdan Shaqiri,25,19,2024-06-19,15,10,0,1
Darren Bent,3,3,2011-10-07,0,3,0,0
Vanče Šikov,2,2,2011-10-07,0,2,0,0
Vladimír Weiss,6,6,2022-06-10,1,5,0,0
Sebastian Prödl,2,2,2013-10-15,1,1,0,0
Marko Arnautović,28,21,2024-06-21,14,14,0,6
Roman Hubník,1,1,2010-10-08,1,0,0,0
Ádám Szalai,23,19,2022-09-23,13,10,0,2
Balázs Dzsudzsák,10,9,2017-08-31,7,3,0,3
Marvin Ogunjimi,5,4,2011-10-07,3,2,0,0
Alan Dzagoev,8,6,2015-09-08,4,4,0,0
Roman Shirokov,5,5,2013-10-15,3,2,0,2
Shane Long,5,5,2016-10-09,3,2,0,0
Tarmo Kink,3,3,2013-09-10,1,2,0,0
Aleksandar Luković,1,1,2010-10-08,0,1,1,0
Tim Matavž,8,5,2019-11-19,6,2,0,0
Christian Mouritsen,1,1,2010-10-08,0,1,0,0
Loïc Rémy,2,2,2011-10-07,2,0,0,0
Itay Shechter,2,2,2013-09-07,2,0,0,0
Marcos Pizzelli,8,8,2018-10-16,5,3,0,0
Sergey Krivets,1,1,2010-10-12,1,0,0,0
Jelle Vossen,2,2,2011-03-29,2,0,0,0
Nicolas Lombaerts,1,1,2010-10-12,1,0,0,0
Martin Harnik,9,8,2017-03-24,2,7,0,0
Morten Rasmussen,3,2,2013-10-15,3,0,0,0
Kasper Lorentzen,1,1,2010-10-12,1,0,0,0
Andrei Sidorenkov,1,1,2010-10-12,0,1,1,0
Christian Holst,2,2,2014-09-07,2,0,0,0
Václav Kadlec,3,3,2017-10-08,1,2,0,0
Ibrahim Afellay,4,3,2014-10-10,3,1,0,0
Steven Naismith,8,8,2019-11-19,6,2,0,0
Valentin Stocker,4,3,2016-10-07,3,1,0,0
Gökhan Inler,4,4,2015-10-09,3,1,0,3
Nikola Kalinić,7,7,2017-11-09,6,1,0,0
Kasper Hämäläinen,5,3,2012-10-12,5,0,0,0
Zhang Linpeng,3,3,2019-11-14,2,1,1,0
Deng Zhuoxiang,3,2,2011-07-28,0,3,0,0
Maya Yoshida,9,9,2022-03-29,8,1,0,0
Abdelrazaq Al Hussain,4,3,2016-03-24,1,3,0,0
Koo Ja-cheol,12,11,2016-11-15,8,4,0,1
Iman Mobali,1,1,2011-01-11,0,1,0,0
Yusef Ahmed,5,4,2012-06-08,4,1,0,0
Baha' Abdel-Rahman,3,3,2019-01-20,3,0,0,0
Makoto Hasebe,1,1,2011-01-13,0,1,0,0
Mile Jedinak,18,15,2018-06-21,11,7,1,11
Gouramangi Singh,2,2,2011-07-28,1,1,0,0
Karim Ansarifard,15,11,2024-01-14,11,4,0,2
Walid Abbas,3,3,2011-11-15,1,2,3,0
Yu Hai,5,5,2016-09-01,2,3,0,0
Hao Junmin,7,5,2016-09-01,5,2,0,1
Mohamed El-Sayed,2,2,2011-09-06,2,0,0,0
Ali Diab,1,1,2011-01-17,1,0,1,0
Odai Al-Saify,1,1,2011-01-17,1,0,0,0
Ryoichi Maeda,7,6,2012-09-11,4,3,0,0
Ji Dong-won,7,4,2016-10-06,5,2,0,0
Son Heung-min,25,20,2024-02-02,17,8,0,5
Arash Afshin,1,1,2011-01-19,0,1,0,0
Mohammad Nouri,1,1,2011-01-19,0,1,0,0
Shinji Kagawa,15,11,2018-06-19,8,7,0,1
Masahiko Inoha,1,1,2011-01-21,0,1,0,0
Bashar Bani Yaseen,2,2,2011-10-11,0,2,0,0
Yoon Bit-garam,1,1,2011-01-22,0,1,0,0
Hajime Hosogai,1,1,2011-01-25,1,0,0,0
Hwang Jae-won,1,1,2011-01-25,0,1,0,0
Saša Ognenovski,1,1,2011-01-25,0,1,0,0
Carl Valeri,1,1,2011-01-25,0,1,0,0
Robbie Kruse,4,4,2017-10-05,2,2,0,0
Tadanari Lee,1,1,2011-01-29,0,1,0,0
Axel Witsel,8,7,2022-06-08,4,4,0,0
Philippe Mexès,1,1,2011-03-25,0,1,0,0
Thiago Motta,1,1,2011-03-25,0,1,0,0
Biram Kayal,1,1,2011-03-26,1,0,0,0
Aiden McGeady,4,3,2014-09-07,1,3,0,0
Ivan Trichkovski,4,4,2020-11-15,2,2,0,0
Jan Vertonghen,8,8,2024-07-01,4,4,1,0
Ruslan Abishov,3,3,2013-06-07,2,1,0,0
Nacer Chadli,7,7,2020-11-18,4,3,1,0
Tal Ben Haim,6,6,2016-10-06,2,4,0,1
Tadas Kijanskas,2,2,2013-09-10,1,1,1,0
Lars Krogh Gerson,3,3,2015-10-12,2,1,0,1
Ianis Zicu,1,1,2011-03-29,1,0,0,0
Mikael Lustig,5,5,2017-10-07,2,3,0,0
Sebastian Larsson,6,5,2021-03-28,2,4,0,4
Gökhan Gönül,1,1,2011-03-29,1,0,0,0
Eric Abidal,1,1,2011-06-03,1,0,1,0
Burak Yılmaz,22,19,2022-03-24,12,10,0,4
Jaba Kankava,7,7,2019-10-15,1,6,0,0
Rógvi Baldvinsson,4,4,2019-10-15,2,2,1,0
Sergey Gridin,2,1,2011-06-03,2,0,0,0
Philippe Erne,1,1,2011-06-03,1,0,0,0
Ola Toivonen,7,7,2018-06-23,5,2,0,0
Alexander Gerndt,1,1,2011-06-03,0,1,0,0
Ashley Young,4,4,2013-03-22,2,2,0,0
Ioannis Fetfatzidis,2,1,2011-06-04,2,0,0,0
Kyriakos Papadopoulos,2,2,2011-09-06,1,1,0,0
Lasse Schøne,1,1,2011-06-04,0,1,0,0
Christian Eriksen,27,20,2024-06-16,14,13,0,10
Radomir Đalović,1,1,2011-06-04,1,0,0,0
Marco Ureña,9,7,2017-09-05,3,6,0,0
Heiner Mora,1,1,2011-06-05,1,0,0,0
Joel Campbell,14,13,2023-07-04,8,6,0,1
Efraín Juárez,1,1,2011-06-05,1,0,0,0
Aldo de Nigris,5,5,2013-06-04,2,3,0,0
Ryan Johnson,3,3,2012-06-08,2,1,0,0
Murad Hüseynov,1,1,2011-06-07,1,0,0,0
André Schürrle,15,9,2017-03-26,4,11,0,0
Anton Putsila,2,2,2012-09-11,1,1,0,0
Haris Medunjanin,8,7,2017-10-07,4,4,0,0
Darko Maletić,1,1,2011-06-07,1,0,0,0
Brice Jovial,2,1,2011-06-07,0,2,0,0
Zoltán Lipták,1,1,2011-06-07,0,1,0,0
Emir Bajrami,1,1,2011-06-07,1,0,0,0
Clive Murray,3,3,2011-10-15,2,1,0,0
Jerry Bengtson,14,11,2023-07-02,9,5,0,0
Alfredo Mejía,1,1,2011-06-10,0,1,0,0
Léster Blanco,4,3,2011-11-11,1,3,0,0
Arturo Álvarez,2,2,2015-06-16,2,0,0,0
José Javier del Aguila,1,1,2011-06-13,1,0,0,0
Jaylee Hodgson,3,2,2011-07-17,2,1,0,0
Elroy Kuylen,3,3,2015-06-14,1,2,0,0
Dennis Marshall,1,1,2011-06-18,1,0,0,0
Jermaine Jones,3,3,2016-06-07,3,0,0,0
Murad Alyan,3,2,2011-07-28,2,1,0,0
Ismail Al-Amour,1,1,2011-06-29,0,1,0,0
Jahid Hasan Ameli,3,3,2015-06-16,3,0,0,0
Mohamed Zahid Hossain,1,1,2011-06-29,1,0,0,0
Rezaul Karim,1,1,2011-06-29,1,0,0,0
Manolom Phomsouvanh,2,1,2011-06-29,0,2,0,0
Khoun Laboravy,3,3,2015-11-17,2,1,1,0
Kouch Sokumpheak,3,3,2019-06-06,2,1,0,0
Mohd Safiq Rahim,2,2,2011-07-03,1,1,0,0
Aidil Zafuan,1,1,2011-06-29,1,0,0,0
Chen Po-liang,2,2,2011-07-03,1,1,0,1
Khürelbaataryn Tsend-Ayuush,1,1,2011-06-29,1,0,0,0
Anil Gurung,2,2,2011-07-02,2,0,0,2
José João Pereira,1,1,2011-06-29,0,1,0,0
Ju Manu Rai,2,2,2011-07-02,2,0,0,0
Chathura Gunaratne,1,1,2011-06-29,1,0,0,0
Nate Burkey,1,1,2011-06-29,0,1,0,0
Phạm Thành Lương,1,1,2011-06-29,1,0,0,0
Nguyễn Ngọc Thanh,1,1,2011-06-29,1,0,0,0
Nguyễn Văn Quyết,1,1,2011-06-29,1,0,0,0
Edivaldo Hermoza,1,1,2011-07-01,0,1,0,0
Bhola Silwal,1,1,2011-07-02,1,0,0,0
Jagajeet Shrestha,1,1,2011-07-02,1,0,0,0
Sujal Shrestha,1,1,2011-07-02,1,0,0,0
Cameron Hepple,1,1,2011-07-02,0,1,0,1
Jackner Louis,1,1,2011-07-02,0,1,0,0
Lamnao Singto,2,1,2011-07-03,2,0,0,0
Khampheng Sayavutthi,4,3,2015-10-13,3,1,0,1
Chhin Chhoeun,1,1,2011-07-03,0,1,0,0
Souliya Syphasay,1,1,2011-07-03,1,0,0,0
Kanlaya Sysomvang,1,1,2011-07-03,1,0,0,1
Nguyễn Quang Hải,7,7,2024-01-24,4,3,0,0
Leong Ka Hang,2,2,2015-03-17,2,0,0,1
Pai Soe,1,1,2011-07-03,1,0,0,0
Mai Aih Naing,1,1,2011-07-03,1,0,0,0
Houssam Wadi,1,1,2011-07-03,1,0,0,0
Balal Arezou,1,1,2011-07-03,0,1,0,0
Emelio Caligdong,1,1,2011-07-03,1,0,0,0
Phil Younghusband,2,1,2011-07-03,2,0,0,1
Ángel Guirado,4,4,2021-06-15,3,1,0,0
Mohd Aidil Zafuan Abdul Radzak,1,1,2011-07-03,0,1,0,0
Chang Han,1,1,2011-07-03,1,0,0,0
Xavier Chen,1,1,2011-07-03,1,0,0,1
Alderman Lesmond,1,1,2011-07-03,1,0,0,0
Reid Klopp,2,2,2011-07-10,1,1,0,0
Néstor Araujo,3,3,2017-06-24,1,2,0,0
Esteban Paredes,4,3,2017-03-28,4,0,0,0
Josué Martínez,1,1,2011-07-07,0,1,0,0
Erik Santos de Gouveia,1,1,2011-07-08,1,0,0,0
Kevin Edward,1,1,2011-07-08,0,1,0,0
Cliff Magnam Valcin,3,3,2011-10-11,1,2,0,0
Frederick Gomez,2,2,2011-07-12,1,1,0,0
David Abdul,1,1,2011-07-08,1,0,0,0
Domingo Peralta,3,3,2021-03-27,1,2,0,0
Jonathan Faña,3,3,2011-10-11,2,1,0,0
Jádson,1,1,2011-07-09,1,0,0,0
César Eduardo González,2,2,2013-09-10,2,0,0,1
Dwayne Thomas,1,1,2011-07-10,0,1,0,0
Trevor Peters,1,1,2011-07-10,1,0,0,0
Inoel Navarro,3,2,2011-11-11,3,0,0,0
Jhoan Sánchez,1,1,2011-07-10,1,0,0,0
Ángel Di María,17,16,2022-12-18,10,7,0,0
André Carrillo,9,8,2021-06-27,3,6,1,0
Jamil Joseph,3,1,2011-07-12,3,0,0,0
Kurt Frederick,2,2,2015-06-14,1,1,0,1
Rensy Barradas,1,1,2011-07-12,0,1,0,0
Alexandre Pato,2,1,2011-07-13,2,0,0,0
Neymar,31,26,2022-12-09,24,7,0,8
Salomón Rondón,17,14,2024-07-05,8,9,0,1
Lucas Barrios,5,5,2015-11-17,2,3,0,0
Grenddy Perozo,1,1,2011-07-13,0,1,0,0
Diego Pérez,2,2,2013-06-23,1,1,0,0
Carlos Lobatón,1,1,2011-07-16,0,1,0,0
Daniel Jimenez,1,1,2011-07-17,1,0,0,0
Luis Mendez,1,1,2011-07-17,1,0,0,0
Oswaldo Vizcarrondo,2,2,2011-11-15,1,1,0,0
Gabriel Cichero,1,1,2011-07-17,0,1,0,0
Soukaphone Vongchiengkham,1,1,2011-07-23,0,1,0,0
Yang Xu,17,7,2019-10-10,12,5,0,2
Chen Tao,2,1,2011-07-23,2,0,0,0
Saeid Daghighi,1,1,2011-07-23,1,0,0,0
Alaa Abdul-Zahra,3,3,2012-10-16,2,1,0,0
Amer Deeb,5,4,2012-09-11,5,0,0,0
Ahmad Hayel,7,6,2013-06-18,6,1,0,0
Abdallah Deeb,7,6,2016-03-29,2,5,0,2
Yousef Nasser,14,9,2021-06-15,9,5,0,0
Fahad Al Ansari,2,2,2019-11-14,2,0,0,0
Hassan Maatouk,9,8,2019-10-15,6,3,0,3
Ali Al Saadi,3,3,2012-06-08,3,0,0,0
Tarek El Ali,1,1,2011-07-23,1,0,0,0
William Chiroque,1,1,2011-07-23,1,0,0,0
Mohammed Kasola,4,4,2015-10-13,3,1,0,0
Safee Sali,3,2,2011-07-28,1,2,0,0
Qiu Li,1,1,2011-07-23,1,0,0,0
Abdul Hadi Yahya,1,1,2011-07-23,0,1,0,0
Jakkaphan Kaewprom,1,1,2011-07-23,1,0,0,0
Wýaçeslaw Krendelew,1,1,2011-07-23,1,0,0,0
Muhammad Ilham,1,1,2011-07-23,0,1,0,0
Hamdan Al-Kamali,2,2,2011-10-11,2,0,1,1
Mithun Chowdhury,1,1,2011-07-28,1,0,0,0
Hassan Fallatah,1,1,2011-07-28,0,1,0,0
Mohammad Al-Sahlawi,19,10,2017-06-08,8,11,0,5
Ali Al-Wehaibi,2,2,2012-02-29,1,1,0,0
Jeje Lalpekhlua,3,3,2019-01-06,1,2,0,0
Cristian Gonzáles,4,2,2011-10-11,4,0,0,0
Mohammad Nasuha,1,1,2011-07-28,1,0,0,0
Arslanmyrat Amanow,7,7,2019-11-14,2,5,0,0
Muhammad Ridwan,1,1,2011-07-28,1,0,0,0
Berdi Şamyradow,1,1,2011-07-28,0,1,0,0
Gahrymanberdi Çoňkaýew,1,1,2011-07-28,0,1,0,0
Bahodir Nasimov,4,2,2013-06-18,2,2,0,0
Yu Hanchao,4,2,2015-11-12,2,2,0,0
Mohammad Reza Khalatbari,3,3,2013-06-11,1,2,0,0
Saeed Murjan,2,2,2013-09-10,0,2,0,0
Bharat Khawas,1,1,2011-07-28,1,0,0,0
Stephan Schröck,4,4,2019-09-10,2,2,0,0
Nguyễn Trọng Hoàng,1,1,2011-07-28,1,0,0,0
Aaron Hughes,1,1,2011-08-10,1,0,0,0
Paddy McCourt,2,1,2011-08-10,2,0,0,0
Yann M'Vila,1,1,2011-09-02,0,1,0,0
Rihairo Meulens,1,1,2011-09-02,0,1,0,0
Marc Joseph,1,1,2011-09-02,1,0,0,0
Quinton Griffith,4,3,2021-03-27,1,3,0,1
Tamarley Thomas,6,4,2011-11-15,4,2,0,0
Peter Byers,11,6,2021-03-27,5,6,0,1
Alex Brosque,3,2,2012-02-29,3,0,0,0
Rauf Aliyev,3,3,2012-11-14,2,1,0,0
Gary Cahill,2,2,2016-11-11,1,1,0,0
Josh Simpson,3,2,2011-11-15,3,0,0,0
Tremain Paul,2,2,2015-06-10,0,2,0,0
Will Johnson,3,3,2015-09-08,2,1,0,0
Raúl Leguías,5,4,2015-06-16,1,4,0,0
Félix Rodríguez,1,1,2011-09-02,0,1,0,0
Christian Javier Bautista,2,2,2011-09-06,1,1,0,0
Johan Cruz,1,1,2011-09-02,0,1,0,0
Igor Armaș,4,4,2022-03-29,2,2,1,0
Mario Götze,10,9,2015-09-04,8,2,0,0
Yony Flores,1,1,2011-09-02,1,0,0,0
Shawn Beveney,1,1,2011-09-02,1,0,0,0
Charles Pollard,2,2,2012-10-12,1,1,1,0
Jean-Eudes Maurice,8,5,2015-09-04,2,6,0,2
Listner Pierre-Louis,1,1,2011-09-02,1,0,0,0
Jean Monuma,1,1,2011-09-02,1,0,0,0
Jean Alexandre,2,1,2011-09-02,2,0,0,0
Sotiris Ninis,2,2,2012-09-11,1,1,0,0
Gabriel Torje,5,4,2013-10-11,1,4,0,1
Milan Badelj,2,2,2018-06-26,0,2,0,0
Dejan Lovren,5,5,2022-09-25,0,5,0,0
Georginio Wijnaldum,24,19,2023-06-18,15,9,0,0
Ats Purje,2,2,2014-09-08,1,1,0,0
Friso Mando,2,2,2011-09-06,1,1,0,2
Ulan Konysbayev,1,1,2011-09-02,0,1,0,0
Ahmed Khalil,23,14,2019-01-21,17,6,0,5
Steve Morison,1,1,2011-09-02,1,0,0,0
Mahir Shukurov,2,2,2013-10-11,2,0,0,1
Vitali Yevstigneyev,1,1,2011-09-06,0,1,0,0
Minor López,3,3,2015-11-17,1,2,0,0
Mark Ebanks,4,4,2021-06-08,3,1,0,1
Xavier García,1,1,2011-09-06,0,1,0,0
Tomer Hemed,14,10,2018-10-14,7,7,0,2
Orin de Waard,1,1,2011-09-06,1,0,0,0
Kevin Lafrance,2,2,2016-09-06,0,2,0,0
Wilde-Donald Guerrier,3,3,2019-06-29,2,1,0,0
Erick Ozuna,5,4,2011-11-11,3,2,0,0
Martin Vunk,1,1,2011-09-06,1,0,0,0
Kevin Strootman,2,2,2013-10-11,1,1,0,0
Luuk de Jong,5,5,2021-03-30,2,3,0,0
Vurlon Mills,2,1,2011-09-06,2,0,0,0
Kolbeinn Sigþórsson,13,13,2019-10-14,8,5,0,0
Sayed Dhiya Saeed,6,4,2021-06-15,4,2,0,0
Hussain Fadhel,2,2,2015-01-09,1,1,0,0
Mahmoud Khamees,2,2,2021-06-15,1,1,0,0
Akram Moghrabi,1,1,2011-09-06,1,0,0,0
Gilles Bettmer,1,1,2011-09-06,1,0,0,0
Aurélien Joachim,8,7,2018-09-11,3,5,0,1
Román Torres,6,6,2017-10-10,6,0,1,0
Mirko Ivanovski,1,1,2011-09-06,1,0,0,0
Simeon Jackson,4,2,2011-10-07,0,4,0,0
Tosaint Ricketts,7,5,2015-09-04,6,1,0,0
Hadi Aghily,2,2,2011-10-11,1,1,0,0
Jevon Francis,1,1,2011-09-06,0,1,0,0
Devaughn Elliott,1,1,2011-09-06,0,1,0,0
Zaine Pierre,1,1,2011-09-06,1,0,0,0
Martin Olsson,3,3,2013-10-11,1,2,0,0
Tobias Hysén,3,2,2013-10-15,2,1,0,0
Luke Wilkshire,2,2,2012-06-12,1,1,0,2
Artur Sarkisov,3,3,2012-09-07,1,2,0,0
Ivan Ivanov,2,2,2013-03-22,1,1,0,0
Sompong Soleb,1,1,2011-09-06,1,0,0,0
Rashid Juma Al-Farsi,1,1,2011-09-06,1,0,1,0
Ranjae Christian,1,1,2011-09-06,0,1,0,0
Justin Cochrane,1,1,2011-09-06,0,1,0,0
Jamie Browne,2,2,2015-03-22,1,1,0,0
Randolph Burton,4,2,2011-10-11,2,2,0,0
Myron Samuel,4,4,2016-03-25,2,2,0,1
Cornelius Stewart,3,3,2015-06-10,2,1,0,0
Cassim Langaigne,1,1,2011-09-18,0,1,0,0
Zlatko Junuzović,5,5,2015-09-05,3,2,0,0
Anthony Abrams,1,1,2011-10-07,0,1,0,0
Chris Nurse,2,2,2012-09-11,1,1,0,0
Eden Hazard,25,21,2021-09-05,16,9,0,7
Vincent Kompany,3,3,2012-10-16,2,1,0,0
Kairat Nurdauletov,3,3,2013-09-06,2,1,0,2
Marcus Julien,1,1,2011-10-07,0,1,0,0
Lancaster Joseph,1,1,2011-10-07,0,1,0,0
Ryan Simpson,1,1,2011-10-07,1,0,0,0
Antwan Russell,1,1,2011-10-07,1,0,0,0
Nahki Wells,7,6,2019-06-24,5,2,0,2
Kevin Molino,6,6,2019-06-26,3,3,0,0
Giovanni Drenthe,1,1,2011-10-07,0,1,0,0
Lars Jacobsen,1,1,2011-10-07,0,1,0,0
Michael Krohn-Dehli,4,4,2012-06-17,2,2,0,0
Amir Waithe,2,1,2011-10-07,0,2,0,0
Ricardo Buitrago,2,2,2011-11-15,1,1,0,0
Jaime Ayoví,2,2,2016-06-12,2,0,0,0
Joona Toivio,2,2,2013-10-15,2,0,1,0
Anthony Réveillère,1,1,2011-10-07,1,0,0,0
Artiom Rudņev,1,1,2011-10-07,1,0,0,0
Hallgrímur Jónasson,2,1,2011-10-07,0,2,0,0
João Moutinho,4,4,2016-10-10,2,2,0,0
Eliseu,1,1,2011-10-07,1,0,0,0
Gylfi Sigurðsson,24,19,2023-10-16,14,10,0,7
Andrés Cabrero,2,2,2011-11-11,2,0,0,0
Stanislaw Drahun,10,8,2019-10-13,4,6,0,0
Olivier Occéan,4,3,2012-06-08,1,3,0,0
Claudio Marchisio,2,2,2014-06-14,0,2,0,0
Hakan Balta,1,1,2011-10-07,1,0,0,0
Kim Jaggy,1,1,2011-10-07,0,1,0,0
Kervens Belfort,5,4,2015-09-08,3,2,0,1
Réginal Goreux,1,1,2011-10-07,0,1,0,0
Rudy Cardozo,2,2,2015-11-12,1,1,0,0
Craig Mackail-Smith,1,1,2011-10-08,0,1,0,0
Srdjan Luchin,1,1,2011-10-11,0,1,0,0
Jamie Thomas,1,1,2011-10-11,1,0,0,0
Keiran Murtagh,1,1,2011-10-11,1,0,0,0
Ricky Shakes,3,3,2015-06-10,1,2,0,0
Dorlan Pabón,2,2,2011-11-15,1,1,0,0
Wálter Flores,1,1,2011-10-11,1,0,0,0
Eduardo Vargas,26,19,2021-06-21,13,13,0,0
Víctor Turcios,1,1,2011-10-11,1,0,0,0
Steve Purdy,1,1,2011-10-11,1,0,0,0
Jaime Alas,2,2,2012-09-11,1,1,0,0
Herbert Sosa,1,1,2011-10-11,1,0,0,1
David Targamadze,1,1,2011-10-11,1,0,0,0
Georgios Fotakis,1,1,2011-10-11,0,1,0,0
Sendley Sidney Bito,2,2,2011-11-11,0,2,0,0
Abdulaziz Al Sulaiti,1,1,2011-10-11,0,1,0,0
Mohammed Razak,2,2,2011-11-11,1,1,0,0
Mojtaba Jabbari,3,3,2011-11-15,1,2,0,0
Mike Havenaar,2,1,2011-10-11,2,0,0,0
Yūichi Komano,1,1,2011-10-11,1,0,0,0
Mahmoud Baquir Younes,1,1,2011-10-11,0,1,1,0
Jan Rezek,3,2,2012-10-12,1,2,0,0
Lior Refaelov,3,3,2017-03-24,0,3,0,0
Rami Gershon,2,2,2013-03-22,1,1,0,0
Denis Zmeu,1,1,2011-10-11,1,0,0,0
Simone Bacciocchi,1,1,2011-10-11,1,0,1,0
Gheorghe Andronic,1,1,2011-10-11,1,0,0,0
Juraj Piroska,1,1,2011-10-11,0,1,0,0
Tom Høgli,2,2,2013-06-07,1,1,0,0
Daniel Reyes,1,1,2011-10-11,0,1,0,0
Richard Ortiz,3,3,2017-08-31,2,1,0,0
Valeri Aleksanyan,1,1,2011-10-11,1,0,1,0
Denis Glushakov,4,4,2016-06-15,3,1,0,0
David Goodwillie,1,1,2011-10-11,0,1,0,1
Naldo Kwasie,1,1,2011-10-11,1,0,0,0
Stephan Lichtsteiner,6,5,2017-10-07,6,0,0,0
Lester Peltier,4,2,2011-11-15,4,0,0,0
Hughton Hector,1,1,2011-10-11,1,0,0,0
Fernando Amorebieta,1,1,2011-10-11,1,0,0,0
Ezequiel Lavezzi,6,5,2016-06-21,5,1,0,0
Mahmood Al-Ajmi,1,1,2011-11-11,1,0,0,0
Diquan Adamson,1,1,2011-11-11,0,1,0,0
Mrisho Ngassa,1,1,2011-11-11,0,1,0,0
Mahamat Labbo,2,2,2011-11-15,1,1,0,0
Nurdin Bakari,1,1,2011-11-11,0,1,0,0
Fredy Guarín,1,1,2011-11-11,1,0,0,0
Frank Feltscher,1,1,2011-11-11,0,1,0,0
Václav Pilař,5,5,2015-03-28,3,2,0,0
Tomáš Sivok,2,2,2014-10-10,1,1,0,0
Lazarus Kaimbi,3,2,2011-11-15,2,1,0,0
Sydney Urikhob,2,2,2011-11-15,1,1,0,0
Kerbi Rodríguez,1,1,2011-11-11,1,0,0,0
Jack Michael Morillo,1,1,2011-11-11,1,0,0,0
Iban Iyanga,3,3,2012-06-02,2,1,0,0
Tesfalem Tekle,1,1,2011-11-11,1,0,0,0
Elias Uzamukunda,1,1,2011-11-11,0,1,0,0
Keith Andrews,1,1,2011-11-11,0,1,0,0
Jonathan Walters,10,8,2017-06-11,7,3,0,3
Sidumo Shongwe,2,2,2011-11-15,1,1,0,0
Gladys Bokese,1,1,2011-11-11,0,1,0,0
Ángelo Padilla,1,1,2011-11-11,1,0,0,0
Serge Gakpé,2,2,2013-01-30,1,1,0,0
Basile de Carvalho,1,1,2011-11-11,1,0,0,0
Leon Cort,1,1,2011-11-11,1,0,0,0
Lehlomela Ramabele,1,1,2011-11-11,1,0,0,0
Darío Verón,1,1,2011-11-11,1,0,0,0
Joao Rojas,1,1,2011-11-11,0,1,0,0
Cristian Arrieta,1,1,2011-11-11,1,0,0,0
Héctor Ramos,4,2,2011-11-14,4,0,0,0
Pascal Ochieng,1,1,2011-11-11,0,1,0,0
Edwin Sánchez,1,1,2011-11-11,0,1,0,0
Evani Esperance,1,1,2011-11-11,1,0,0,0
Matt Moussilou,1,1,2011-11-11,0,1,0,0
Ladislas Douniama,1,1,2011-11-11,0,1,0,0
Chris Malonga,2,2,2012-06-09,1,1,0,0
Prince Oniangué,2,2,2015-01-21,0,2,0,0
Harris Tchilimbou,1,1,2011-11-11,0,1,0,0
Yasuyuki Konno,2,2,2017-03-23,0,2,0,0
Vedran Ćorluka,3,3,2015-09-06,1,2,1,0
Sheridan Grosvenor,1,1,2011-11-14,0,1,0,0
César García Peralta,1,1,2011-11-14,0,1,0,0
Joseph Marrero,1,1,2011-11-14,1,0,0,0
Thapelo Tale,1,1,2011-11-15,0,1,0,0
Bokang Mothoana,1,1,2011-11-15,0,1,0,0
Cédric Amissi,4,3,2019-09-04,4,0,0,0
Pablo Contreras,1,1,2011-11-15,1,0,0,0
Matías Campos,1,1,2011-11-15,1,0,0,0
Orlando Gando,1,1,2011-11-15,0,1,0,0
Francis N'Ganga,2,2,2015-11-17,2,0,0,0
Shanon Carmelia,2,1,2011-11-15,2,0,0,0
Keithroy Cornelius,1,1,2011-11-15,0,1,0,0
Everon Espacia,1,1,2011-11-15,1,0,0,0
Angelo Cijntje,1,1,2011-11-15,1,0,0,0
Yves Diba Ilunga,1,1,2011-11-15,1,0,0,0
Rafael Burgos,3,2,2012-09-11,2,1,0,0
Nicko Williams,1,1,2011-11-15,0,1,1,0
Fredy Thompson,1,1,2011-11-15,0,1,0,0
Lyndon Joseph,1,1,2011-11-15,0,1,1,0
Judelin Aveska,1,1,2011-11-15,1,0,0,0
Milad Meydavoudi,1,1,2011-11-15,0,1,0,0
Brian Onyango,1,1,2011-11-15,1,0,0,0
Victor Wanyama,1,1,2011-11-15,1,0,0,0
Fahad Al Enezi,1,1,2011-11-15,1,0,0,0
Abbas Ahmed Atwi,2,2,2015-10-08,1,1,0,1
Viera Ellong,1,1,2011-11-15,0,1,0,0
Yvan Rajoarimanana,1,1,2011-11-15,1,0,0,0
Falimery Ramanamahefa,2,2,2015-10-13,2,0,0,0
Petr Jiráček,3,3,2012-06-16,0,3,0,0
Jerry Sitoe,1,1,2011-11-15,1,0,0,0
Francisco Massinga,1,1,2011-11-15,1,0,0,0
Mohamed Youssouf,1,1,2011-11-15,0,1,0,0
Clésio Baúque,1,1,2011-11-15,1,0,0,0
Heinrich Isaacks,1,1,2011-11-15,1,0,0,0
Rolando Blackburn,8,7,2022-03-24,4,4,0,0
Stephen Ward,1,1,2011-11-15,1,0,0,0
Jean-Claude Iranzi,1,1,2011-11-15,1,0,0,0
Abraham Tedros,1,1,2011-11-15,0,1,0,0
Zheng Zheng,2,1,2011-11-15,0,2,0,0
Jonas Mendes,1,1,2011-11-15,1,0,1,0
Sanzhar Tursunov,3,3,2012-10-16,2,1,0,0
Oumed Oukri,1,1,2011-11-16,1,0,0,0
Shimelis Bekele,3,2,2015-11-14,3,0,0,0
Getaneh Kebede,10,9,2022-01-17,8,2,1,1
Ramin Ott,2,2,2015-09-02,1,1,0,0
Shalom Luani,2,2,2011-11-24,2,0,0,0
Unaloto Feao,1,1,2011-11-22,0,1,0,0
Luki Gosche,2,1,2011-11-22,2,0,0,0
Campbell Best,2,1,2011-11-22,0,2,0,0
Albert Bell,1,1,2011-11-22,1,0,0,0
Tala Luvu,1,1,2011-11-24,0,1,1,0
Shaun Easthope,1,1,2011-11-24,1,0,0,1
Silao Malo,2,2,2012-06-01,2,0,0,0
Timote Maamaaloa,1,1,2011-11-26,1,0,0,0
Grover Harmon,1,1,2011-11-26,0,1,0,0
Kinitoni Falatau,1,1,2011-11-26,1,0,0,0
Javier Balboa,4,3,2015-01-31,4,0,0,2
Emmanuel Mayuka,4,4,2015-01-22,2,2,0,0
Dame N'Doye,2,2,2012-06-02,2,0,0,0
Mateus Galiano da Costa,1,1,2012-01-22,0,1,0,0
Khaled Korbi,1,1,2012-01-23,0,1,0,0
Youssef Msakni,10,8,2022-01-23,2,8,0,1
John Mensah,2,2,2012-02-05,2,0,0,0
Bakaye Traoré,1,1,2012-01-24,1,0,0,0
Moussa Sow,6,6,2017-01-23,4,2,0,1
Kily Álvarez,1,1,2012-01-25,1,0,0,0
Bakary Koné,1,1,2012-01-26,1,0,1,0
Mohamed Ahmed Bashir,2,1,2012-01-26,2,0,0,0
William N'Gounou,1,1,2012-01-27,1,0,0,0
Sadio Diallo,4,2,2013-06-09,2,2,0,1
Abdoul Camara,3,3,2012-06-10,1,2,0,1
Ibrahima Traoré,4,4,2015-01-24,1,3,0,0
Naby Soumah,1,1,2012-01-28,0,1,0,0
Ihaab Boussefi,2,1,2012-01-29,2,0,0,0
Deme N'Diaye,1,1,2012-01-29,0,1,0,0
Emmanuel Eboué,1,1,2012-01-30,1,0,0,0
Wilfried Bony,10,9,2017-01-20,6,4,0,1
Issiaka Ouédraogo,1,1,2012-01-30,0,1,0,0
Younès Belhanda,2,2,2013-06-15,1,1,0,0
Mogakolodi Ngele,4,3,2015-10-13,4,0,0,0
Garra Dembélé,1,1,2012-02-01,0,1,0,0
Emmanuel Agyemang-Badu,3,3,2013-03-24,3,0,0,0
Stophira Sunzu,1,1,2012-02-04,1,0,0,0
Cheick Diabaté,5,4,2015-11-17,2,3,0,1
Saber Khelifa,2,2,2012-06-09,0,2,0,0
Salem Al-Dawsari,13,13,2022-11-30,8,5,0,3
Mohammed Tayeb Al Alawi,2,1,2012-02-29,2,0,0,0
Basem Fathi,1,1,2012-02-29,0,1,0,0
Yu Dabao,10,7,2019-01-11,7,3,0,0
Ashkan Dejagah,6,5,2019-01-20,6,0,0,3
Isa Halim,1,1,2012-02-29,0,1,0,0
Mustafa Karim,1,1,2012-02-29,1,0,0,0
Aleksandr Shadrin,1,1,2012-02-29,0,1,0,0
Hussain Al-Hadhri,1,1,2012-02-29,1,0,0,0
Abdul Aziz Al-Muqbali,7,5,2019-10-10,6,1,0,0
Jang Song-Hyok,1,1,2012-02-29,0,1,0,1
Akhtam Khamrakulov,1,1,2012-02-29,1,0,0,0
Mahmoud Fathalla,1,1,2012-06-01,1,0,0,0
Njazi Kuqi,2,1,2012-06-01,0,2,0,0
Dominic Adiyiah,2,1,2012-06-01,2,0,0,0
Jordan Ayew,9,7,2024-01-22,4,5,0,3
Christian Atsu Twasam,2,2,2013-01-28,1,1,0,0
Jerry Akaminko,1,1,2012-06-01,1,0,0,0
Edgars Gauračs,4,3,2012-10-16,3,1,0,0
Vitālijs Smirnovs,1,1,2012-06-01,1,0,0,0
Lorenzo Tehau,5,2,2012-06-03,1,4,0,0
Jonathan Tehau,6,4,2013-06-17,2,4,1,0
Alvin Tehau,7,6,2022-03-24,3,4,0,0
Teaonui Tehau,10,8,2024-06-30,7,3,0,0
Steevy Chong Hue,3,3,2016-05-29,2,1,0,0
Bertrand Kaï,6,4,2016-06-05,0,6,0,0
Robert Tasso,3,3,2012-06-05,2,1,0,0
Georges Gope-Fenepej,8,5,2012-10-16,1,7,0,0
Roy Kayara,6,5,2016-06-01,4,2,0,0
Sofiane Feghouli,9,9,2021-11-16,4,5,0,2
Hillal Soudani,6,5,2016-10-09,5,1,0,0
Islam Slimani,23,15,2022-03-25,12,11,0,2
Charles Aránguiz,6,5,2016-06-22,2,4,0,0
Eric Maxim Choupo-Moting,6,5,2022-11-28,4,2,0,1
Foxi Kéthévoama,2,1,2012-06-02,2,0,0,0
Tommy Smith,2,2,2013-03-22,1,1,0,0
Abdou Jammeh,2,2,2015-10-09,2,0,0,0
Francis Doe,1,1,2012-06-02,0,1,0,0
Ibrahima Baldé,1,1,2012-06-02,1,0,0,0
Sadio Mané,17,16,2024-01-19,8,9,0,4
Mohamed Kamara,1,1,2012-06-02,1,0,0,0
Benjamin Totori,5,4,2017-06-09,5,0,0,0
Chadi Hammami,2,1,2012-06-02,2,0,0,0
Djalma Campos,2,2,2019-06-24,1,1,0,0
Emmanuel Okwi,5,5,2019-06-26,3,2,0,0
Toni Kolehmainen,1,1,2012-06-03,1,0,0,0
James Rodríguez,20,19,2024-07-06,9,11,0,5
Saladin Said,4,3,2013-09-07,2,2,0,0
Nicolas Vallar,3,3,2013-06-17,2,1,1,2
Bako,1,1,2012-06-03,0,1,0,0
Jacques Haeko,7,3,2012-10-12,5,2,0,0
Roihau Degage,1,1,2012-06-03,1,0,0,0
Dick Kauma,1,1,2012-06-03,0,1,0,0
Kalen Damessi,1,1,2012-06-03,1,0,0,0
Ahmed Zuway,2,2,2012-06-10,1,1,0,0
Brian Kaltak,3,3,2024-06-21,1,2,1,1
Freddy Vava,1,1,2012-06-03,1,0,0,0
Chris Wood,21,14,2022-03-30,10,11,0,2
Niel Hans,1,1,2012-06-04,1,0,0,1
Kabeu,1,1,2012-06-05,1,0,0,0
Judikael Ixoée,1,1,2012-06-05,1,0,0,1
Kalaje Gnipate,1,1,2012-06-05,1,0,0,0
Kema Jack,1,1,2012-06-06,1,0,0,0
Isidro Gutiérrez,2,2,2012-09-07,1,1,0,0
Yuzo Kurihara,2,2,2012-06-12,1,1,0,0
Jasur Khasanov,1,1,2012-06-08,0,1,0,0
J. P. Rodrigues,1,1,2012-06-08,1,0,1,0
Héctor Moreno,5,5,2021-10-13,0,5,1,0
Kim Shin-wook,7,3,2021-06-09,6,1,0,1
Herculez Gomez,2,2,2012-09-11,2,0,0,0
Alcides Peña,1,1,2012-06-09,1,0,0,0
Pablo Daniel Escobar,4,2,2016-10-11,4,0,0,0
Morgan Gould,1,1,2012-06-09,0,1,0,0
Ofentse Nato,2,2,2013-06-15,2,0,0,0
Odaïr Fortes,1,1,2012-06-09,1,0,0,0
Samuel Barlay,1,1,2012-06-09,0,1,0,0
Teteh Bangura,1,1,2012-06-09,0,1,0,0
Rémy Ebanega,1,1,2012-06-09,1,0,0,0
Azubuike Egwuekwe,1,1,2012-06-09,0,1,0,0
John Banda,2,2,2015-10-11,2,0,0,0
Kolo Touré,1,1,2012-06-09,0,1,0,0
Hamza Abourazzouk,1,1,2012-06-09,1,0,0,0
Henrico Botes,1,1,2012-06-09,1,0,0,0
Papiss Cissé,5,4,2013-10-12,0,5,0,1
Godfrey Walusimbi,1,1,2012-06-09,1,0,0,1
Alhassane Bangoura,1,1,2012-06-10,1,0,0,0
Mohamed Salah,20,17,2024-01-14,10,10,0,4
Hamed Snousi,1,1,2012-06-10,1,0,0,0
Mahamadou N'Diaye,2,2,2013-06-09,2,0,0,0
Nikica Jelavić,2,2,2012-09-07,1,1,0,0
Himson Teleda,2,2,2012-09-07,2,0,0,0
Momodou Ceesay,1,1,2012-06-10,0,1,0,0
Shomari Kapombe,1,1,2012-06-10,1,0,0,0
Erasto Nyoni,2,2,2021-09-07,2,0,0,2
Diego Godín,7,7,2017-10-10,2,5,2,0
Joleon Lescott,1,1,2012-06-11,0,1,0,0
Jesús Zavala,2,2,2012-09-07,0,2,0,0
Mohammed Al Balushi,1,1,2012-06-12,0,1,0,0
Kim Bo-Kyung,2,1,2012-06-12,2,0,0,0
Silvestre Varela,4,4,2014-06-22,2,2,0,0
Andy Carroll,1,1,2012-06-15,0,1,0,0
Glen Johnson,1,1,2012-06-15,1,0,1,0
Danny Welbeck,12,8,2017-09-01,8,4,0,0
Jérémy Ménez,1,1,2012-06-15,0,1,0,0
Yohan Cabaye,1,1,2012-06-15,0,1,0,0
Lars Bender,1,1,2012-06-17,0,1,0,0
Jesús Navas,3,3,2019-11-15,1,2,0,0
Mario Balotelli,11,9,2014-06-14,5,6,0,3
Seb Larsson,1,1,2012-06-19,1,0,0,0
Marco Reus,13,10,2021-11-11,8,5,0,0
Jordi Alba,7,6,2022-09-24,3,4,0,0
Armando Sadiku,7,6,2019-03-25,2,5,0,0
Vincent Laban,3,3,2017-08-31,1,2,0,0
Edgar Çani,2,2,2012-10-12,2,0,0,0
Jonathan Fabbro,2,2,2013-09-06,1,1,0,1
Bibras Natcho,3,3,2021-03-31,0,3,0,0
Stanislav Manolev,4,4,2017-08-31,3,1,0,0
Dani Osvaldo,4,3,2013-10-11,0,4,0,0
Georgi Milanov,1,1,2012-09-07,1,0,0,0
Juan Camilo Zúñiga,1,1,2012-09-07,1,0,0,0
Víctor Bernárdez,1,1,2012-09-07,0,1,0,0
Marvin Chávez,2,2,2013-07-08,0,2,0,0
Trayon Bobb,2,1,2012-09-07,0,2,0,0
Abou Diaby,1,1,2012-09-07,0,1,0,0
Tornike Okriashvili,10,10,2021-10-12,6,4,0,4
Alfreð Finnbogason,10,10,2023-10-16,8,2,0,2
Rodolph Austin,3,3,2015-07-11,3,0,0,1
Mathias Christen,1,1,2012-09-07,1,0,0,0
Marius Žaliūkas,1,1,2012-09-07,1,0,0,0
Daniel da Mota,3,3,2017-08-31,2,1,0,0
James Milner,1,1,2012-09-07,0,1,0,0
Leighton Baines,1,1,2012-09-07,0,1,0,0
Nikola Drinčić,1,1,2012-09-07,1,0,0,0
Adrian Mierzejewski,2,2,2013-09-10,0,2,0,0
Luciano Narsingh,2,2,2015-06-12,1,1,0,0
Viktor Fayzulin,3,3,2013-10-11,1,2,0,0
Granit Xhaka,11,11,2023-09-12,6,5,0,0
Ivan Perišić,25,24,2022-12-05,12,13,0,0
Guillaume Gillet,1,1,2012-09-11,1,0,0,0
Yevhen Konoplyanka,10,9,2019-06-07,5,5,0,1
Étienne Capoue,1,1,2012-09-11,1,0,0,0
Christophe Jallet,1,1,2012-09-11,1,0,0,0
Roberto Soldado,2,2,2013-06-16,1,1,0,0
Konstantinos Mitroglou,9,8,2017-10-10,5,4,0,0
Gregory Richardson,1,1,2012-09-11,1,0,0,0
Jeremain Lens,5,4,2013-10-11,2,3,0,0
Bruno Martins Indi,2,2,2012-10-16,0,2,0,0
Aleksandr Kokorin,8,7,2015-10-12,4,4,0,2
Mattia Destro,1,1,2012-09-11,1,0,0,0
Federico Peluso,1,1,2012-09-11,1,0,0,0
Kosta Barbarouses,6,5,2024-06-27,5,1,0,0
Tony Lochhead,1,1,2012-09-11,1,0,0,0
Marco Rojas,4,3,2017-03-25,3,1,0,0
Dean Shiels,1,1,2012-09-11,1,0,0,0
Markus Henriksen,4,3,2017-10-05,2,2,1,0
Carlos Zambrano,2,2,2013-09-10,1,1,0,0
Jakub Wawrzyniak,1,1,2012-09-11,1,0,0,0
Costin Lazăr,2,2,2013-10-11,1,1,0,0
Valerică Găman,1,1,2012-09-11,1,0,0,0
Alexandru Maxim,6,6,2020-10-08,2,4,0,1
Luka Đorđević,1,1,2012-09-11,0,1,0,0
Fatos Bećiraj,13,11,2021-11-16,6,7,0,2
Aleksandar Kolarov,8,8,2018-06-17,3,5,0,1
Filip Đuričić,3,2,2013-03-26,3,0,0,0
Dušan Tadić,13,13,2023-10-17,8,5,0,6
Miralem Sulejmani,1,1,2012-09-11,1,0,0,0
Rasmus Elm,2,2,2012-10-16,1,1,0,0
Xavier Samin,1,1,2012-09-11,0,1,1,0
Umut Bulut,6,4,2014-10-10,5,1,0,0
Selçuk İnan,5,5,2015-10-13,3,2,0,1
Artyom Filiposyan,1,1,2012-09-11,0,1,1,0
Birkir Bjarnason,12,11,2021-03-31,3,9,0,0
Dexter Blackstock,1,1,2012-10-12,1,0,0,0
Pedro,7,5,2014-11-15,3,4,0,0
Alejandro Chumacero,2,2,2016-03-24,2,0,0,0
Dimitar Rangelov,3,3,2016-09-06,3,0,0,0
David Edgar,2,2,2016-09-06,2,0,0,0
Theodor Gebre Selassie,3,3,2017-06-10,1,2,0,0
Roderick Briffa,1,1,2012-10-12,0,1,0,0
Tomáš Pekhart,2,2,2013-10-11,1,1,0,0
Juan Carlos Paredes,1,1,2012-10-12,0,1,1,0
Segundo Castillo,3,3,2013-06-11,2,1,0,0
José Miguel Cubero,1,1,2012-10-12,0,1,0,0
Alex Oxlade-Chamberlain,5,5,2019-11-14,2,3,0,0
Alexander Kačaniklić,2,2,2013-10-15,1,1,0,0
Guram Kashia,2,2,2022-06-02,1,1,0,0
Carlos Figueroa,1,1,2012-10-12,1,0,0,0
Oribe Peralta,18,13,2017-10-10,11,7,0,0
Ángel Reyna,1,1,2012-10-12,0,1,0,0
Maharan Radi,1,1,2012-10-12,0,1,0,0
Eden Ben Basat,6,6,2013-10-15,3,3,0,0
Maor Melikson,1,1,2012-10-12,0,1,0,0
Ruben Schaken,2,2,2013-03-22,2,0,0,0
Agim Ibraimi,3,3,2014-09-08,2,1,0,2
Toni Kroos,12,9,2019-11-16,7,5,0,2
Andy Keogh,1,1,2012-10-12,1,0,0,0
Christian Benteke,11,8,2021-11-13,7,4,0,0
Kevin De Bruyne,22,20,2024-06-22,15,7,0,1
Tutizama Tanito,1,1,2012-10-12,1,0,0,0
Joses Nawo,1,1,2012-10-12,1,0,0,0
Tome Faisi,1,1,2012-10-12,0,1,1,0
Mario Gavranović,8,7,2021-10-12,2,6,0,0
Gheorghe Grozav,1,1,2012-10-12,0,1,0,0
James Morrison,1,1,2012-10-12,0,1,0,0
Odise Roshi,4,4,2019-09-10,3,1,0,0
David Alaba,11,11,2019-11-16,6,5,0,5
Renan Bardini Bressan,1,1,2012-10-16,1,0,0,0
Carlos Saucedo,3,1,2012-10-16,3,0,0,0
Gualberto Mojica,1,1,2012-10-16,1,0,0,0
Felipe Gutiérrez,2,2,2016-03-24,2,0,0,0
Cristian Gamboa,3,3,2017-09-05,2,1,1,0
Alberto Gómez,1,1,2012-10-16,1,0,0,0
Tarik Elyounoussi,4,4,2019-06-07,3,1,0,1
Joshua King,14,12,2019-11-18,6,8,0,5
Marc Wilson,1,1,2012-10-16,0,1,0,0
Pól Jóhannus Justinussen,1,1,2012-10-16,0,1,1,0
Darren O'Dea,1,1,2012-10-16,0,1,0,0
Mario Martínez,3,2,2016-09-02,3,0,0,0
Riccardo Montolivo,1,1,2012-10-16,1,0,0,0
William Kvist,1,1,2012-10-16,0,1,0,0
Nyron Nosworthy,1,1,2012-10-16,1,0,0,0
Dane Richards,2,1,2012-10-16,2,0,0,0
Vladimirs Kamešs,3,3,2020-11-14,2,1,0,0
Iamel Kabeu,1,1,2012-10-16,1,0,0,0
César Lolohea,4,3,2013-03-26,3,1,0,0
Michael McGlinchey,4,3,2017-09-01,3,1,0,0
Juma Darwish Al-Mashri,1,1,2012-10-16,1,0,0,0
Pablo César Aguilar,1,1,2012-10-16,1,0,0,0
Niall McGinn,5,5,2020-10-08,1,4,0,0
Olivier Giroud,28,23,2023-11-18,19,9,0,3
Kamil Glik,7,7,2020-09-07,3,4,2,0
Hammadi Ahmed,1,1,2012-11-14,1,0,0,0
Hiroshi Kiyotake,3,3,2016-11-15,2,1,0,1
Emmanuel Emenike,7,6,2013-10-13,2,5,0,1
Adane Girma,1,1,2013-01-21,0,1,0,0
Jonathan Ayité,1,1,2013-01-22,0,1,0,0
Platini,1,1,2013-01-23,0,1,0,0
Youssef El-Arabi,5,5,2015-11-12,3,2,0,0
Siyabonga Sangweni,2,2,2013-01-27,2,0,0,0
Lehlohonolo Majoro,1,1,2013-01-23,1,0,0,0
Mubarak Wakaso,8,7,2021-09-03,6,2,0,3
Djakaridja Koné,2,2,2013-10-12,2,0,0,0
Kennedy Mweene,1,1,2013-01-25,1,0,0,1
Dové Womé,2,2,2013-03-23,0,2,0,0
Didier Ya Konan,1,1,2013-01-26,1,0,0,0
Nando Maria Neves,1,1,2013-01-27,0,1,1,0
Fernando Varela,1,1,2013-01-27,1,0,0,0
Héldon Ramos,5,4,2015-11-17,4,1,0,1
Issam El Adoua,1,1,2013-01-27,0,1,0,0
May Mahlangu,1,1,2013-01-27,1,0,0,0
Abdelilah Hafidi,1,1,2013-01-27,0,1,0,0
John Boye,4,4,2015-01-27,1,3,1,0
Victor Moses,8,6,2018-06-26,6,2,0,5
Khaled Mouelhi,1,1,2013-01-30,0,1,0,1
Tokelo Rantie,3,3,2017-09-01,1,2,0,0
Cheick Tioté,1,1,2013-02-03,1,0,0,0
Sunday Mba,2,2,2013-02-10,1,1,0,0
Juan Carlos García,1,1,2013-02-06,1,0,0,0
Uwa Elderson Echiéjilé,2,2,2013-06-17,0,2,0,0
Brown Ideye,1,1,2013-02-06,0,1,0,0
Ahmed Musa,7,5,2021-11-13,4,3,0,1
Cheick Fantamady Diarra,1,1,2013-02-06,1,0,0,0
Luis Henríquez,2,2,2013-03-22,1,1,0,0
Sigamary Diarra,1,1,2013-02-09,1,0,0,0
Philipp Hosiner,2,1,2013-03-22,2,0,0,0
György Garics,1,1,2013-03-22,1,0,0,0
Aleksandar Tonev,4,2,2016-09-06,4,0,0,0
Emil Gargorov,2,2,2013-09-10,1,1,0,0
Carlos Valdés,1,1,2013-03-22,1,0,0,0
Pablo Armero,2,2,2014-06-14,2,0,0,0
Andreas Cornelius,6,5,2022-06-03,3,3,0,0
Simon Kjær,5,5,2021-10-09,2,3,1,1
Niki Zimling,1,1,2013-03-22,0,1,0,0
Mathieu Valbuena,2,2,2014-06-20,1,1,0,0
Alexander Kobakhidze,1,1,2013-03-22,0,1,0,0
Alexandru Chipciu,4,4,2019-06-10,0,4,0,0
Fábio Coentrão,2,2,2015-03-29,1,1,0,0
Marvin Elliott,1,1,2013-03-22,1,0,0,0
Łukasz Piszczek,3,3,2017-03-26,2,1,0,0
Roman Zozulya,2,2,2013-11-15,1,1,0,0
Alessandro Della Valle,3,3,2014-10-09,2,1,2,0
Daniel Sturridge,6,6,2016-11-11,5,1,0,1
Grant Hanley,2,2,2021-03-25,2,0,0,0
Hal Robson-Kanu,5,5,2017-09-05,3,2,0,0
Teemu Pukki,31,26,2024-03-21,17,14,0,5
Heimano Bourebare,1,1,2013-03-22,1,0,0,0
Samuel Hyanine,1,1,2013-03-22,1,0,0,0
Préjuce Nakoulma,9,7,2017-11-14,6,3,0,0
Christopher Samba,1,1,2013-03-23,1,0,0,0
Gabadinho Mhango,4,3,2022-01-25,2,2,0,0
Francis Kahata,1,1,2013-03-23,0,1,0,0
Nnamdi Oduamadi,4,2,2013-06-17,1,3,0,0
Amaro,1,1,2013-03-23,0,1,0,0
Thabo Matlaba,1,1,2013-03-23,1,0,0,0
Wahbi Khazri,13,12,2022-11-30,7,6,0,4
Alhassan Kamara,2,2,2013-09-07,1,1,0,0
Abdul Majeed Waris,3,3,2013-10-15,3,0,0,0
Litsepe Marabe,1,1,2013-03-24,1,0,0,0
Patrick Ronaldinho Wleh,1,1,2013-03-24,1,0,0,0
Anthony Laffor,1,1,2013-03-24,1,0,0,0
Meddie Kagere,5,4,2019-09-10,3,2,0,0
Abdou Traoré,1,1,2013-03-24,0,1,0,0
Thomas Ulimwengu,3,3,2015-10-07,3,0,0,0
Mbwana Samatta,6,5,2019-09-08,5,1,0,0
Rudy Gestede,2,2,2013-06-09,1,1,0,0
Saphir Sliti Taïder,2,2,2013-06-16,1,1,0,0
Matěj Vydra,3,2,2020-10-11,0,3,0,0
Daniel Kolář,1,1,2013-03-26,0,1,0,0
Éver Banega,2,2,2016-06-06,1,1,0,0
Michael Umaña,1,1,2013-03-26,1,0,0,0
Diego Calvo,1,1,2013-03-26,1,0,0,0
Luis Nery Caballero,1,1,2013-03-26,0,1,0,0
Knowledge Musona,5,5,2022-01-18,3,2,0,1
Henri Anier,12,10,2024-06-08,5,7,0,0
İlkay Gündoğan,16,14,2024-06-19,8,8,0,7
Heinrich Schmidtgal,1,1,2013-03-26,0,1,0,0
Khalil Bani Attiah,1,1,2013-03-26,1,0,0,0
Łukasz Teodorczyk,1,1,2013-03-26,1,0,0,0
Jakub Kosecki,1,1,2013-03-26,1,0,0,0
Tim Payne,2,1,2013-03-26,0,2,0,0
Dániel Böde,5,4,2017-10-10,4,1,0,0
Yevhen Khacheridi,3,2,2013-09-06,3,0,0,0
Tommy Oar,2,2,2015-06-16,0,2,0,0
Reza Ghoochannejhad,7,7,2016-09-01,4,3,0,0
Valdet Rama,2,2,2013-09-10,1,1,0,0
Stefano Bensi,4,4,2018-11-18,1,3,0,0
Roy Miller,2,2,2015-07-08,2,0,0,0
Robert Snodgrass,6,4,2017-10-08,1,5,0,1
Igor Shitov,1,1,2013-06-07,1,0,1,0
Rene Krhin,2,2,2016-09-04,0,2,0,0
Jermaine Beckford,1,1,2013-06-07,1,0,0,0
Brad Evans,1,1,2013-06-07,0,1,0,0
Senad Lulić,3,3,2017-09-03,1,2,0,0
Martin Büchel,2,2,2014-09-08,2,0,1,0
Lazaros Christodoulopoulos,1,1,2013-06-07,0,1,0,0
Eugen Sidorenco,4,3,2013-10-15,3,1,0,0
Denys Harmash,2,2,2015-06-14,1,1,0,0
Artem Fedetskiy,2,2,2013-09-06,1,1,0,0
Roman Bezus,3,3,2013-10-15,1,2,0,0
Guilherme Afonso,2,2,2013-09-07,2,0,0,0
Katlego Mashego,1,1,2013-06-08,0,1,0,0
Lacina Traoré,2,2,2013-06-16,0,2,0,0
Amri Kiemba,2,2,2013-06-16,1,1,0,0
Abderrazak Hamdallah,1,1,2013-06-08,1,0,0,1
Kei Kamara,2,2,2019-09-08,2,0,0,0
Fakhreddine Ben Youssef,2,2,2018-06-28,0,2,0,0
Haris Seferovic,21,16,2022-06-12,12,9,0,0
Tony Mawejje,2,2,2013-06-15,2,0,0,0
Nabil Ghilas,1,1,2013-06-09,0,1,0,0
Mohamed Yattara,6,4,2019-06-30,3,3,0,0
Mohammed Diarra,1,1,2013-06-09,1,0,0,0
Lincoln Zvasiya,1,1,2013-06-09,1,0,0,0
Lucas Neill,1,1,2013-06-11,1,0,0,0
Aras Özbiliz,3,3,2017-03-26,2,1,0,0
Boniek García,2,2,2016-03-29,2,0,0,0
Roger Rojas,1,1,2013-06-11,1,0,0,0
Akmal Shorakhmedov,1,1,2013-06-11,1,0,1,0
Robin Ngalande,1,1,2013-06-12,1,0,0,0
Andrew Murunga,1,1,2013-06-12,0,1,0,0
Deon Kavendji,1,1,2013-06-12,1,0,0,0
Godfrey Oboabona,1,1,2013-06-12,0,1,0,0
Faisal Al Badri,2,2,2015-11-13,2,0,0,2
Nicaise Zimbori-Auzingoni,2,1,2013-06-15,0,2,0,0
Jerome Ramatlhakwane,2,2,2013-09-07,1,1,0,1
Paulinho,10,8,2018-06-27,5,5,0,1
Jô,2,2,2013-06-19,2,0,0,0
Yacouba Ali,1,1,2013-06-15,0,1,0,0
Abdelaziz Barrada,1,1,2013-06-15,1,0,0,0
Salah Ibrahim,1,1,2013-06-15,0,1,0,0
Abdulgadir Ilyas Bakur,1,1,2013-06-18,0,1,0,0
Oleg Zoteev,1,1,2013-06-18,1,0,0,0
Sebastian Giovinco,1,1,2013-06-19,1,0,0,0
Dante,1,1,2013-06-22,1,0,0,0
Emanuele Giaccherini,2,2,2016-06-13,0,2,0,0
Abel Hernández,6,3,2016-06-13,6,0,0,1
Nicolás Lodeiro,4,4,2019-06-16,3,1,0,0
Davide Astori,1,1,2013-06-30,0,1,0,0
Alessandro Diamanti,1,1,2013-06-30,0,1,0,0
Fabrice Reuperné,1,1,2013-07-07,0,1,0,0
Gabriel Torres,18,13,2022-03-30,14,4,0,5
Marco Fabián,4,4,2017-06-29,2,2,0,1
Rony Martínez,1,1,2013-07-08,0,1,0,0
Michael Barrantes,2,1,2013-07-09,2,0,0,0
Jairo Arrieta,1,1,2013-07-09,1,0,0,0
Chris Wondolowski,5,2,2013-07-13,5,0,0,0
Ian Gaynair,1,1,2013-07-09,0,1,0,0
Michael Orozco,2,2,2013-10-15,1,1,0,0
Raúl Jiménez,17,16,2022-03-30,12,5,0,6
Jorge Claros,2,2,2013-10-15,2,0,1,0
Dalton Eiley,1,1,2013-07-13,1,0,1,0
José Ciprian Alfonso,2,2,2013-07-20,0,2,0,0
Joe Corona,3,3,2017-07-15,3,0,0,0
Luis Montes,2,2,2013-07-24,0,2,0,0
Kévin Parsemain,5,4,2019-06-23,3,2,0,1
Miguel Ángel Ponce,1,1,2013-07-14,0,1,0,0
Ariel Martínez,3,1,2013-07-16,3,0,0,0
Brek Shea,2,2,2013-07-28,2,0,0,0
Carlos Gabriel Rodríguez,1,1,2013-07-20,1,0,0,0
Jairo Jiménez,1,1,2013-07-20,1,0,0,0
Andy Najar,2,2,2015-07-10,2,0,0,0
Mikkel Diskerud,1,1,2013-07-21,1,0,0,0
Nery Medina,1,1,2013-07-24,0,1,0,0
Martin Paterson,2,2,2013-09-10,1,1,0,0
Viktor Pečovský,1,1,2013-09-06,0,1,0,0
Marcos González,1,1,2013-09-06,1,0,0,0
Jhonny Acosta,2,2,2016-03-25,1,1,0,0
Karlen Mkrtchyan,1,1,2013-09-06,0,1,0,0
Rickie Lambert,1,1,2013-09-06,1,0,0,0
Nathan Sinkala,1,1,2013-09-06,0,1,0,0
Mussab Al-Laham,1,1,2013-09-06,1,0,0,0
Andrei Finonchenko,2,2,2013-10-11,1,1,0,0
Nauris Bulvītis,2,2,2014-05-31,2,0,0,0
Artūrs Zjuzins,5,5,2022-06-06,4,1,0,0
Deivydas Matulevičius,3,3,2014-09-08,1,2,0,0
Clayton Failla,2,2,2014-11-16,1,1,0,1
Ryan Camilleri,1,1,2013-09-06,0,1,1,0
Aleksandar Trajkovski,14,12,2022-03-24,10,4,0,1
Jamie Ward,4,4,2017-03-26,3,1,0,0
Gustavo Gómez,5,4,2021-07-02,3,2,3,0
Mihai Pintilii,1,1,2013-09-06,1,0,0,0
Aleksandr Samedov,3,3,2017-06-24,2,1,0,0
Aleksandar Mitrović,47,32,2023-10-17,28,19,0,2
Kevin Kampl,2,2,2015-03-27,2,0,0,0
Jóhann Berg Guðmundsson,6,4,2019-06-08,2,4,0,0
Fabian Schär,8,7,2019-09-05,3,5,0,1
Blerim Džemaili,5,5,2018-06-27,3,2,0,1
Marko Dević,4,2,2013-10-15,1,3,0,1
Edmar Halovskyi de Lacerda,1,1,2013-09-06,1,0,0,0
Guedes Lupapa,1,1,2013-09-07,1,0,0,0
Mabululu,4,4,2024-01-27,3,1,0,1
Abdul Nzayinawo,1,1,2013-09-07,1,0,0,0
Marcus Macauley,2,2,2021-11-16,1,1,0,0
Salif Kéïta,1,1,2013-09-07,1,0,0,0
Minyahil Teshome,1,1,2013-09-07,0,1,0,0
Rahid Amirguliyev,3,2,2015-09-06,0,3,0,0
Mahamane Cissé,3,2,2015-10-13,3,0,0,0
Fabrice N'Guessi,1,1,2013-09-07,0,1,0,0
Ulrich Kapolongo,1,1,2013-09-07,0,1,0,0
Moustapha Bangura,1,1,2013-09-07,1,0,0,0
Ibrahim Kargbo,1,1,2013-09-07,1,0,0,1
Jimmy Bermúdez,1,1,2013-09-07,0,1,0,0
Kermit Erasmus,1,1,2013-09-07,1,0,0,0
Dean Furman,2,2,2016-10-08,1,1,0,0
Mickaël Poté,3,2,2019-06-25,1,2,0,0
Babatounde Bello,2,2,2015-11-12,2,0,0,0
David Owino,1,1,2013-09-08,1,0,0,0
Bakri Almadina,1,1,2013-09-08,1,0,0,0
Tsepo Seturumane,3,3,2019-09-08,2,1,0,0
Tsepo Lekhoana,1,1,2013-09-08,0,1,0,0
Tsoanelo Koetle,1,1,2013-09-08,0,1,0,0
Lalawélé Atakora,1,1,2013-09-08,1,0,0,0
Patou Ebunga-Simbi,1,1,2013-09-08,0,1,0,0
Backer Aloenouvo,1,1,2013-09-08,1,0,0,0
Masimba Mambare,1,1,2013-09-08,1,0,0,0
Maninho,1,1,2013-09-08,0,1,0,0
Egor Filipenko,1,1,2013-09-10,1,0,0,0
Paul Pogba,7,7,2021-06-28,5,2,0,0
Jaime Arrascaita,1,1,2013-09-10,1,0,0,0
Josip Iličić,14,11,2021-10-11,6,8,0,5
Adam El-Abd,1,1,2013-09-10,0,1,1,0
Hossam Ghaly,1,1,2013-09-10,1,0,0,0
Seydouba Soumah,2,2,2016-11-13,1,1,0,1
Roman Eremenko,2,2,2014-09-07,0,2,0,1
Roberto Chen,1,1,2013-09-10,0,1,0,0
Ragnar Klavan,3,3,2016-11-13,2,1,3,0
Krisztián Németh,3,2,2015-10-11,1,2,0,0
Libor Kozák,1,1,2013-09-10,0,1,0,0
Jermaine Anderson,1,1,2013-09-10,1,0,0,0
Mathias Jänisch,1,1,2013-09-10,1,0,0,0
Radoslav Dimitrov,1,1,2013-09-10,0,1,0,0
Edward Herrera,1,1,2013-09-10,1,0,0,0
Ikechi Anya,2,2,2014-09-07,0,2,0,0
Jovan Kostovski,1,1,2013-09-10,1,0,0,0
José Ariel Núñez,1,1,2013-09-10,1,0,0,0
Eran Zahavi,31,22,2024-03-21,14,17,0,2
Piotr Zieliński,7,6,2024-03-21,3,4,0,0
Waldemar Sobota,1,1,2013-09-10,0,1,0,0
Ermin Bičakčić,3,3,2017-03-25,2,1,0,0
Izet Hajrović,4,3,2019-10-12,1,3,0,0
Cristhian Stuani,2,2,2013-11-13,1,1,0,0
Anzur Ismailov,3,3,2016-03-24,2,1,0,0
Paolo Hurtado,2,2,2017-09-05,0,2,0,0
Rómulo Otero,5,5,2017-03-23,4,1,0,1
Filip Đorđević,1,1,2013-09-10,0,1,0,0
Lazar Marković,1,1,2013-09-10,0,1,0,0
Michael Lang,3,3,2018-10-15,1,2,0,0
Claudiu Keșerü,10,8,2019-10-12,5,5,0,0
Rufat Dadashov,1,1,2013-10-11,1,0,0,0
Nicolas Hasler,3,3,2020-09-08,1,2,0,1
Romelu Lukaku,60,37,2023-11-19,36,24,0,6
Andros Townsend,2,2,2014-10-09,2,0,0,0
Hallur Hansson,3,3,2018-09-07,3,0,0,0
Fedor Černych,14,13,2023-10-17,10,4,0,0
Tomáš Hübschman,1,1,2013-10-11,0,1,0,0
Szilárd Devecseri,1,1,2013-10-11,1,0,1,0
Ricardo Costa,1,1,2013-10-11,1,0,0,0
Graham Zusi,4,4,2016-06-07,3,1,0,0
Luis Manuel Seijas,1,1,2013-10-11,1,0,0,0
Simon Church,1,1,2013-10-11,1,0,0,0
Carl Medjani,2,2,2015-11-17,1,1,0,0
Ludovic Sané,1,1,2013-10-12,1,0,1,0
Behailu Assefa,1,1,2013-10-13,1,0,0,0
Bořek Dočkal,6,6,2020-09-04,1,5,0,1
Andreas Bjelland,1,1,2013-10-15,1,0,0,0
Nicki Bille Nielsen,1,1,2013-10-15,1,0,0,0
Wael Gomaa,1,1,2013-10-15,1,0,1,0
Christian Atsu,3,2,2015-02-01,3,0,0,0
Nemanja Nikolić,4,4,2021-03-28,2,2,0,1
Alessandro Florenzi,2,2,2015-10-13,2,0,0,0
Kornel Saláta,2,2,2015-06-14,1,1,0,0
Valērijs Šabala,7,6,2017-10-10,4,3,0,1
Renārs Rode,1,1,2013-10-15,1,0,0,0
Alexandru Antoniuc,2,1,2013-10-15,0,2,0,0
Artur Ioniță,1,1,2013-10-15,0,1,0,0
Aron Jóhannsson,2,2,2015-07-18,1,1,0,0
Jorge Rojas,1,1,2013-10-15,1,0,0,0
Yoshimar Yotún,5,5,2022-03-29,4,1,0,0
Diego Bejarano,2,2,2021-06-03,1,1,0,0
Dmitriy Shomko,2,1,2013-10-15,1,1,1,0
John O'Shea,3,3,2015-06-13,1,2,1,0
Vitaliy Mandzyuk,1,1,2013-10-15,0,1,0,0
Dušan Basta,1,1,2013-10-15,1,0,0,0
Stefan Šćepović,1,1,2013-10-15,1,0,0,0
Adis Jahović,2,2,2014-10-09,1,1,0,1
Paul Aguilar,2,2,2015-07-15,1,1,0,0
Chris James,2,2,2013-11-20,1,1,0,1
Kostas Mitroglou,4,3,2018-10-12,3,1,0,0
Benjamin Moukandjo,4,4,2017-01-14,2,2,0,0
Ahmed Akaïchi,4,4,2015-01-31,0,4,0,0
Mohamed Nagy,1,1,2013-11-19,1,0,0,0
Mamadou Sakho,2,1,2013-11-19,2,0,0,0
Carlos Peña,1,1,2013-11-20,0,1,0,0
Arvydas Novikovas,9,9,2020-11-18,4,5,0,3
Perparim Hetemaj,1,1,2014-05-31,1,0,0,0
Valtteri Moren,1,1,2014-05-31,1,0,0,0
Marcelo,2,2,2017-03-28,1,1,1,0
Stefan de Vrij,3,3,2024-07-06,1,2,0,0
Óscar Duarte,2,2,2021-11-16,1,1,0,0
Sead Kolašinac,1,1,2014-06-15,1,0,1,0
Noel Valladares,1,1,2014-06-15,1,0,1,0
Enner Valencia,20,16,2022-11-25,10,10,0,4
Admir Mehmedi,7,7,2019-09-08,5,2,0,0
Mats Hummels,5,5,2021-06-15,2,3,2,0
John Brooks,1,1,2014-06-16,0,1,0,0
Dries Mertens,15,13,2020-11-15,11,4,0,0
Memphis Depay,35,25,2024-06-25,23,12,0,8
Juan Fernando Quintero,2,2,2018-06-19,2,0,0,0
Blaise Matuidi,2,2,2017-10-07,0,2,0,0
Moussa Sissoko,1,1,2014-06-20,0,1,0,0
Divock Origi,2,2,2014-10-10,2,0,0,0
Abdelmoumene Djabou,2,2,2014-06-30,0,2,0,0
Yacine Brahimi,3,3,2017-09-02,1,2,0,0
Joël Matip,1,1,2014-06-23,0,1,0,0
Fernandinho,2,2,2018-07-06,1,1,1,0
Leroy Fer,1,1,2014-06-23,1,0,0,0
Andreas Samaris,1,1,2014-06-24,1,0,0,0
Juan Cuadrado,5,5,2021-09-05,0,5,0,2
Avdija Vršajević,2,2,2017-03-25,2,0,0,0
Marcos Rojo,3,3,2018-06-26,1,2,0,0
David Luiz,2,2,2014-07-04,2,0,0,0
Sokratis Papastathopoulos,3,3,2017-11-09,0,3,0,0
Julian Green,1,1,2014-07-01,0,1,0,0
Thiago Silva,3,3,2018-06-27,2,1,0,0
Daley Blind,2,2,2022-12-03,1,1,0,0
Pierre-Emile Højbjerg,6,6,2023-09-10,3,3,0,0
Riku Riski,2,1,2014-09-07,0,2,0,0
Kamil Grosicki,9,7,2020-09-07,4,5,0,0
Łukasz Szukała,1,1,2014-09-07,0,1,0,0
Bekim Balaj,5,5,2019-11-14,2,3,0,0
Erkan Zengin,3,3,2015-10-12,2,1,0,0
Žarko Tomašević,4,4,2021-03-27,3,1,0,0
Dmitri Kombarov,1,1,2014-09-08,1,0,0,1
Artem Dzyuba,27,18,2021-06-21,16,11,0,5
Paco Alcácer,9,7,2019-09-08,6,3,0,0
Sergio Busquets,2,2,2014-11-15,2,0,0,0
Róbert Mak,10,9,2023-09-11,7,3,0,0
Iliyan Mitsanski,2,2,2015-03-28,1,1,0,0
Dimitrij Nazarov,6,6,2018-11-17,5,1,0,0
Ventsislav Hristov,1,1,2014-09-09,0,1,0,0
Andrej Kramarić,21,19,2024-06-19,13,8,0,2
Jón Daði Böðvarsson,4,4,2019-09-07,4,0,1,0
Simone Zaza,1,1,2014-09-09,0,1,0,0
Alyaksandr Martynovich,1,1,2014-10-09,0,1,1,0
Serhiy Sydorchuk,3,3,2021-03-24,1,2,0,0
Phil Jagielka,1,1,2014-10-09,1,0,0,0
Alexandru Dedov,2,2,2017-06-11,2,0,0,1
David Turpel,5,5,2019-11-14,3,2,0,0
Besart Abdurahimi,1,1,2014-10-09,1,0,0,0
Juraj Kucka,10,10,2023-11-16,6,4,1,0
Nikolay Bodurov,2,2,2014-10-13,0,2,1,0
Omer Damari,5,3,2014-11-16,1,4,0,0
Aron Gunnarsson,5,3,2023-03-26,1,4,0,1
Rúrik Gíslason,1,1,2014-10-10,0,1,0,0
Mats Møller Dæhli,1,1,2014-10-10,0,1,0,0
Ermir Lenjani,3,3,2022-09-27,2,1,0,0
Lasse Vibe,1,1,2014-10-11,0,1,0,0
Nikolaos Karelis,1,1,2014-10-11,0,1,0,0
Jarkko Hurme,1,1,2014-10-11,1,0,0,0
Arkadiusz Milik,12,11,2023-06-20,8,4,0,1
Sebastian Mila,2,2,2014-11-14,1,1,0,0
James McClean,6,4,2017-10-09,2,4,0,0
Jordan Perez,1,1,2014-10-11,1,0,1,0
Wes Hoolahan,2,2,2016-06-13,2,0,0,0
Raul Rusescu,1,1,2014-10-11,1,0,0,0
Akaki Khubutia,1,1,2014-10-11,1,0,1,0
Rubin Okotie,2,2,2014-11-15,2,0,0,0
Diego Costa,9,7,2018-06-20,3,6,0,0
Juan Bernat,1,1,2014-10-12,0,1,0,0
Jimmy Durmaz,2,2,2017-06-09,2,0,0,0
Radja Nainggolan,4,4,2016-07-01,0,4,0,0
Marcelo Brozović,6,5,2021-11-11,5,1,1,0
Ladislav Krejčí,3,3,2023-06-17,1,2,0,0
Yuriy Logvinenko,4,3,2018-09-10,2,2,0,0
Bilal Kısa,1,1,2014-10-13,0,1,0,0
Graziano Pellè,6,6,2016-09-05,3,3,0,0
Håvard Nielsen,1,1,2014-10-13,1,0,0,0
David Cotterill,1,1,2014-10-13,1,0,0,0
Nikoloz Gelashvili,1,1,2014-10-14,0,1,0,0
Krzysztof Mączyński,2,2,2017-10-08,2,0,0,0
Grzegorz Krychowiak,5,5,2021-09-02,3,2,0,0
Yogan Santos,1,1,2014-11-14,1,0,1,0
Paul Papp,2,1,2014-11-14,2,0,0,0
Jordan Henderson,4,4,2022-12-04,2,2,1,0
Adam Nemec,8,7,2017-10-08,5,3,0,0
Isco,8,7,2018-09-11,7,1,0,0
Giedrius Arlauskis,2,2,2015-10-12,1,1,2,0
Håvard Nordtveit,2,2,2019-03-26,0,2,1,0
Andrey Galabinov,1,1,2014-11-16,1,0,0,0
Giorgos Merkis,1,1,2014-11-16,1,0,0,0
Georgios Efrem,5,3,2019-11-16,5,0,0,0
Ragnar Sigurðsson,5,4,2019-06-11,3,2,0,0
Pavel Kadeřábek,2,2,2015-10-13,1,1,0,0
Gil Vermouth,1,1,2014-11-16,1,0,0,0
Antonio Candreva,5,5,2017-10-09,1,4,0,2
Jeffrey Bruma,1,1,2014-11-16,1,0,0,0
Serdar Aziz,2,2,2018-09-07,2,0,0,0
Massimo Luongo,5,5,2016-09-01,5,0,0,0
James Troisi,3,3,2017-06-25,2,1,0,0
Cho Young-cheol,1,1,2015-01-10,1,0,0,0
Igor Sergeev,7,6,2024-01-18,3,4,0,0
Ehsan Hajsafi,4,3,2021-11-16,3,1,0,3
Ali Mabkhout,32,22,2021-11-16,23,9,0,5
Yaser Kasim,1,1,2015-01-12,0,1,0,0
Matt McKay,1,1,2015-01-13,1,0,0,0
Mark Milligan,4,4,2017-06-22,2,2,0,3
Tomi Juric,7,6,2017-09-05,6,1,0,0
Nam Tae-hee,4,4,2021-06-05,3,1,0,0
Wu Xi,6,6,2021-10-12,3,3,0,0
Sun Ke,3,2,2015-01-18,3,0,0,0
Ryang Yong-gi,1,1,2015-01-14,1,0,0,0
Nawaf Al-Abed,6,5,2017-08-29,2,4,0,4
Sardar Azmoun,29,22,2024-02-07,17,12,0,0
Yousef Al-Rawashdeh,2,2,2016-03-24,1,1,0,0
Hamza Al-Dardour,11,5,2019-11-19,7,4,0,0
Jaka Ihbeisheh,3,3,2016-03-29,3,0,0,0
Lee Jung-hyup,2,2,2015-01-26,1,1,0,0
Malick Evouna,2,2,2015-11-14,1,1,0,0
Emilio Nsue,8,5,2024-01-22,6,2,0,0
Thievy Bifouma,6,6,2017-09-01,3,3,0,0
Gao Lin,4,4,2019-01-20,1,3,1,3
Mohamed Ali Manser,1,1,2015-01-18,1,0,0,0
Sardor Rashidov,7,5,2016-03-29,3,4,0,0
Vokhid Shodiev,1,1,2015-01-18,1,0,0,0
Given Singuluma,1,1,2015-01-18,1,0,0,0
Yannick Bolasie,3,3,2016-11-13,0,3,0,0
Thuso Phala,1,1,2015-01-19,0,1,0,0
Thulani Hlatshwayo,1,1,2015-01-19,1,0,1,0
Faouzi Ghoulam,3,2,2015-11-17,3,0,0,1
Mame Biram Diouf,3,3,2015-11-17,1,2,0,0
Hassan Al-Haydos,17,14,2024-02-03,13,4,0,4
Sayed Jaafar Ahmed,1,1,2015-01-19,0,1,0,0
Ahmed Yasin Ghani,4,4,2017-03-23,3,1,0,0
Seydou Doumbia,3,2,2017-09-02,1,2,0,0
Sambou Yatabaré,2,2,2016-10-08,1,1,0,0
Ambroise Oyongo,1,1,2015-01-20,0,1,0,0
Morteza Pouraliganji,3,3,2021-06-11,2,1,0,0
Dhurgham Ismail,2,2,2015-11-17,0,2,0,1
Gaku Shibasaki,1,1,2015-01-23,1,0,0,0
Oupa Manyisa,1,1,2015-01-23,1,0,0,0
Kara Mbodji,3,3,2017-11-14,1,2,0,0
Bakary Sako,2,2,2015-11-17,1,1,0,0
Max Gradel,7,7,2022-01-12,2,5,0,0
Fabrice Ondama,2,2,2015-11-14,1,1,0,0
Iban Salvador,3,3,2024-01-14,2,1,0,1
Jeremy Bokila,2,2,2015-01-31,1,1,0,0
Kim Young-gwon,5,5,2022-12-02,5,0,0,0
Trent Sainsbury,3,3,2021-06-07,2,1,0,0
Jason Davidson,1,1,2015-01-27,1,0,0,0
Riyad Mahrez,12,10,2021-11-16,10,2,0,1
Nabil Bentaleb,2,2,2016-11-12,0,2,0,0
Mandla Masango,1,1,2015-01-27,1,0,0,0
Kévin Constant,1,1,2015-01-28,1,0,0,1
Waleed Salim Al-Lami,1,1,2015-01-30,1,0,0,0
Amjad Kalaf,1,1,2015-01-30,1,0,0,0
Férébory Doré,2,2,2016-10-09,2,0,0,0
Joël Kimwaki,1,1,2015-01-31,0,1,0,0
Kwesi Appiah,1,1,2015-02-01,1,0,0,0
Wilfried Kanon,1,1,2015-02-04,0,1,0,0
Chan Vathanaka,2,1,2015-03-12,2,0,0,0
Tshering Dorji,4,4,2019-06-06,2,2,0,1
Adi Said,1,1,2015-03-12,0,1,0,0
Abdulwasea Al-Matari,2,2,2019-09-05,1,1,0,0
Mohammed Boqshan,1,1,2015-03-12,1,0,0,0
Hassan Bashir,2,2,2019-06-11,1,1,0,2
Ala Al-Sasi,1,1,2015-03-12,1,0,0,0
Chencho Gyeltshen,4,3,2016-03-29,3,1,0,0
Subash Madushan,1,1,2015-03-17,0,1,0,0
Wang Rui,1,1,2015-03-17,0,1,0,0
Onur Dogan,1,1,2015-03-17,0,1,0,0
Thierry Bin,1,1,2015-03-17,0,1,0,0
Luis Galeano,2,2,2015-09-04,1,1,0,0
Luis Copete,2,1,2015-03-23,2,0,0,0
Juan Barrera,5,4,2021-06-04,2,3,0,0
Norfran Lazo,1,1,2015-03-23,1,0,0,0
Atiba Harris,2,2,2015-06-16,1,1,0,0
Billy Forbes,1,1,2015-03-23,0,1,0,0
Thrizen Leader,2,1,2015-03-23,1,1,1,0
Tishan Hanley,1,1,2015-03-23,1,0,0,0
Errol O'Loughlin,1,1,2015-03-23,1,0,0,0
Dante Leverock,3,3,2021-03-30,1,2,0,0
Zeiko Lewis,1,1,2015-03-25,0,1,0,0
Justin Donawa,2,1,2015-03-25,0,2,0,0
Eduard Moss,1,1,2015-03-26,0,1,0,0
Glensworth Elizee,1,1,2015-03-26,1,0,0,0
Jordan Johnson,1,1,2015-03-26,0,1,0,0
Mitchell Joseph,1,1,2015-03-26,1,0,0,0
Randolph Peltier,1,1,2015-03-26,1,0,0,0
Widlin Calixte,2,1,2015-03-26,2,0,0,2
Joash Leader,2,1,2015-03-26,0,2,0,0
Harry Panayiotou,3,1,2015-03-26,0,3,0,1
Ryan Robbins,1,1,2015-03-26,0,1,0,0
Raheim Sargeant,1,1,2015-03-26,0,1,0,0
Jamal Chandler,1,1,2015-03-26,0,1,0,0
Mario Harte,1,1,2015-03-26,0,1,0,0
Jabarry Chandler,1,1,2015-03-26,0,1,0,0
Papito Merencia,2,2,2015-06-14,1,1,0,0
Lyle Taylor,6,4,2021-06-08,1,5,0,2
Felitciano Zschusschen,1,1,2015-03-27,1,0,0,1
Raheem Sterling,19,15,2022-11-21,12,7,0,1
Harry Kane,58,42,2024-07-10,32,26,0,20
Andraž Struna,1,1,2015-03-27,1,0,0,0
Dejan Lazarević,1,1,2015-03-27,1,0,0,0
Branko Ilić,1,1,2015-03-27,1,0,0,0
Álvaro Morata,29,23,2024-06-15,17,12,0,1
Javid Huseynov,1,1,2015-03-28,1,0,0,0
Michy Batshuayi,17,14,2022-11-23,10,7,0,1
Yordan Minev,1,1,2015-03-28,0,1,1,0
Éder,4,4,2017-06-11,2,2,0,0
Alexander Tettey,3,3,2015-10-13,1,2,0,0
Gordon Schildenfeld,1,1,2015-03-28,1,0,0,0
Danijel Pranjić,1,1,2015-03-28,1,0,0,0
Mërgim Mavraj,2,1,2015-03-29,1,1,1,0
Shkëlzen Gashi,1,1,2015-03-29,1,0,0,0
Berat Sadik,1,1,2015-03-29,0,1,0,0
Nemanja Matić,2,2,2017-10-06,0,2,0,0
Sławomir Peszko,1,1,2015-03-29,0,1,0,0
Lee Casciaro,3,3,2019-10-15,1,2,0,0
Darryl Lachman,1,1,2015-03-31,0,1,0,0
Jamal Willer,1,1,2015-03-31,1,0,0,0
Bradley Woods-Garness,1,1,2015-03-31,1,0,0,0
Charlton Vicento,1,1,2015-03-31,0,1,0,0
Pokklaw Anan,3,3,2017-09-05,2,1,0,0
Carlos Chavarría,4,4,2017-07-12,1,3,0,0
Tevaughn Harriette,2,2,2015-06-14,2,0,0,0
David Henry,1,1,2015-06-10,0,1,0,0
Troy Greenidge,1,1,2015-06-10,0,1,0,0
Emmerson Boyce,2,1,2015-06-10,0,2,0,0
Brandon Beresford,1,1,2015-06-10,0,1,0,0
Tevin Slater,5,4,2015-09-08,2,3,0,0
Moayad Ajan,1,1,2015-06-11,0,1,0,0
Omar Khribin,15,11,2024-01-31,7,8,0,3
Anton Zemlianukhin,4,3,2015-11-17,2,2,0,1
Edgar Bernhardt,4,2,2019-10-10,3,1,0,2
Valery Kichin,2,2,2019-10-10,2,0,1,0
Safuwan Baharudin,4,3,2019-09-10,2,2,0,1
Cyle Larin,20,16,2022-03-27,13,7,0,2
Russell Teibert,1,1,2015-06-11,0,1,0,1
Geremy Lombardi,1,1,2015-06-11,1,0,0,0
Serdar Annaorazow,1,1,2015-06-11,1,0,1,0
Jaimes McKee,2,1,2015-06-11,2,0,0,0
Christian Annan,1,1,2015-06-11,1,0,0,0
Ju Yingzhi,1,1,2015-06-11,1,0,0,0
Godfred Karikari,2,2,2015-09-08,2,0,0,0
Qasim Said,1,1,2015-06-11,0,1,0,0
Zaw Min Tun,2,2,2015-09-03,1,1,1,0
Kyaw Zayar Win,1,1,2015-06-11,0,1,0,0
Ahmed Abdul Maqsoud,1,1,2015-06-11,0,1,0,0
Misagh Bahadoran,3,3,2016-03-29,2,1,0,0
Javier Patiño,2,2,2019-09-05,2,0,0,0
Abdulwahab Al-Malood,2,2,2016-03-24,1,1,0,0
Irvin Herrera,1,1,2015-06-11,0,1,0,0
Romaine Sawyers,2,2,2021-06-04,2,0,0,0
Nelson Bonilla,9,8,2022-01-30,3,6,0,0
Yahya Al-Shehri,5,5,2017-03-28,4,1,0,0
Pablo Tamburrini,1,1,2015-06-11,0,1,0,0
Matías Jadue,1,1,2015-06-11,0,1,0,0
Manuchekhr Dzhalilov,10,6,2021-06-15,7,3,0,1
Dossa Júnior,2,2,2015-10-10,1,1,1,0
Nestoras Mitidis,4,2,2015-10-13,1,3,0,0
Edin Višća,7,6,2019-09-05,6,1,0,0
Deniz Bozkurt,1,1,2015-06-12,1,0,0,0
Hrayr Mkoyan,2,2,2016-10-11,2,0,1,0
Yussuf Poulsen,10,10,2023-10-17,7,3,0,0
Brandur Olsen,1,1,2015-06-13,1,0,0,0
Zoltán Stieber,2,2,2016-06-14,0,2,0,0
Max Kruse,3,2,2015-10-11,1,2,0,0
Karim Bellarabi,1,1,2015-06-13,0,1,0,0
Josh Parker,2,1,2015-06-14,2,0,0,0
Aaron Tumwa,1,1,2015-06-14,1,0,0,0
Christian Cueva,11,11,2021-11-16,6,5,0,2
Douglas Costa,3,3,2016-03-25,3,0,0,0
Emery Welshman,3,2,2021-03-30,3,0,0,0
Neil Danns,5,3,2019-06-26,4,1,0,3
Oalex Anderson,6,5,2021-03-30,2,4,0,1
Sandro Wieser,2,2,2018-09-09,2,0,0,0
Gheorghe Boghiu,1,1,2015-06-14,0,1,0,0
Josip Drmić,5,4,2018-06-27,4,1,0,0
Arijan Ademi,4,4,2021-03-25,1,3,0,0
Jack Wilshere,2,1,2015-06-14,0,2,0,0
Artem Kravets,6,6,2016-11-12,4,2,0,0
Stefano Cincotta,2,2,2015-11-17,0,2,0,0
Ronald Raldes,2,2,2015-06-19,1,1,1,0
Martin Smedberg-Dalence,1,1,2015-06-15,0,1,0,0
Miller Bolaños,5,5,2016-11-15,4,1,0,0
Fatkhullo Fatkhuloev,1,1,2015-06-16,0,1,0,0
Wu Lei,17,14,2021-11-16,11,6,0,4
Mustafa Zazai,2,2,2015-11-12,1,1,0,0
Tesho Akindele,1,1,2015-06-16,1,0,0,0
Darwin Cerén,3,3,2022-01-30,1,2,0,1
Joan Morales,1,1,2015-06-16,1,0,1,0
Jamal Charles,1,1,2015-06-16,1,0,0,0
Brandon McDonald,1,1,2015-06-16,1,0,0,0
Travis Nicklaw,2,2,2019-11-19,2,0,1,0
Xu Deshuai,1,1,2015-06-16,1,0,0,0
Almazbek Mirzaliev,1,1,2015-06-16,1,0,0,0
Feiz Shamsin,1,1,2015-06-16,0,1,0,0
Musab Al-Battat,1,1,2015-06-16,0,1,0,0
Sameh Maraaba,2,1,2015-06-16,0,2,0,0
Tamer Seyam,6,4,2024-01-14,3,3,0,2
Khader Yousef,1,1,2015-06-16,0,1,0,0
Lee Jae-sung,4,4,2021-11-16,2,2,0,0
Pak Kwang-ryong,3,3,2019-01-17,2,1,0,1
Jang Kuk-chol,2,2,2019-09-10,1,1,0,0
Ro Hak-su,1,1,2015-06-16,1,0,0,0
Roxey Fer,1,1,2015-06-16,1,0,0,0
Manuel Rosas Arreola,3,3,2019-06-20,0,3,1,1
Ruslan Mingazow,1,1,2015-06-16,1,0,0,0
Iain Ramsay,3,3,2019-11-14,1,2,0,0
Jeison Murillo,1,1,2015-06-17,0,1,0,0
José María Giménez,3,3,2019-06-20,2,1,0,0
Roberto Firmino,9,8,2021-06-23,9,0,0,0
Mauricio Isla,2,2,2021-10-10,2,0,0,0
Derlis González,4,4,2019-06-16,1,3,0,1
Javier Pastore,1,1,2015-06-30,1,0,0,0
Alberto Quintero,4,4,2021-07-20,4,0,0,0
Duckens Nazon,12,9,2023-06-25,4,8,0,2
Carlos Discua,1,1,2015-07-07,0,1,0,0
Garath McCleary,2,2,2015-07-14,1,1,0,0
David Ramírez,2,2,2017-07-14,2,0,0,0
Jobi McAnuff,1,1,2015-07-08,0,1,0,0
Sheldon Bateau,4,4,2021-03-25,4,0,0,0
Cordell Cato,1,1,2015-07-09,1,0,0,0
Joevin Jones,7,6,2021-03-28,5,2,0,1
Dustin Corea,1,1,2015-07-11,0,1,0,0
Andre Boucaud,1,1,2015-07-12,1,0,0,0
Maikel Reyes,4,4,2023-07-04,1,3,0,1
Keron Cummings,2,1,2015-07-15,2,0,0,0
Yohance Marshall,1,1,2015-07-15,1,0,0,0
Giles Barnes,2,2,2015-07-22,0,2,0,0
Gyasi Zardes,8,7,2021-07-29,8,0,0,0
Omar Gonzalez,4,4,2017-10-10,4,0,1,0
Darren Mattocks,7,7,2019-06-30,4,3,0,2
Roberto Nurse,1,1,2015-07-25,0,1,0,0
Jesús Manuel Corona,6,6,2021-09-08,2,4,0,0
Faitalia Hamilton-Pama,1,1,2015-08-31,1,0,0,0
Andrew Mobberley,2,2,2015-09-04,1,1,0,0
Frankie Beauchamp,2,1,2015-08-31,0,2,0,0
Taylor Saghabi,4,2,2015-09-02,1,3,0,0
Sione Uhatahi,1,1,2015-09-02,1,0,0,0
Justin Manao,2,2,2015-09-04,1,1,0,0
Mathew Leckie,9,8,2022-11-30,4,5,0,0
Tom Rogic,9,7,2022-01-27,9,0,0,0
Nathan Burns,3,2,2016-03-24,3,0,0,0
Aaron Mooy,4,4,2022-02-01,2,2,0,0
Jong Il-gwan,5,4,2019-09-05,4,1,0,1
Vegard Forren,1,1,2015-09-03,0,1,0,0
Milan Škoda,3,2,2016-06-17,3,0,0,0
Mehdi Taremi,23,18,2024-01-31,12,11,0,2
Mehdi Torabi,1,1,2015-09-03,1,0,0,0
Ali Adnan Kadhim,5,5,2021-06-07,5,0,0,2
Ali Hosni,1,1,2015-09-03,1,0,0,0
Wen Chih-hao,2,2,2019-09-05,1,1,0,0
Justin Meram,3,3,2017-08-31,1,2,0,1
Nir Bitton,3,3,2021-11-12,2,1,0,0
Mu'nas Dabbur,11,10,2021-11-15,8,3,0,1
Ali Maqseed,1,1,2015-09-03,1,0,0,0
Faisal Zayid,2,2,2019-11-14,2,0,0,0
Aziz Mashaan,1,1,2015-09-03,1,0,0,0
Raed Ibrahim Saleh,1,1,2015-09-03,1,0,0,0
Mekan Saparow,2,2,2015-11-12,1,1,1,0
Mohammed Musa,4,3,2015-10-13,3,1,0,0
Ali Assadalla,4,2,2017-08-31,3,1,0,0
Mohammed Muntari,6,4,2022-11-25,4,2,0,0
Akram Afif,18,14,2024-02-10,15,3,0,6
Boualem Khoukhi,7,5,2019-09-05,5,2,0,0
Ismaeel Mohammad,1,1,2015-09-03,1,0,0,0
Salman Al-Faraj,6,4,2021-06-15,4,2,0,2
Fahad Al-Muwallad,10,9,2021-06-11,8,2,0,0
Kwon Chang-hoon,7,6,2022-02-01,5,2,0,0
Suk Hyun-jun,2,2,2015-11-17,1,1,0,0
Oday Al-Jafal,1,1,2015-09-03,1,0,0,0
Mohanad Salem,1,1,2015-09-03,1,0,0,0
Habib Fardan,1,1,2015-09-03,1,0,0,0
Ali'i Mitchell,1,1,2015-09-04,1,0,0,0
Myles Weston,1,1,2015-09-04,1,0,0,1
Alexander Larín,2,2,2016-09-02,1,1,0,1
Valeri Qazaishvili,10,9,2022-06-05,8,2,0,1
Cyrus Christie,1,1,2015-09-04,0,1,0,0
Joel Pohjanpalo,12,11,2023-11-17,8,4,0,1
Anthony Straker,1,1,2015-09-04,1,0,0,1
Mechack Jérôme,1,1,2015-09-04,0,1,0,0
Adrian Mariappa,2,2,2022-03-27,2,0,1,0
Levon Hayrapetyan,1,1,2015-09-04,1,0,1,0
Adem Ljajić,5,5,2019-06-10,4,1,0,0
Johnny Hall,2,1,2015-09-04,0,2,0,0
Sébastien Thill,2,2,2021-11-11,1,1,0,0
Cristian Brolli,3,3,2021-10-09,2,1,3,0
Ross Barkley,6,4,2019-10-14,0,6,0,0
David Limberský,1,1,2015-09-06,0,1,0,0
Vladimír Darida,6,5,2020-11-15,2,4,0,2
Alfred Effiong,2,2,2016-09-04,2,0,0,0
Jo Inge Berget,1,1,2015-09-06,1,0,0,0
Oğuzhan Özyakup,1,1,2015-09-06,1,0,0,0
Richárd Guzmics,2,2,2017-10-07,0,2,0,0
Bartosz Kapustka,2,2,2016-09-04,1,1,0,0
Jake Gosling,1,1,2015-09-07,0,1,0,0
James McArthur,3,3,2017-09-01,2,1,0,0
Masato Morishige,1,1,2015-09-08,0,1,0,0
Erixon Danso,2,1,2015-09-08,2,0,0,0
Munther Abu Amarah,1,1,2015-09-08,0,1,0,0
Yaseen Al-Bakhit,1,1,2015-09-08,0,1,0,0
Mikhail Gordeichuk,2,1,2015-09-08,2,0,0,0
Mahmoud Al-Mawas,12,9,2021-06-07,5,7,0,3
Omar Midani,1,1,2015-09-08,0,1,0,0
Osama Omari,5,3,2019-11-14,4,1,0,0
Jonathan Barrios,1,1,2015-09-08,1,0,0,0
Dennis López,2,2,2015-11-17,1,1,0,0
Karim Boudiaf,3,3,2019-10-10,1,2,0,0
Abdelkarim Hassan,3,3,2019-09-05,1,2,0,0
Bai He,1,1,2015-09-08,1,0,0,0
Jang Hyun-soo,2,2,2015-11-12,1,1,0,1
Ali Hamam,2,2,2015-11-12,1,1,1,0
Fyodor Smolov,6,5,2021-11-11,5,1,0,0
Matteo Vitaioli,1,1,2015-09-08,0,1,0,0
Lukas Spalvis,1,1,2015-09-08,1,0,0,0
Stefan Savić,5,5,2023-09-10,3,2,0,1
Petru Racu,1,1,2015-09-08,0,1,1,0
Simon Dawkins,1,1,2015-09-08,0,1,0,0
Tome Pačovski,1,1,2015-09-08,0,1,1,0
Robert Berić,2,2,2018-09-09,1,1,0,0
Đinh Tiến Thành,2,2,2015-10-13,0,2,1,0
Wu Chun-ching,3,3,2021-06-15,1,2,0,0
Trần Phi Sơn,1,1,2015-09-08,0,1,0,0
Theerathon Bunmathan,3,3,2019-09-10,1,2,0,2
Mongkol Tossakrai,3,3,2017-06-13,2,1,0,0
Hussain Ali Baba,1,1,2015-09-08,0,1,0,1
Sami Al-Husaini,1,1,2015-09-08,0,1,0,0
Abdullah Omar,1,1,2015-09-08,0,1,0,0
Johanna Omolo,3,2,2019-06-27,1,2,0,0
Ayub Masika,1,1,2015-10-07,0,1,0,0
Haron Shakava,1,1,2015-10-07,0,1,0,0
Jonathan Bru,1,1,2015-10-07,1,0,0,0
Michael Olunga,7,6,2021-11-15,4,3,0,0
Fiston Abdul Razak,4,3,2019-09-08,2,2,0,1
Boubacar Bagili,2,2,2015-10-13,1,1,0,0
Dominic Abui Pretino,1,1,2015-10-07,1,0,0,0
Frickson Erazo,1,1,2015-10-08,0,1,0,0
Eldor Shomurodov,12,9,2021-06-07,6,6,0,0
Ahmed Nashid,1,1,2015-10-08,0,1,0,0
Biren Basnet,1,1,2015-10-08,1,0,0,0
Martín Cáceres,3,3,2017-10-10,2,1,0,0
Edwin Cardona,4,4,2021-06-13,2,2,0,0
Mate Vatsadze,2,1,2015-10-08,2,0,0,0
Róaldur Jakobsen,1,1,2015-10-08,0,1,0,0
Bakhtiyar Duyshobekov,1,1,2015-10-08,1,0,0,0
Akhtam Nazarov,2,2,2015-11-12,1,1,0,2
William Jebor,4,2,2015-10-13,1,3,0,1
Amido Baldé,1,1,2015-10-08,0,1,0,0
Josh Magennis,10,9,2023-10-14,5,5,0,0
Christos Aravidis,1,1,2015-10-08,0,1,0,0
Saad Al-Mukhaini,1,1,2015-10-08,1,0,0,0
Ovidiu Hoban,1,1,2015-10-08,1,0,0,0
Matt Ritchie,1,1,2015-10-08,1,0,0,0
Takashi Usami,1,1,2015-10-08,0,1,0,0
Luís Leal,1,1,2015-10-08,1,0,0,0
Guwanç Abylow,2,2,2015-10-13,2,0,0,0
Mthunzi Mkhontfo,1,1,2015-10-09,0,1,0,0
Sabelo Ndzinisa,1,1,2015-10-09,0,1,0,0
Saneliso Dlamini,1,1,2015-10-09,0,1,0,0
Sandile Hlatjwako,3,2,2015-10-17,2,1,0,0
Tony Tsabedze,1,1,2015-10-09,0,1,0,0
Mxolisi Lukhele,1,1,2015-10-09,0,1,0,0
Willy Stephanus,2,2,2015-10-13,1,1,0,0
Eugeniu Cebotaru,1,1,2015-10-09,1,0,0,0
Marcel Sabitzer,14,13,2024-06-25,6,8,0,3
Moussa Maâzou,4,2,2015-10-13,2,2,0,1
Johan Djourou,2,2,2017-10-10,2,0,1,1
Pajtim Kasami,1,1,2015-10-09,1,0,0,0
Breel Embolo,13,12,2024-07-06,5,8,0,1
Laurent Depoitre,1,1,2015-10-10,0,1,0,0
Stephan El Shaarawy,3,3,2023-11-17,1,2,0,0
Matteo Darmian,2,2,2023-11-17,1,1,0,0
Milan Đurić,2,2,2015-10-13,1,1,0,0
Léger Djimrangar,2,2,2015-10-13,1,1,0,0
Hakan Çalhanoğlu,12,12,2024-06-26,5,7,0,3
Galabgwe Moyana,1,1,2015-10-10,0,1,0,0
Joel Mogorosi,3,3,2015-11-14,2,1,0,0
Jason Demetriou,1,1,2015-10-10,0,1,0,0
Islambek Kuat,6,6,2021-09-07,3,3,0,0
Michael Rabeson,1,1,2015-10-10,1,0,0,0
Njiva Rakotoharimalala,4,4,2021-10-10,3,1,0,0
Johann Paul,1,1,2015-10-10,1,0,0,0
Alexander Søderlund,2,2,2017-06-10,2,0,0,1
Kamo Hovhannisyan,3,3,2021-10-08,0,3,1,0
Berat Djimsiti,2,2,2018-09-10,1,1,1,0
Dawit Fekadu,2,2,2015-11-14,2,0,0,0
Gatoch Panom,1,1,2015-10-11,1,0,0,1
Ramkel Lok,1,1,2015-10-11,1,0,0,0
Constantin Budescu,4,2,2017-10-05,2,2,0,1
Craig Cathcart,1,1,2015-10-11,0,1,0,0
Paulus Arajuuri,3,3,2017-10-09,3,0,0,0
Chris Martin,3,3,2017-03-26,1,2,0,0
Kostas Stafylidis,2,2,2016-10-10,1,1,0,0
Gergő Lovrencsics,1,1,2015-10-11,0,1,0,0
Panagiotis Tachtsidis,1,1,2015-10-11,1,0,0,0
Panagiotis Kone,1,1,2015-10-11,1,0,0,0
Mario Mutsch,1,1,2015-10-12,1,0,0,0
Oleg Kuzmin,1,1,2015-10-12,1,0,0,0
Mario Gaspar Pérez,1,1,2015-10-12,0,1,0,0
Henok Goitom,1,1,2015-10-13,0,1,0,0
Willian,5,4,2019-06-22,3,2,0,0
Christian Santos,1,1,2015-10-13,0,1,0,0
Mihail Aleksandrov,2,2,2016-10-07,1,1,0,1
Ibraime Cassamá,1,1,2015-10-13,1,0,0,0
Vitalij Lux,5,3,2019-01-16,4,1,0,0
Ildar Amirov,2,2,2015-11-12,2,0,1,0
Mohamed M'Changama,1,1,2015-10-13,0,1,0,0
Eudes Dagoulou,1,1,2015-10-13,0,1,0,0
Anicet Abel,2,2,2019-06-22,1,1,0,0
Demba Malick,1,1,2015-10-13,0,1,0,0
Bessam,1,1,2015-10-13,1,0,0,0
Moussa Samba,1,1,2015-10-13,1,0,0,0
Ismaël Diakité,1,1,2015-10-13,1,0,0,0
Suan Lam Mang,3,2,2019-11-14,3,0,0,0
Kyaw Ko Ko,1,1,2015-10-13,1,0,0,0
Aung Thu,3,3,2019-11-14,2,1,0,0
Pa Dibba,1,1,2015-10-13,0,1,0,0
Hendrik Somaeb,1,1,2015-10-13,1,0,0,0
Josef Šural,1,1,2015-10-13,0,1,0,0
Alhaji Kamara,2,2,2022-01-16,1,1,0,0
Abdul Sesay,1,1,2015-10-13,1,0,0,0
Faris Ramli,2,2,2019-09-05,2,0,0,0
Sos Suhana,1,1,2015-10-13,0,1,0,0
Norlla Amiri,2,2,2015-11-12,1,1,0,0
Faysal Shayesteh,1,1,2015-10-13,0,1,0,0
Diego Rolán,2,2,2016-11-10,2,0,0,0
Kroekrit Thaweekarn,1,1,2015-10-13,0,1,0,0
Mohamed Liban,1,1,2015-10-17,0,1,0,0
Hélder Pelembe,1,1,2015-11-11,1,0,0,0
Winston Kalengo,2,2,2015-11-15,1,1,0,0
Khaibar Amani,2,2,2016-03-29,2,0,0,0
Rodrigo Ramallo,3,2,2021-10-14,3,0,0,0
Mario Rondón,1,1,2015-11-12,0,1,0,0
Richard José Blanco,1,1,2015-11-12,0,1,0,0
Firmin Ndombe Mubele,5,4,2017-10-07,1,4,0,0
Mei Fang,1,1,2015-11-12,1,0,0,0
Wang Yongpo,2,1,2015-11-12,2,0,0,0
Zhang Xizhe,2,2,2021-06-15,2,0,0,0
Fidel Martínez,2,2,2015-11-17,1,1,0,0
Robin Singh,1,1,2015-11-12,1,0,0,0
Saeid Ezatolahi,1,1,2015-11-12,1,0,0,0
Youssef Mohamad,1,1,2015-11-12,1,0,0,0
Hassan Chaito,2,1,2015-11-12,2,0,0,0
Joan Oumari,3,2,2021-06-05,3,0,0,0
Yacine Bammou,1,1,2015-11-12,1,0,0,0
Naby Keïta,5,5,2022-01-18,3,2,0,0
László Kleinheisler,3,3,2021-03-31,1,2,0,0
Jonathan Cantillana,3,2,2016-03-29,3,0,0,0
Ahmad Abu Nahyeh,3,1,2015-11-12,3,0,0,0
Ahmed Al-Sarori,2,2,2015-11-17,1,1,0,0
Mu Kanazaki,2,2,2016-03-24,1,1,0,0
Yaki Yen,1,1,2015-11-12,0,1,0,0
Hung Kai-chun,1,1,2015-11-12,0,1,0,0
Adisak Kraisorn,3,3,2021-06-03,2,1,0,0
Tana Chanabut,2,2,2016-10-06,1,1,0,0
Farouk Miya,5,4,2017-01-25,4,1,0,0
Dawood Ali,1,1,2015-11-12,1,0,0,0
Ahmed Al Hashmi,1,1,2015-11-12,1,0,0,0
Gelson,1,1,2015-11-13,1,0,0,0
Thamsanqa Gabuza,1,1,2015-11-13,0,1,0,0
Andile Jali,2,2,2017-09-05,1,1,0,1
Lucas Lima,2,2,2016-06-08,1,1,0,0
Robbie Brady,5,5,2022-09-27,2,3,0,2
Carlos Mejía,2,2,2023-07-04,1,1,0,0
Armando Cooper,3,3,2021-06-05,2,1,0,0
Wes Morgan,1,1,2015-11-13,0,1,1,0
Gohi Bi Zoro Cyriac,1,1,2015-11-13,0,1,0,0
Oumar N'Diaye,1,1,2015-11-13,1,0,0,0
Héctor Herrera,5,5,2021-11-16,4,1,0,0
Vincent Aboubakar,17,14,2022-12-02,13,4,0,5
Edgar Salli,1,1,2015-11-13,0,1,0,0
Bobby Wood,6,6,2017-10-06,4,2,0,0
Fabian Johnson,1,1,2015-11-13,1,0,0,0
Geoff Cameron,2,2,2016-03-29,2,0,0,0
Tapiwa Gadibolae,1,1,2015-11-14,1,0,0,0
Samba Sow,1,1,2015-11-14,0,1,0,0
Ezechiel N'Douassel,2,2,2019-09-05,2,0,0,1
Delvin N'Dinga,1,1,2015-11-14,0,1,0,0
Hardy Binguila,1,1,2015-11-14,0,1,0,0
Emil Forsberg,18,16,2023-11-19,14,4,0,5
Nicolai Jørgensen,4,4,2018-11-16,1,3,0,0
Elias Maguri,1,1,2015-11-14,1,0,0,0
Rui da Gracia,1,1,2015-11-15,1,0,0,0
Idrissa Sylla,1,1,2015-11-15,1,0,0,0
Lubambo Musonda,1,1,2015-11-15,1,0,0,0
Renato Augusto,6,5,2018-07-06,5,1,0,0
Filipe Luís,2,2,2016-10-06,2,0,0,0
Bertrand Traoré,7,7,2024-01-30,4,3,0,3
Lucas Biglia,1,1,2015-11-17,0,1,0,0
Jannik Vestergaard,1,1,2015-11-17,1,0,0,0
Mohamed Elneny,3,3,2021-11-12,2,1,0,0
Abdallah El Said,4,4,2017-01-21,3,1,0,0
Ahmed Hassan Mahgoub,2,1,2015-11-17,2,0,0,0
Kamal Kamyabinia,1,1,2015-11-17,0,1,0,0
Ramin Rezaeian,2,2,2022-11-25,0,2,0,0
Clayton Donaldson,1,1,2015-11-17,0,1,0,0
Jürgen Damm,1,1,2015-11-17,0,1,0,0
Giovanni Sio,2,1,2015-11-17,2,0,0,0
Jean Seri,1,1,2015-11-17,1,0,0,0
Omar Abdulrahman,2,2,2016-03-29,1,1,0,0
Baddrol Bakhtiar,1,1,2015-11-17,1,0,0,0
Moses Simon,3,3,2022-01-15,2,1,0,0
Efe Ambrose,1,1,2015-11-17,1,0,0,0
Yasmani Duk,1,1,2015-11-17,0,1,0,0
Darío Lezcano,4,3,2016-03-29,2,2,0,0
Mohamed El Monir,2,1,2015-11-17,0,2,0,0
Jacques Tuyisenge,3,2,2019-09-10,3,0,0,0
Mohamed Al Ghanodi,1,1,2015-11-17,0,1,0,0
Gerson Tinoco,2,2,2016-09-06,1,1,0,0
Cheikhou Kouyaté,2,2,2022-01-30,2,0,0,0
Moussa Konaté,1,1,2015-11-17,1,0,0,0
Manucho Diniz,1,1,2015-11-17,1,0,1,0
Syam Ben Youssef,1,1,2015-11-17,1,0,0,0
Cheikh Moulaye Ahmed,1,1,2015-11-17,0,1,0,0
Saad Bguir,1,1,2015-11-17,1,0,0,0
Süleýman Muhadow,1,1,2015-11-17,1,0,0,0
Mohammed Al-Ghassani,1,1,2015-11-17,0,1,0,0
Josef Martínez,8,6,2022-02-01,5,3,0,0
Azizbek Haydarov,1,1,2015-11-17,0,1,0,0
Stanislav Andreev,1,1,2015-11-17,0,1,0,0
Mohamed Al-Romaihi,4,4,2021-06-03,2,2,0,0
Carlos Bacca,5,4,2016-06-25,3,2,0,0
Gabriel Mercado,3,3,2018-06-30,1,2,0,0
Jiang Ning,3,1,2016-03-24,3,0,0,0
Ángel Mena,5,5,2021-06-27,3,2,0,0
Alireza Jahanbakhsh,10,10,2024-02-07,7,3,0,3
Mahdi Kamel,2,2,2017-06-13,2,0,0,0
Sharif Mukhammad,1,1,2016-03-24,1,0,1,0
Baha' Faisal,7,5,2021-06-07,4,3,0,1
Yousef Al-Naber,1,1,2016-03-24,1,0,0,0
Ahmed Samir,2,2,2019-09-05,1,1,0,1
Mikel Villanueva,2,2,2017-03-23,1,1,0,0
Raúl Ruidíaz,2,2,2016-06-12,1,1,0,0
Lee Jeong-hyeop,1,1,2016-03-24,1,0,0,0
Ahmad Kallasi,1,1,2016-03-24,1,0,0,0
Leng Makara,1,1,2016-03-24,1,0,1,0
Nguyễn Văn Toàn,2,1,2016-03-24,2,0,0,0
Hirving Lozano,7,7,2021-10-10,4,3,0,0
Alberth Elis,7,7,2023-06-29,2,5,0,0
Pablo Punyed,1,1,2016-03-25,1,0,0,0
Anthony Lozano,3,3,2019-06-17,1,2,0,0
Rafael Morales,2,2,2016-09-06,2,0,0,0
Je-Vaughn Watson,3,3,2017-07-26,2,1,1,0
Levi García,3,2,2021-03-25,1,2,0,0
Josef Shirdel,1,1,2016-03-29,1,0,0,0
Huang Bowen,1,1,2016-03-29,1,0,0,0
Sebastián Pérez Cardona,1,1,2016-03-29,1,0,0,0
Michael Arroyo,2,2,2016-06-16,0,2,0,0
Johan Venegas,4,4,2017-10-10,2,2,0,0
Romell Quioto,10,9,2021-11-16,6,4,0,0
Sandesh Jhingan,1,1,2016-03-29,1,0,0,0
Serdaraly Ataýew,1,1,2016-03-29,0,1,0,0
Mohannad Abdul-Raheem,6,3,2016-10-11,6,0,0,0
Hamdi Al Masri,1,1,2016-03-29,1,0,1,0
Genki Haraguchi,9,9,2019-11-14,3,6,0,1
Hilal El-Helwe,6,4,2019-10-15,4,2,0,1
Asadhulla Abdulla,1,1,2016-03-29,1,0,0,0
Ahmed Niyaz,1,1,2016-03-29,1,0,0,0
Yashir Pinto,2,1,2016-03-29,2,0,0,0
Ahmed Awad,1,1,2016-03-29,1,0,0,0
Abdelatif Bahdari,1,1,2016-03-29,1,0,0,0
So Kyong-jin,1,1,2016-03-29,0,1,0,0
Manuel Ott,1,1,2016-03-29,1,0,0,0
Trevin Caesar,2,1,2016-03-29,2,0,0,0
Themistoklis Tzimopoulos,1,1,2016-05-28,1,0,0,0
Jerry Donga,2,2,2017-06-13,0,2,0,0
Nerijus Valskis,1,1,2016-05-29,1,0,0,0
Tommy Semmy,5,5,2024-06-22,2,3,0,0
Jean-Philippe Saïko,2,2,2022-03-24,0,2,0,0
Artjoms Rudņevs,1,1,2016-06-01,1,0,0,0
Kevin Nemia,1,1,2016-06-01,1,0,0,0
César Zeoula,1,1,2016-06-01,1,0,0,1
Jean-Brice Wadriako,1,1,2016-06-01,1,0,0,0
Joerisse Cexome,1,1,2016-06-01,1,0,0,0
Brice Dahité,1,1,2016-06-01,1,0,0,1
Raymond Gunemba,7,4,2017-06-13,6,1,0,0
Cristián Zapata,1,1,2016-06-03,0,1,0,0
Dominique Fred,1,1,2016-06-04,0,1,0,0
Fenedy Masauvakalo,1,1,2016-06-04,0,1,0,0
Samuela Kautoga,1,1,2016-06-04,1,0,0,0
Luke Adams,1,1,2016-06-04,1,0,0,0
Michael Foster,4,3,2017-06-09,3,1,0,0
Nigel Dabinyaba,4,3,2017-03-23,4,0,0,0
Koriak Upaiga,1,1,2016-06-05,1,0,0,0
José Pedro Fuenzalida,3,3,2019-06-21,0,3,0,0
Víctor Ayala,1,1,2016-06-07,0,1,0,0
Philippe Coutinho,14,11,2022-03-24,14,0,0,2
Gabriel Barbosa,4,4,2021-10-14,3,1,0,1
Edison Flores,10,10,2022-02-01,3,7,0,0
Judd Molea,1,1,2016-06-08,0,1,0,0
Nicolás Otamendi,2,2,2016-09-06,1,1,0,0
Dimitri Payet,5,5,2016-11-11,5,0,0,0
Frank Fabra,2,1,2016-06-11,1,1,1,0
Marlos Moreno,1,1,2016-06-11,1,0,0,0
Eric Dier,2,2,2017-09-04,2,0,0,0
Ondrej Duda,10,8,2024-06-26,6,4,0,2
Shkodran Mustafi,2,2,2017-06-10,2,0,0,0
José Manuel Velázquez,1,1,2016-06-13,0,1,0,0
Ciaran Clark,1,1,2016-06-13,0,1,1,0
Mathías Corujo,1,1,2016-06-13,1,0,0,0
Erik Lamela,2,2,2016-06-18,2,0,0,0
Víctor Cuesta,1,1,2016-06-14,1,0,0,0
Miguel Camargo,3,3,2021-06-05,1,2,0,0
Abdiel Arroyo,5,5,2019-06-22,3,2,0,0
Antoine Griezmann,29,25,2023-03-24,22,7,0,7
Jamie Vardy,2,2,2017-03-26,2,0,0,0
Nolito,2,2,2016-10-09,1,1,0,0
Birkir Már Sævarsson,3,3,2021-03-31,1,2,1,0
Edson Puch,2,1,2016-06-18,0,2,0,0
Neil Taylor,1,1,2016-06-20,0,1,0,0
Ozan Tufan,7,6,2021-03-27,3,4,0,0
Alessandro Schöpf,2,2,2020-10-14,0,2,0,0
Arnór Ingvi Traustason,2,2,2024-03-21,1,1,0,0
Jérôme Boateng,1,1,2016-06-26,1,0,0,0
Julian Draxler,5,5,2017-09-04,4,1,0,1
Toby Alderweireld,4,4,2019-10-10,2,2,0,0
Yannick Carrasco,8,8,2023-09-09,4,4,0,0
Renato Sanches,2,2,2021-11-14,1,1,0,0
Eder,1,1,2016-07-10,0,1,0,0
Gabriel Jesus,9,7,2019-07-07,5,4,0,0
Óscar Romero,1,1,2016-09-01,1,0,0,0
Ángel Sepúlveda,2,2,2017-07-16,0,2,0,0
Manjrekar James,1,1,2016-09-02,0,1,0,0
Matt Besler,1,1,2016-09-02,0,1,0,0
Christian Pulisic,17,12,2024-06-23,13,4,0,2
Sacha Kljestan,2,2,2016-09-06,1,1,0,0
Vykintas Slivka,3,3,2022-09-22,2,1,0,0
Joshua Kimmich,4,4,2022-06-14,1,3,0,0
Adrian Popa,2,2,2016-10-08,1,1,0,0
Ruslan Qurbanov,1,1,2016-09-04,0,1,0,0
Adam Lallana,2,2,2016-11-11,1,1,0,0
Ezgjan Alioski,11,11,2021-11-14,6,5,0,4
Valon Berisha,4,3,2022-06-02,0,4,0,1
Martin Hinteregger,4,4,2019-10-10,2,2,1,0
Jano Ananidze,1,1,2016-09-05,1,0,0,0
Ciro Immobile,15,13,2023-09-09,7,8,0,2
Jeff Hendrick,2,2,2019-03-23,0,2,0,0
Filip Kostić,3,3,2021-03-27,2,1,0,0
Daryl Murphy,3,2,2017-10-06,2,1,0,0
Sergi Roberto,1,1,2016-09-05,1,0,0,0
Vitolo,4,4,2017-03-24,3,1,0,0
Joe Allen,2,2,2016-10-06,1,1,0,0
Miranda,1,1,2016-09-06,1,0,0,0
Marquinhos,4,4,2021-10-07,2,2,1,0
Marcelo Nascimento da Costa,1,1,2016-09-06,1,0,0,0
Florian Bohnert,1,1,2016-09-06,0,1,0,0
Nikolas Ledgerwood,1,1,2016-09-06,1,0,0,0
Rónald Matarrita,2,2,2016-11-11,1,1,0,0
Liam Walker,3,3,2022-06-09,3,0,0,1
Scott Wiseman,1,1,2016-09-06,0,1,1,0
Kostas Fortounis,6,6,2020-11-15,1,5,0,1
Jairo Arreola,1,1,2016-09-06,1,0,0,0
Jean Márquez,1,1,2016-09-06,1,0,0,0
Nazir McBurnette,1,1,2016-09-06,0,1,0,0
Gabriel Achilier,1,1,2016-09-06,0,1,0,0
Renato Tapia,4,4,2021-09-02,4,0,1,0
Egor Krimets,1,1,2016-09-06,0,1,0,0
Takuma Asano,6,6,2022-11-23,3,3,0,0
Paul Arriola,4,4,2022-03-27,4,0,0,0
Juanpi,1,1,2016-09-06,1,0,0,0
Lucas Pratto,2,2,2016-11-15,1,1,0,0
Kevin Wimmer,1,1,2016-10-06,0,1,1,0
Cristian Ramírez,1,1,2016-10-06,1,0,0,0
Robin Lod,4,4,2023-11-17,1,3,0,0
Saad Abdul-Amir,2,2,2017-08-31,0,2,0,1
Hotaru Yamaguchi,1,1,2016-10-06,1,0,0,0
Matej Mitrović,1,1,2016-10-06,0,1,0,0
Peter Jehle,1,1,2016-10-06,0,1,1,0
Ilija Nestorovski,9,7,2021-03-28,6,3,0,2
Ramiro Funes Mori,1,1,2016-10-06,0,1,0,0
Séamus Coleman,1,1,2016-10-06,1,0,0,0
Mattias Käit,8,6,2021-09-02,7,1,0,0
Sergei Mošnikov,1,1,2016-10-07,1,0,0,0
Kevin Gameiro,2,1,2016-10-07,2,0,0,0
Petros Mantalos,5,5,2022-09-27,5,0,0,0
Ricardo Rodríguez,6,6,2019-09-08,2,4,0,4
Sonni Nattestad,2,2,2021-03-28,0,2,0,0
Quincy Promes,5,4,2019-06-06,3,2,0,0
Alexei Rios,1,1,2016-10-07,0,1,0,0
Davy Klaassen,7,7,2022-11-21,3,4,0,0
Vincent Janssen,2,2,2017-06-09,2,0,0,1
João Cancelo,8,8,2023-11-16,5,3,0,0
André Silva,15,13,2021-09-07,6,9,0,0
Răzvan Marin,4,4,2024-06-26,2,2,0,2
Nicolae Stanciu,8,8,2024-06-17,5,3,0,1
Maksim Medvedev,3,3,2021-03-24,2,1,1,0
Banou Diawara,2,2,2017-11-14,2,0,0,0
Jonathan Bolingi,3,3,2019-06-30,2,1,0,1
Dele Alli,2,2,2018-07-07,1,1,0,0
Jonathan Kodjia,3,3,2019-07-11,3,0,0,0
Salif Coulibaly,1,1,2016-10-08,1,0,1,0
Nikola Vukčević,1,1,2016-10-08,1,0,0,0
Keita Baldé,3,3,2021-10-09,3,0,0,0
Rok Kronaveter,1,1,2016-10-08,1,0,0,0
Theódór Elmar Bjarnason,1,1,2016-10-09,1,0,0,0
Maximilian Göppel,3,3,2021-11-11,1,2,2,0
Andrea Belotti,10,8,2021-03-28,1,9,0,1
Ferhan Hasani,1,1,2016-10-09,1,0,0,0
Aymen Abdennour,1,1,2016-10-09,1,0,0,0
Änis Ben-Hatira,1,1,2016-10-09,1,0,0,0
Alex Iwobi,3,3,2019-07-06,2,1,0,0
Kelechi Iheanacho,5,4,2022-01-11,4,1,0,0
Alexandre Martínez Palau,1,1,2016-10-10,1,0,0,0
Pavel Savitsky,4,4,2022-09-22,3,1,0,0
Ádám Gyurcsó,2,2,2016-11-13,1,1,0,0
Oscar Hiljemark,1,1,2016-10-10,1,0,0,0
Victor Lindelöf,3,3,2019-09-05,2,1,0,0
Yerry Mina,6,6,2021-06-20,2,4,1,0
Mattia Stefanelli,2,2,2016-11-11,0,2,1,0
Adama Diomande,1,1,2016-10-11,1,0,0,0
Martin Samuelsen,1,1,2016-10-11,1,0,0,0
Otabek Shukurov,2,2,2019-11-14,2,0,0,1
Christian Ramos,2,2,2017-11-15,1,1,0,0
Sebastián Coates,1,1,2016-11-10,1,0,0,0
Jacobo Kouffati,1,1,2016-11-10,1,0,0,0
Damir Kojašević,1,1,2016-11-11,0,1,0,0
Artak Grigoryan,1,1,2016-11-11,1,0,0,0
Varazdat Haroyan,2,2,2021-03-31,2,0,0,0
Michael Krmenčík,6,5,2020-09-04,3,3,0,0
Jaromír Zmrhal,1,1,2016-11-11,1,0,0,0
Gafurzhan Suyumbayev,4,4,2019-11-16,2,2,0,0
Peter Ankersen,1,1,2016-11-11,1,0,0,0
Fidel Escobar,2,2,2023-07-04,1,1,0,0
Benjamin Verbič,6,5,2023-11-20,5,1,0,0
Conor McLaughlin,1,1,2016-11-11,1,0,0,0
Serge Gnabry,18,12,2022-12-01,10,8,0,0
Jonas Hector,2,1,2016-11-11,0,2,0,0
Kevin Volland,1,1,2016-11-11,0,1,0,0
Miguel Layún,1,1,2016-11-11,0,1,0,0
Dan Einbinder,1,1,2016-11-12,0,1,0,0
Eliran Atar,1,1,2016-11-12,0,1,0,0
Issoufou Dayo,5,5,2021-11-16,3,2,0,2
Darko Velkovski,5,5,2021-10-08,2,3,2,0
Nacho Monreal,1,1,2016-11-12,1,0,0,0
Aritz Aduriz,1,1,2016-11-12,1,0,0,0
Volkan Şen,2,2,2017-06-11,1,1,0,0
Thomas Meunier,8,6,2021-06-12,5,3,0,0
Konstantinos Laifis,2,2,2019-03-21,2,0,0,0
Pieros Sotiriou,11,10,2022-03-29,9,2,0,2
Valentinos Sielis,1,1,2016-11-13,1,0,0,0
Georgios Tzavellas,1,1,2016-11-13,1,0,0,0
Neeskens Kebano,3,3,2017-11-11,1,2,0,0
Ádám Lang,1,1,2016-11-13,1,0,0,0
Maxime Chanot,5,5,2023-09-08,4,1,2,2
William Carvalho,5,5,2022-06-05,3,2,0,0
Emmanuel Poila,1,1,2016-11-13,1,0,0,0
Arturo Mina,2,2,2019-06-16,2,0,1,0
Emilio Izaguirre,2,2,2019-06-25,2,0,0,0
Carlyle Mitchell,2,2,2017-09-05,1,1,1,0
Eddie Hernández,2,2,2017-10-07,1,1,0,0
Omar Hawsawi,1,1,2016-11-15,0,1,0,0
Juary Soares,1,1,2017-01-14,0,1,0,0
Kudakwashe Mahachi,3,3,2022-01-18,2,1,0,0
Nyasha Mushekwi,1,1,2017-01-15,0,1,0,1
Junior Kabananga,3,3,2017-01-24,1,2,0,0
Piqueti,3,2,2021-09-07,0,3,0,0
Sébastien Siani,1,1,2017-01-18,1,0,0,0
Michael Ngadeu-Ngadjui,4,4,2021-10-11,3,1,0,0
Aïssa Mandi,2,2,2021-10-12,0,2,1,0
Naïm Sliti,3,3,2019-07-11,0,3,0,1
Sofiane Hanni,1,1,2017-01-19,1,0,0,0
Henri Saivet,1,1,2017-01-19,1,0,0,0
Serey Dié,2,2,2019-07-01,1,1,0,0
Mathieu Dossevi,1,1,2017-01-20,0,1,0,0
Aziz Bouhaddouz,2,2,2018-06-15,1,1,1,0
Romain Saïss,3,3,2024-01-17,2,1,0,0
Youssef En-Nesyri,8,8,2024-01-17,6,2,0,0
Rudinilson Silva,1,1,2017-01-22,0,1,1,0
Papakouli Diop,1,1,2017-01-23,1,0,0,0
Taha Yassine Khenissi,2,2,2019-07-08,0,2,0,0
Tendai Ndoro,1,1,2017-01-23,1,0,0,0
Rachid Alioui,1,1,2017-01-24,1,0,0,0
Kodjo Fo-Doh Laba,2,2,2019-09-06,1,1,0,0
Paul-José M'Poku,3,3,2017-09-05,2,1,0,0
Yves Bissouma,1,1,2017-01-25,0,1,0,0
Kahraba,1,1,2017-01-29,1,0,0,0
Christian Bassogog,3,2,2021-11-13,1,2,0,0
Nicolas Nkoulou,1,1,2017-02-05,0,1,0,0
Sylvain Graglia,2,1,2017-03-23,0,2,0,0
Bruno Valdez,1,1,2017-03-23,1,0,0,0
Júnior Alonso,2,2,2021-07-02,1,1,0,0
Tanaboon Kesarat,1,1,2017-03-23,0,1,1,0
Salman Al-Moasher,1,1,2017-03-23,0,1,0,0
Yuya Kubo,2,2,2017-03-28,1,1,0,0
Nika Kacharava,3,3,2020-10-11,1,2,0,0
Mijat Gaćinović,2,2,2017-09-02,1,1,0,0
Björn Bergmann Sigurðarson,1,1,2017-03-24,0,1,0,0
Atdhe Nuhiu,3,3,2019-11-14,2,1,0,0
Boban Nikolov,4,4,2022-06-05,1,3,0,0
Cenk Tosun,14,9,2024-06-26,9,5,0,1
Sebastian Lletget,2,2,2021-09-08,1,1,0,0
Spas Delev,3,2,2023-11-16,3,0,0,0
Isaac Kiese Thelin,2,2,2018-09-10,2,0,0,0
Jean Paul Farrugia,1,1,2017-03-26,1,0,0,0
Ján Greguš,2,2,2020-11-15,1,1,0,0
Stefan Mugoša,12,9,2022-06-14,4,8,0,1
Conor Washington,4,4,2021-10-12,1,3,0,1
Antonín Barák,5,4,2021-09-02,1,4,0,0
Jackson Irvine,7,6,2024-01-18,2,5,0,0
Kendall Waston,4,4,2023-07-04,2,2,0,0
Ryan Thomas,3,2,2017-09-01,3,0,0,0
Carlos Andrés Sánchez,1,1,2017-03-28,0,1,0,0
Hong Jeong-ho,1,1,2017-03-28,1,0,0,0
Patrick Aisa,2,2,2017-06-09,0,2,0,0
Tauhiti Keck,1,1,2017-03-28,1,0,0,0
Diego Reyes,1,1,2017-03-28,0,1,0,0
Mone Wamowe,2,1,2017-06-07,0,2,0,0
Saula Waqa,1,1,2017-06-07,1,0,0,0
Oswaldo Alanís,1,1,2017-06-08,1,0,0,0
Marc Rebés,2,2,2020-11-14,1,1,0,0
Mikhail Sivakow,1,1,2017-06-09,1,0,0,1
Georgi Kostadinov,3,3,2017-09-03,1,2,0,0
Roy Chipolina,3,3,2022-09-23,1,2,1,0
Anthony Hernandez,1,1,2017-06-09,1,0,0,0
Atkin Kaua,2,2,2022-03-17,1,1,0,0
Micah Lea'alafa,2,2,2017-09-05,2,0,0,1
Stuart Dallas,2,2,2020-10-14,1,1,1,0
Sandro Wagner,5,3,2017-10-08,4,1,0,0
Amin Younes,2,2,2017-06-29,2,0,0,0
Julian Brandt,2,2,2019-11-19,2,0,0,0
Kasper Dolberg,9,6,2022-09-25,5,4,0,1
Ruslan Koryan,2,2,2017-09-04,1,1,0,0
Leigh Griffiths,4,3,2017-10-08,3,1,0,0
Artem Besyedin,2,2,2019-11-17,0,2,0,0
Ledian Memushaj,1,1,2017-06-11,0,1,0,0
Lorenzo Insigne,6,6,2021-07-02,3,3,0,0
Federico Bernardeschi,3,3,2019-10-15,2,1,0,0
Manolo Gabbiadini,1,1,2017-06-11,1,0,0,0
Amir Rrahmani,5,5,2023-09-09,3,2,1,0
Cengiz Ünder,8,8,2023-06-16,5,3,0,1
Radu Gînsari,4,3,2018-11-18,4,0,0,1
Giorgi Merebashvili,2,2,2018-11-19,1,1,0,0
Emile Ounei,1,1,2017-06-11,1,0,0,1
Epeli Saukuru,1,1,2017-06-11,0,1,0,0
Richard Sele,1,1,2017-06-11,1,0,0,0
Stefan Ristovski,2,2,2020-09-08,1,1,0,0
Francisco Calvo,4,4,2024-07-02,4,0,0,0
Yuya Osako,16,8,2022-01-27,11,5,0,3
Hwang Hee-chan,7,7,2024-02-02,5,2,0,2
Ahmad Al Saleh,1,1,2017-06-13,1,0,0,0
Michael Boxall,1,1,2017-06-17,1,0,1,0
Cédric Soares,1,1,2017-06-18,1,0,0,0
Lars Stindl,3,3,2017-07-02,1,2,0,0
Leon Goretzka,13,10,2021-06-23,11,2,0,0
André-Frank Zambo Anguissa,3,3,2021-11-13,1,2,0,0
Bernardo Silva,11,11,2024-06-22,5,6,0,0
Martín Rodríguez,1,1,2017-06-25,1,0,0,0
Kerem Demirbay,1,1,2017-06-25,1,0,0,0
Timo Werner,20,15,2022-06-14,14,6,0,0
Luís Neto,1,1,2017-07-02,0,1,1,0
Adrien Silva,1,1,2017-07-02,1,0,0,1
Dejan Jakovic,1,1,2017-07-07,0,1,0,0
Scott Arfield,2,2,2019-06-15,1,1,0,0
Alphonso Davies,9,7,2022-11-27,2,7,0,1
Roy Contout,1,1,2017-07-07,1,0,0,0
Sloan Privat,1,1,2017-07-07,1,0,0,0
Steeven Langil,1,1,2017-07-08,1,0,0,0
Dom Dwyer,1,1,2017-07-08,1,0,0,0
Romario Williams,2,2,2017-07-20,1,1,0,0
Hedgardo Marín,1,1,2017-07-09,1,0,0,0
Elías Hernández,1,1,2017-07-09,1,0,0,0
Orbelín Pineda,7,7,2023-07-08,5,2,0,3
Ismael Díaz,5,3,2023-07-08,5,0,0,0
Jordan Morris,3,2,2017-07-26,3,0,0,0
Gerson Mayen,3,3,2021-06-15,3,0,0,0
Ariel Francisco Rodríguez,1,1,2017-07-14,1,0,0,0
Rodney Wallace,1,1,2017-07-14,1,0,0,0
Michael Amir Murillo,4,4,2024-06-23,2,2,1,0
Kelyn Rowe,1,1,2017-07-15,1,0,0,0
Matt Miazga,1,1,2017-07-15,1,0,0,0
Edson Álvarez,3,3,2022-03-27,0,3,1,0
Aníbal Godoy,4,4,2022-03-27,3,1,1,0
Eric Lichaj,1,1,2017-07-19,1,0,0,0
Shaun Francis,1,1,2017-07-20,1,0,0,0
Junior Hoilett,9,9,2023-07-04,5,4,0,3
Rodolfo Pizarro,1,1,2017-07-20,1,0,0,0
Kemar Lawrence,1,1,2017-07-23,0,1,0,0
Ivaylo Chochev,3,3,2021-09-05,2,1,0,0
Víctor Cáceres,1,1,2017-08-31,0,1,0,0
Toni Šunjić,1,1,2017-08-31,0,1,0,0
Thomas Lemar,2,1,2017-08-31,2,0,0,0
Kylian Mbappé,38,26,2024-06-25,24,14,0,7
Demba Camara,1,1,2017-08-31,1,0,0,0
Motasem Sabbou,1,1,2017-08-31,0,1,0,0
Akram Zuway,1,1,2017-08-31,0,1,0,0
Alkhaly Bangoura,1,1,2017-08-31,1,0,0,0
Tamás Kádár,1,1,2017-08-31,1,0,0,0
Gints Freimanis,1,1,2017-08-31,0,1,0,0
Yosuke Ideguchi,1,1,2017-08-31,1,0,0,0
Gilbert Álvarez,1,1,2017-08-31,0,1,0,0
Nélson Oliveira,1,1,2017-08-31,1,0,0,0
Ahmad Ibrahim Khalaf,2,2,2019-10-15,1,1,1,0
Nuno Miguel Monteiro Rocha,2,1,2017-09-01,2,0,0,1
Thomas Delaney,8,6,2023-11-17,3,5,0,0
Thomas Partey,7,6,2022-03-29,2,5,0,0
Marko Vešović,2,2,2019-03-25,1,1,0,0
Marko Simić,2,2,2021-03-27,1,1,0,0
Stuart Armstrong,5,4,2023-11-19,2,3,0,0
Andrew Robertson,2,2,2019-06-08,1,1,0,0
Ryan Bertrand,1,1,2017-09-01,0,1,0,0
Hakim Ziyech,4,3,2024-01-24,2,2,0,1
Khalid Boutaïb,5,3,2018-06-25,4,1,0,0
Achraf Hakimi,6,6,2024-01-21,5,1,0,0
Fayçal Fajr,1,1,2017-09-01,1,0,0,0
Mimoun Mahi,1,1,2017-09-01,1,0,0,0
Odion Ighalo,6,5,2019-07-17,4,2,0,1
Miha Mevlja,2,2,2021-11-11,1,1,1,0
Alexander López,3,3,2021-09-02,0,3,0,1
Yassine Meriah,2,2,2018-06-28,2,0,1,1
Cédric Bakambu,5,4,2019-07-07,0,5,0,1
Ghailene Chaalali,1,1,2017-09-01,1,0,0,0
Ansi Agolli,1,1,2017-09-02,1,0,0,0
Domagoj Vida,2,2,2018-07-07,1,1,0,0
Alexander Ring,1,1,2017-09-02,1,0,0,0
Shane Duffy,6,6,2021-11-14,2,4,0,0
Ben Woodburn,1,1,2017-09-02,1,0,0,0
Brian Mwila,3,2,2017-11-11,3,0,0,0
Enock Mwepu,2,2,2021-09-03,1,1,0,0
Christoffer Nyman,1,1,2017-09-03,0,1,0,0
Gilli Rólantsson,1,1,2017-09-03,1,0,0,0
Kenan Kodro,1,1,2017-09-03,0,1,0,0
Zeca,2,2,2019-06-11,2,0,0,0
Davy Pröpper,3,2,2017-10-07,2,1,0,0
Afran Ismayilov,3,2,2017-10-05,3,0,0,1
Araz Abdullayev,2,2,2018-10-14,2,0,0,0
Michele Cevoli,2,2,2019-06-08,2,0,2,0
Mirko Palazzi,1,1,2017-09-04,0,1,0,0
Stanislav Lobotka,3,3,2023-10-13,0,3,0,0
Marcus Rashford,13,12,2023-10-17,8,5,0,2
Hamdou Elhouni,1,1,2017-09-04,1,0,0,0
Christophe Berra,1,1,2017-09-04,1,0,0,0
Patson Daka,4,4,2024-01-21,3,1,0,0
Jhon Murillo,1,1,2017-09-05,0,1,0,0
Rolf Feltscher,1,1,2017-09-05,1,0,1,0
Valerian Gvilia,3,3,2019-06-07,1,2,0,0
Louis Schaub,6,5,2021-11-12,5,1,0,0
Ismaïla Sarr,8,7,2024-01-19,4,4,0,1
Richmond Boakye,4,2,2022-01-18,1,3,0,0
Vladis-Emmerson Illoy-Ayyet,1,1,2017-09-05,1,0,0,0
Chancel Mbemba,3,3,2024-02-02,2,1,0,0
Wilfred Moke,1,1,2017-09-05,0,1,1,0
Anice Badri,1,1,2017-09-05,0,1,0,0
Tamer Haj Mohamad,1,1,2017-09-05,0,1,0,0
Omar Al Somah,13,9,2021-11-11,7,6,0,2
Aymen Hussein,10,8,2024-01-29,6,4,0,1
Axel Méyé,2,2,2021-10-08,0,2,0,0
Mario Lemina,1,1,2017-09-05,0,1,0,0
Maxwel Cornet,3,3,2021-11-13,2,1,0,0
Iago Aspas,3,2,2018-06-25,1,2,0,0
Federico Valverde,4,4,2024-06-27,2,2,0,0
Ángel Romero,7,5,2021-06-14,6,1,0,2
Xiao Zhi,2,2,2019-01-20,0,2,0,0
Myer Bevan,1,1,2017-09-05,0,1,0,0
Nelson Sale,1,1,2017-09-05,0,1,1,0
Garry Rodrigues,5,4,2024-01-14,0,5,0,0
Hovhannes Hambardzumyan,3,3,2020-11-18,3,0,0,0
Rafał Wolski,1,1,2017-10-05,0,1,0,0
Jan Kopic,2,2,2017-10-08,1,1,0,0
Romario Ibarra,2,2,2017-10-10,1,1,0,0
Antonio Sanabria,2,2,2021-09-05,1,1,0,0
Andrei Agius,5,5,2020-09-03,2,3,1,1
Sebastian Rudy,1,1,2017-10-05,0,1,0,0
Bauyrzhan Turysbek,3,3,2018-10-16,2,1,0,0
Mohamed Elyounoussi,9,6,2023-11-19,3,6,0,0
Ole Selnæs,2,2,2018-10-13,1,1,0,0
Martin Linnes,1,1,2017-10-05,0,1,0,0
Luka Milivojević,1,1,2017-10-06,0,1,0,0
Guido Burgstaller,2,2,2019-06-07,2,0,0,0
Pyry Soiri,5,4,2023-11-20,1,4,0,0
Tom Lawrence,2,2,2018-09-06,1,1,0,0
Leart Paqarada,1,1,2017-10-06,0,1,1,0
Eitan Tibi,1,1,2017-10-06,0,1,0,0
Shahdon Winchester,1,1,2017-10-06,0,1,0,0
Rodrigo,7,6,2019-10-15,5,2,0,0
Thiago Alcântara,1,1,2017-10-06,1,0,0,0
Maksim Valadzko,1,1,2017-10-07,1,0,0,0
Dario Đumić,1,1,2017-10-07,1,0,0,0
Clinton N'Jie,2,2,2019-07-06,1,1,0,0
Franck Pangop,1,1,2017-10-07,1,0,0,0
Diafra Sakho,2,2,2017-11-10,0,2,0,0
Cheikh N'Doye,1,1,2017-10-07,0,1,0,0
Alexandros Tziolis,1,1,2017-10-07,0,1,0,0
Siim Luts,2,2,2018-10-15,1,1,0,0
Joonas Tamm,4,2,2022-06-02,1,3,0,0
Mohamed Amine Ben Amor,1,1,2017-10-07,0,1,0,0
Ali Elmusrati,1,1,2017-10-07,1,0,0,0
Percy Tau,3,3,2024-01-21,2,1,0,1
Themba Zwane,3,2,2024-01-21,3,0,0,0
Sibusiso Vilakazi,1,1,2017-10-07,1,0,0,0
Fabian Frei,1,1,2017-10-07,1,0,0,0
Steven Zuber,7,6,2021-10-09,4,3,0,0
Roland Ugrai,1,1,2017-10-07,0,1,0,0
Filip Novák,1,1,2017-10-08,1,0,0,0
Ciprian Deac,2,2,2019-03-26,1,1,0,0
Arnold Bouka Moutou,1,1,2017-10-08,0,1,0,0
Ramil Sheydayev,6,6,2023-10-13,3,3,0,1
Antonio Rüdiger,3,3,2024-06-14,1,2,1,0
Emre Can,2,2,2024-06-14,2,0,0,0
Filip Stojković,1,1,2017-10-08,1,0,1,0
Roman Bezjak,3,2,2019-09-09,3,0,0,0
Asier Illarramendi,1,1,2017-10-09,0,1,0,0
Visar Musliu,1,1,2017-10-09,1,0,0,0
Enis Bardhi,14,12,2023-11-20,7,7,0,3
Aleksandar Prijović,2,2,2018-11-20,2,0,0,0
Thorgan Hazard,8,7,2021-11-13,4,4,0,0
Ilja Antonov,1,1,2017-10-10,1,0,0,0
Anton Saroka,4,4,2018-11-18,2,2,0,1
Giannis Gianniotas,1,1,2017-10-10,1,0,0,0
Guillermo Ochoa,1,1,2017-10-10,1,0,1,0
Dāvis Ikaunieks,3,3,2021-06-10,1,2,0,1
Igors Tarasovs,2,2,2019-11-16,2,0,1,0
Olivier Thill,3,3,2021-09-04,2,1,0,0
Yangel Herrera,1,1,2017-10-10,0,1,0,0
David Ospina,1,1,2017-10-10,1,0,1,0
Alvin Jones,2,2,2023-06-25,2,0,0,0
Gastón Silva,1,1,2017-10-10,0,1,1,0
Thamsanqa Mkhize,1,1,2017-11-10,0,1,1,0
Jakob Johansson,1,1,2017-11-10,1,0,0,0
Ousmane Sidibé,1,1,2017-11-11,1,0,1,0
Keita Karamokoba,1,1,2017-11-11,0,1,0,0
Nabil Dirar,1,1,2017-11-11,0,1,0,0
Medhi Benatia,1,1,2017-11-11,0,1,0,0
Banana Yaya,2,2,2019-06-25,1,1,0,0
Marvin Baudry,1,1,2017-11-12,1,0,0,0
Milton Karisa,1,1,2017-11-12,0,1,0,0
Shikabala,1,1,2017-11-12,0,1,0,0
Edwin Gyasi,1,1,2017-11-12,1,0,0,0
Andreas Christensen,3,3,2022-11-26,1,2,0,0
Opa Nguette,1,1,2017-11-14,1,0,0,0
Henrik Ojamaa,1,1,2018-05-30,1,0,0,0
Jānis Ikaunieks,10,8,2023-10-12,5,5,0,1
Kaspars Dubra,1,1,2018-06-05,0,1,0,0
Karolis Laukžemis,2,2,2020-10-11,2,0,0,0
Yury Gazinsky,1,1,2018-06-14,1,0,0,0
Denis Cheryshev,13,10,2020-11-15,5,8,1,0
Aleksandr Golovin,3,3,2019-10-13,2,1,0,0
Nacho,1,1,2018-06-15,0,1,0,0
Oghenekaro Etebo,1,1,2018-06-16,1,0,1,0
Aziz Behich,2,2,2021-10-12,2,0,2,0
Ferjani Sassi,2,2,2019-07-11,1,1,0,1
Thiago Cionek,1,1,2018-06-19,0,1,1,0
M'Baye Niang,1,1,2018-06-19,0,1,0,0
Ante Rebić,2,2,2019-03-24,0,2,0,0
Dylan Bronn,3,3,2021-09-03,2,1,1,0
John Stones,3,2,2021-10-12,3,0,0,0
Jesse Lingard,4,3,2021-09-05,4,0,0,0
Takashi Inui,2,2,2018-07-02,1,1,0,0
Moussa Wagué,1,1,2018-06-24,0,1,0,0
Ludwig Augustinsson,2,2,2021-03-28,0,2,0,0
Yann Sommer,1,1,2018-06-27,0,1,1,0
Adnan Januzaj,1,1,2018-06-28,0,1,0,0
Jan Bednarek,1,1,2018-06-28,0,1,0,0
Benjamin Pavard,3,3,2023-03-27,2,1,0,0
Mathias Jørgensen,2,2,2019-03-26,0,2,0,0
Raphaël Varane,3,3,2019-11-14,1,2,0,0
Mário Fernandes,5,5,2021-03-30,2,3,0,0
Harry Maguire,6,6,2021-11-15,2,4,0,0
Samuel Umtiti,2,2,2019-03-25,2,0,0,0
Kieran Trippier,1,1,2018-07-11,0,1,0,0
Sandro Wolfinger,2,2,2023-09-08,0,2,0,0
Tigran Barseghyan,8,8,2023-06-19,5,3,0,3
Patrik Schick,16,14,2024-06-22,6,10,0,2
Oleksandr Zinchenko,6,6,2023-09-09,2,4,0,0
Giorgi Chakvetadze,5,5,2023-09-08,2,3,0,0
Serhiy Malyi,3,3,2022-03-24,0,3,2,0
Stefan Johansen,3,2,2019-09-08,2,1,0,0
Bozhidar Kraev,3,2,2020-09-03,1,2,0,0
Miha Zajc,6,6,2021-11-14,3,3,0,0
Connor Roberts,3,3,2021-11-13,2,1,0,0
Shaun Williams,1,1,2018-09-06,0,1,0,0
Taulant Xhaka,1,1,2018-09-07,1,0,0,0
René Joensen,3,3,2018-11-20,2,1,0,0
Jorginho,5,5,2020-11-15,4,1,0,5
Yury Kavalyow,1,1,2018-09-08,1,0,0,0
Saúl Ñíguez,3,3,2019-10-12,1,2,0,0
Kevin Malget,1,1,2018-09-08,1,0,0,0
Danel Sinani,12,10,2023-09-08,6,6,0,0
Christopher Martins,1,1,2018-09-08,1,0,0,0
Haris Duljević,1,1,2018-09-08,0,1,0,0
Elvis Sarić,1,1,2018-09-08,0,1,0,0
Will Grigg,1,1,2018-09-08,1,0,0,0
Denis Zakaria,4,4,2021-07-02,2,2,1,0
Albian Ajeti,1,1,2018-09-08,1,0,0,0
Radoslav Vasilev,1,1,2018-09-09,1,0,0,0
Petar Stojanović,3,3,2022-06-05,2,1,1,0
Dennis Salanović,3,3,2019-09-08,1,2,0,0
Jordi Aláez,2,2,2022-06-10,2,0,0,1
Arbër Zeneli,5,3,2019-03-25,5,0,0,0
Tamkin Khalilzade,2,2,2019-09-09,1,1,0,0
Marko Janković,1,1,2018-09-10,1,0,0,0
George Țucudean,2,2,2018-11-20,0,2,0,0
Viktor Claesson,11,11,2023-11-19,7,4,0,0
Emre Akbaba,2,1,2018-09-10,0,2,0,0
Roland Sallai,9,8,2023-10-14,5,4,0,1
Kostas Manolas,1,1,2018-09-11,0,1,0,0
Marco Asensio,2,2,2022-11-23,2,0,0,0
Lovre Kalinić,1,1,2018-09-11,1,0,1,0
Richard Almeida de Oliveira,2,1,2018-10-11,0,2,0,1
Charlie Mulgrew,1,1,2018-10-11,0,1,0,1
Dor Peretz,6,6,2023-03-25,4,2,0,0
Kieran Tierney,1,1,2018-10-11,1,0,1,0
Benjamin Kololli,5,4,2020-10-08,3,2,1,0
Vedat Muriqi,18,15,2023-09-09,11,7,0,4
Artūras Žulpa,2,2,2018-11-20,2,0,1,0
Krzysztof Piątek,8,8,2024-06-21,4,4,0,0
Joseph Chipolina,3,3,2019-06-10,2,1,1,1
Grigoris Kastanos,4,3,2023-06-20,2,2,0,1
Kiril Despodov,9,9,2023-11-19,6,3,0,1
Todor Nedelev,4,3,2021-10-12,4,0,0,1
Bakhtiyar Zaynutdinov,11,10,2023-10-17,3,8,0,2
Artūrs Karašausks,1,1,2018-10-13,1,0,0,0
Virgil van Dijk,6,6,2023-10-16,4,2,0,1
Seyhan Yildiz,1,1,2018-10-13,0,1,0,0
Rowen Muscat,1,1,2018-10-14,0,1,0,0
Milot Rashica,7,6,2023-11-12,1,6,0,0
Dia Saba,1,1,2018-10-14,1,0,0,0
Boris Kopitović,2,2,2019-06-10,1,1,1,0
Darko Zorić,1,1,2018-10-14,0,1,0,0
Rolandas Baravykas,2,2,2021-09-02,2,0,0,0
Cristiano Biraghi,1,1,2018-10-14,0,1,0,0
Roman Neustädter,1,1,2018-10-14,1,0,0,0
Dominik Nagy,1,1,2018-10-15,0,1,0,0
Máté Pátkai,3,3,2019-06-11,3,0,1,0
Glen Kamara,2,2,2023-06-19,2,0,0,0
Vincent Thill,1,1,2018-10-15,1,0,0,0
George Cabrera,1,1,2018-10-16,1,0,0,0
Yerkebulan Seydakhmet,1,1,2018-10-16,1,0,0,0
Josep Gómes,1,1,2018-10-16,1,0,1,0
Roman Murtazayev,1,1,2018-10-16,1,0,0,0
Harry Wilson,7,6,2023-10-15,4,3,0,0
Fotis Papoulis,3,3,2021-10-11,1,2,0,0
Nejc Skubic,1,1,2018-10-16,1,0,0,0
Ruslan Malinovskyi,6,5,2022-06-11,5,1,0,1
Dani Ceballos,1,1,2018-11-15,0,1,0,0
Tin Jedvaj,2,1,2018-11-15,2,0,0,0
Albin Granlund,1,1,2018-11-15,1,0,1,0
Willi Orbán,6,5,2023-09-07,2,4,0,0
Deniss Rakels,1,1,2018-11-15,0,1,0,0
Vitalie Damașcan,1,1,2018-11-15,0,1,0,0
Panagiotis Zachariou,1,1,2018-11-16,1,0,0,0
Nikolay Dimitrov,1,1,2018-11-16,0,1,0,1
Tjay De Barr,3,3,2021-09-01,1,2,0,1
Artur Kartashyan,1,1,2018-11-16,0,1,0,0
Adam Priestley,1,1,2018-11-16,1,0,0,0
Aleksandre Karapetian,6,6,2020-09-08,3,3,0,0
Albert Rusnák,4,3,2021-11-14,2,2,0,0
Adam Zreľák,2,2,2022-09-25,2,0,0,0
Bjørn Maars Johnsen,4,3,2019-06-10,1,3,0,0
Martin Braithwaite,6,6,2021-06-26,2,4,0,0
Ryan Fraser,4,4,2021-03-31,2,2,0,0
James Forrest,5,2,2018-11-20,3,2,0,0
Mahir Madatov,1,1,2018-11-17,1,0,0,0
Donis Avdijaj,2,1,2018-11-17,0,2,0,0
George Pușcaș,10,8,2023-11-18,6,4,0,0
Vassilis Lambropoulos,1,1,2018-11-18,0,1,1,0
Ádám Nagy,2,2,2023-11-19,2,0,0,0
Xaver Schlager,2,2,2022-06-06,1,1,0,0
Valentino Lazaro,3,3,2019-10-10,1,2,0,0
Nico Elvedi,1,1,2018-11-18,1,0,0,0
Galin Ivanov,1,1,2018-11-19,1,0,0,0
Ola Kamara,3,2,2019-03-26,1,2,0,0
Oralkhan Omirtayev,1,1,2018-11-19,0,1,0,0
Leroy Sané,9,8,2021-11-11,5,4,0,0
Sargis Adamyan,2,2,2020-11-15,0,2,0,0
Marcel Büchel,1,1,2018-11-19,1,0,0,0
Juan Carlos Corbalan,1,1,2018-11-20,1,0,0,0
Beram Kayal,1,1,2018-11-20,0,1,0,0
Deimantas Petravičius,1,1,2018-11-20,0,1,0,0
Anas Bani Yaseen,1,1,2019-01-06,0,1,0,0
Anirudh Thapa,1,1,2019-01-06,0,1,0,0
Akhlidin Israilov,1,1,2019-01-07,0,1,0,0
Pavel Matyash,1,1,2019-01-07,1,0,1,0
Saman Ghoddos,1,1,2019-01-07,1,0,0,0
Hwang Ui-jo,4,3,2021-06-05,4,0,0,1
Ali Faez,1,1,2019-01-08,0,1,1,0
Mohanad Ali,8,8,2024-01-15,4,4,0,0
Nguyễn Công Phượng,3,3,2021-06-07,1,2,0,0
Humam Tariq,1,1,2019-01-08,1,0,0,0
Hattan Bahebri,2,2,2019-09-10,1,1,0,0
Mohammed Al-Fatil,1,1,2019-01-08,1,0,0,0
Ritsu Dōan,5,5,2024-01-31,2,3,0,1
Ahmet Ataýew,1,1,2019-01-09,0,1,0,1
Bassam Al-Rawi,2,2,2019-01-22,2,0,0,0
Almoez Ali,22,14,2024-02-07,12,10,0,2
Muhsen Al-Ghassani,5,5,2024-01-25,3,2,0,1
Chanathip Songkrasin,2,2,2019-11-14,0,2,0,0
Musa Al-Taamari,4,3,2024-02-06,2,2,0,1
Tareq Khattab,1,1,2019-01-10,1,0,0,0
Khalfan Mubarak,1,1,2019-01-10,1,0,0,0
Kim Min-jae,2,2,2019-01-16,1,1,0,0
Jamie Maclaren,8,6,2022-02-01,5,3,0,2
Awer Mabil,4,4,2021-10-07,3,1,0,0
Apostolos Giannou,1,1,2019-01-11,0,1,0,0
Housain Al-Mogahwi,1,1,2019-01-12,0,1,0,0
Bashar Resan,2,2,2021-06-07,1,1,0,0
Alaa Abbas,2,2,2019-11-14,1,1,0,0
Javokhir Sidikov,1,1,2019-01-13,0,1,0,0
Jaloliddin Masharipov,4,3,2021-06-11,2,2,0,1
Jamal Rashid,1,1,2019-01-14,0,1,0,1
Thitipan Puangchan,1,1,2019-01-14,0,1,0,0
Chris Ikonomidis,1,1,2019-01-15,1,0,0,0
Quế Ngọc Hải,3,3,2021-06-11,1,2,0,3
Yoshinori Muto,1,1,2019-01-17,1,0,0,0
Tsukasa Shiotani,1,1,2019-01-17,1,0,0,0
Felix Michel Melki,1,1,2019-01-17,1,0,0,0
Altymyrat Annadurdyýew,4,4,2021-06-09,2,2,0,0
Mohammed Al-Musalami,1,1,2019-01-17,1,0,0,0
Supachai Jaided,1,1,2019-01-20,1,0,0,0
Takehiro Tomiyasu,1,1,2019-01-21,1,0,0,0
Khamis Esmaeel,1,1,2019-01-21,1,0,0,0
Mirlan Murzaev,6,4,2021-06-15,0,6,0,1
Tursunali Rustamov,2,2,2021-06-11,0,2,0,0
Kim Jin-su,2,2,2022-02-01,1,1,0,0
Abdulaziz Hatem,7,7,2021-07-24,3,4,0,0
Hamid Ismail,1,1,2019-01-29,0,1,0,0
Takumi Minamino,13,10,2024-01-14,9,4,0,1
Youri Tielemans,6,6,2024-06-22,5,1,0,0
Borna Barišić,1,1,2019-03-21,1,0,0,0
Ioannis Kousoulos,5,4,2020-11-14,1,4,1,0
Andraž Šporar,7,6,2023-09-07,5,2,0,0
Yuriy Pertsukh,1,1,2019-03-21,1,0,0,0
Yan Vorogovsky,4,4,2023-10-14,2,2,0,0
Elif Elmas,11,8,2023-09-12,9,2,0,0
Viðar Örn Kjartansson,2,2,2020-11-15,0,2,0,0
Tomáš Kalas,1,1,2019-03-22,1,0,1,0
Leandro Barreiro,2,2,2022-06-14,2,0,0,0
Gerson Rodrigues,19,17,2023-11-19,8,11,1,5
Vladimir Ambros,1,1,2019-03-22,1,0,0,0
Rade Krunić,4,3,2023-03-23,4,0,0,0
Deni Milošević,1,1,2019-03-23,1,0,0,0
Nicolò Barella,8,8,2024-06-15,5,3,0,0
Moise Kean,4,3,2021-09-08,4,0,0,0
Anastasios Donis,1,1,2019-03-23,0,1,0,0
Kyrian Nwoko,2,2,2020-09-06,2,0,0,0
Steve Borg,2,2,2020-10-13,1,1,0,1
Jákup Thomsen,1,1,2019-03-23,0,1,0,0
Robin Quaison,10,10,2023-09-09,4,6,0,0
Abzal Beisebekov,1,1,2019-03-24,0,1,1,0
Matthijs de Ligt,2,2,2019-06-06,1,1,0,0
Nico Schulz,1,1,2019-03-24,0,1,0,0
Kenny McLean,2,2,2023-06-17,0,2,0,0
Johnny Russell,1,1,2019-03-24,0,1,0,0
Daniel James,6,6,2024-03-21,5,1,0,0
Amir Abrashi,1,1,2019-03-25,0,1,0,0
Vasil Bozhikov,2,2,2019-11-17,1,1,0,0
Viktor Tsyhankov,8,7,2024-03-26,5,3,0,1
Michael Keane,1,1,2019-03-25,0,1,0,0
Danilo Pereira,1,1,2019-03-25,1,0,0,0
Hasan Ali Kaldırım,1,1,2019-03-25,1,0,0,0
Kaan Ayhan,4,4,2022-06-14,3,1,0,0
Fredrik Jensen,5,5,2020-10-14,3,2,0,0
Dimitris Kolovos,1,1,2019-03-26,0,1,0,0
Stefano Sensi,3,3,2021-03-31,2,1,0,0
Marco Verratti,2,2,2019-06-11,2,0,0,0
Leonardo Pavoletti,1,1,2019-03-26,1,0,0,0
Conor Hourihane,1,1,2019-03-26,1,0,0,0
Viljormur Davidsen,3,3,2022-09-25,2,1,0,2
Remo Freuler,9,9,2024-06-29,5,4,0,0
Christian Gytkjær,4,3,2019-11-15,1,3,0,0
Henrik Dalsgaard,1,1,2019-03-26,0,1,0,0
Sieng Chanthea,1,1,2019-06-06,1,0,0,0
Kyle Walker,2,2,2023-09-09,0,2,1,0
Robiul Hasan,1,1,2019-06-06,0,1,0,0
Filipe Duarte,1,1,2019-06-06,1,0,0,0
Norjmoogiin Tsedenbal,3,3,2019-10-15,2,1,0,2
Nyam-Osor Naranbold,1,1,2019-06-06,1,0,0,0
Ismail Isa,1,1,2019-06-07,0,1,0,0
Klæmint Olsen,8,7,2021-11-15,5,3,0,0
Teitur Gestsson,1,1,2019-06-07,0,1,1,0
José Luis Gayà,1,1,2019-06-07,0,1,0,0
Giorgi Papunashvili,1,1,2019-06-07,1,0,0,0
Vato Arveladze,1,1,2019-06-07,1,0,0,1
La'Vere Corbin-Ong,1,1,2019-06-07,1,0,0,0
Shahrel Fikri,4,2,2019-06-11,4,0,0,0
Norshahrul Idlan,1,1,2019-06-07,1,0,0,0
Safawi Rasid,5,3,2021-06-15,4,1,0,1
João Pedro,1,1,2019-06-07,0,1,0,0
Faiz Nasir,1,1,2019-06-07,1,0,0,0
Akhyar Rashid,2,2,2019-06-11,2,0,0,0
Martin Ødegaard,2,2,2023-09-12,2,0,0,0
Alexander Isak,8,7,2023-09-09,4,4,0,0
Roman Yaremchuk,13,13,2024-06-21,5,8,0,0
Mahir Emreli,3,3,2022-06-13,2,1,0,0
Dávid Holman,1,1,2019-06-08,0,1,0,0
Timothy Castagne,2,2,2019-10-10,2,0,0,0
James Lawrence,1,1,2019-06-08,1,0,1,0
David Brooks,4,4,2024-03-21,2,2,0,0
Fyodor Kudryashov,2,2,2021-11-14,2,0,1,0
Anton Miranchuk,3,3,2020-10-11,2,1,0,0
Oliver Burke,1,1,2019-06-08,1,0,0,0
Gonçalo Guedes,4,4,2022-06-09,3,1,0,0
Kristian Dimitrov,1,1,2019-06-10,1,0,0,0
Elbasan Rashani,2,2,2022-09-27,1,1,0,0
Jakub Jankto,2,2,2021-03-24,1,1,0,0
Saba Lobzhanidze,1,1,2019-06-10,0,1,0,0
Domen Črnigoj,2,1,2019-06-10,0,2,0,0
Dennis Man,5,5,2023-03-25,1,4,0,0
Egzon Bejtulai,1,1,2019-06-10,0,1,1,0
Damian Kądzior,1,1,2019-06-10,1,0,0,0
Luka Jović,7,6,2024-06-20,5,2,0,0
Mikel Oyarzabal,8,8,2024-07-14,6,2,0,0
Sokol Çikalleshi,10,9,2023-11-17,5,5,0,3
Ylber Ramadani,1,1,2019-06-11,1,0,0,0
Wissam Ben Yedder,2,2,2019-09-10,1,1,0,0
Florian Thauvin,1,1,2019-06-11,0,1,0,0
Kurt Zouma,1,1,2019-06-11,0,1,0,0
Dávid Hancko,3,3,2023-10-13,1,2,0,0
Paddy McNair,4,4,2022-06-12,2,2,0,1
Razimie Ramlli,2,1,2019-06-11,2,0,0,0
Isiah Lagutang,1,1,2019-06-11,1,0,0,0
Jason Cunliffe,3,1,2019-06-11,3,0,0,0
Shane Malcolm,1,1,2019-06-11,1,0,0,0
Dorukhan Toköz,1,1,2019-06-11,0,1,0,0
Maxim Fedin,1,1,2019-06-11,1,0,0,0
Bauyrzhan Islamkhan,1,1,2019-06-11,1,0,0,0
Benjamin Källman,5,5,2023-06-19,1,4,0,0
Mohamadou Sumareh,4,3,2019-11-14,2,2,0,0
Rufino Gama,1,1,2019-06-11,0,1,0,0
Sath Rosib,1,1,2019-06-11,0,1,0,0
Reung Bunheing,1,1,2019-06-11,0,1,0,0
Aleksei Ionov,2,2,2019-11-19,1,1,0,0
Everton Soares,3,3,2019-07-07,3,0,0,0
Roger Martínez,2,2,2021-09-02,0,2,0,0
Duván Zapata,3,3,2020-10-09,2,1,0,0
Jonathan David,17,12,2024-07-13,12,5,0,1
Uriel Antuna,5,3,2022-03-30,4,1,0,0
Diego Antonio Reyes,1,1,2019-06-15,1,0,0,0
Alexis Vega,3,3,2022-01-27,2,1,0,0
Bryan Oviedo,1,1,2019-06-16,1,0,0,0
Elías Aguilar,2,2,2019-06-20,2,0,0,0
Allan Cruz,1,1,2019-06-16,1,0,0,0
Frantzdy Pierrot,7,4,2023-07-02,3,4,0,0
Juan Rodrigo Rojas,1,1,2019-06-16,0,1,1,0
Dever Orgill,2,1,2019-06-17,2,0,0,0
Damion Lowe,2,2,2023-06-24,1,1,0,0
Rubilio Castillo,2,2,2019-06-25,1,1,0,0
Erick Pulgar,4,3,2021-10-14,3,1,0,0
Yoel Bárcenas,4,4,2023-07-08,3,1,0,0
Tyler Boyd,2,1,2019-06-18,2,0,0,0
Richard Sánchez,1,1,2019-06-19,0,1,0,0
Joris Marveaux,1,1,2019-06-19,0,1,0,0
Stéphane Abaul,1,1,2019-06-19,0,1,0,0
Kévin Fortuné,3,3,2023-06-26,1,2,0,0
Roberto Alvarado,2,2,2023-07-12,1,1,0,0
Lucas Cavallini,11,6,2023-06-27,4,7,0,0
Mayron George,1,1,2019-06-20,1,0,0,0
Steeven Saba,1,1,2019-06-20,0,1,0,0
Koji Miyoshi,2,1,2019-06-20,0,2,0,0
Trézéguet,3,3,2024-01-22,2,1,0,0
Leandro Bacuna,3,3,2021-06-05,0,3,0,0
Darwin Machís,5,4,2022-01-28,3,2,0,0
Leonel Justiniano,1,1,2019-06-22,1,0,0,0
Casemiro,4,4,2022-11-28,3,1,0,0
Patrick Kaddu,1,1,2019-06-22,0,1,0,0
Sory Kaba,1,1,2019-06-22,1,0,0,0
Carolus Andriamatsinoro,2,2,2019-06-30,1,1,0,0
François Kamano,2,2,2021-09-01,1,1,0,1
Terence Vancooten,2,2,2021-03-30,1,1,1,0
Eric Davis,5,5,2022-01-30,2,3,0,3
Aaron Long,2,1,2019-06-22,2,0,0,0
Baghdad Bounedjah,7,6,2024-01-20,5,2,0,2
Gustavo Cuéllar,1,1,2019-06-23,1,0,0,0
Fernando Navarro Morán,1,1,2019-06-23,0,1,0,0
Jordy Delem,1,1,2019-06-23,1,0,0,0
Itamunua Keimuine,1,1,2019-06-23,1,0,1,0
Lautaro Martínez,18,17,2024-07-14,10,8,0,0
Krépin Diatta,1,1,2019-06-23,1,0,0,0
Lejuan Simmons,1,1,2019-06-24,1,0,0,0
Shoya Nakajima,2,2,2019-09-10,0,2,0,0
Djimy Alexis,1,1,2019-06-24,1,0,0,0
Abdoulay Diaby,1,1,2019-06-24,1,0,0,0
Moussa Marega,1,1,2019-06-24,1,0,0,1
Moctar Sidi El Hacen,1,1,2019-06-24,0,1,0,1
Stéphane Bahoken,3,3,2022-02-05,2,1,0,0
Jorge Álvarez,1,1,2019-06-25,1,0,0,0
Bryan Acosta,1,1,2019-06-25,1,0,0,0
Shamar Nicholson,5,5,2021-09-08,2,3,0,0
Juriën Gaari,1,1,2019-06-25,0,1,0,0
Kenneth Omeruo,1,1,2019-06-26,1,0,0,0
Khama Billiat,2,2,2019-09-10,1,1,0,0
Simon Msuva,6,6,2024-01-21,0,6,0,0
Marco Ilaimaharitra,1,1,2019-06-27,1,0,0,0
Youcef Belaïli,3,3,2021-11-12,1,2,0,0
Bongani Zungu,2,2,2019-07-10,1,1,0,0
Diadie Samassékou,1,1,2019-06-28,0,1,0,0
Giovani Lo Celso,1,1,2019-06-28,0,1,0,0
Hervé Bazile,1,1,2019-06-29,1,0,0,1
Weston McKennie,4,4,2022-02-02,4,0,0,0
Britt Assombalonga,1,1,2019-06-30,0,1,0,0
Joslin Kamatuka,2,2,2021-10-09,1,1,0,0
Wilfried Zaha,2,2,2019-07-08,0,2,0,0
Mbark Boussoufa,1,1,2019-07-01,0,1,0,0
Adam Ounas,3,2,2019-07-07,1,2,0,0
Amadou Haidara,1,1,2019-07-02,0,1,0,0
Moise Adilehou,1,1,2019-07-05,0,1,0,0
Paulo Dybala,2,2,2022-06-01,1,1,0,0
Thembinkosi Lorch,1,1,2019-07-06,0,1,0,0
Richarlison,11,9,2022-12-05,7,4,0,1
Ibrahim Amada,1,1,2019-07-07,1,0,0,0
Jonathan dos Santos,2,2,2021-07-24,1,1,0,0
Rami Bedoui,1,1,2019-07-08,1,0,1,0
Samuel Chukwueze,2,2,2022-01-15,2,0,0,0
William Troost-Ekong,7,7,2024-02-11,4,3,1,3
Idrissa Gueye,3,3,2022-02-02,2,1,0,0
Mahdi Houssein Mahabeh,1,1,2019-09-04,1,0,0,1
Siboniso Mamba,1,1,2019-09-04,0,1,0,0
Abdi Idleh Hamza,1,1,2019-09-04,1,0,0,0
Peter Shalulile,4,4,2021-11-11,2,2,0,0
Esey Tesfay,1,1,2019-09-04,0,1,1,0
Ali Sulieman,1,1,2019-09-04,1,0,0,0
Terrence Tisdell,1,1,2019-09-04,1,0,0,1
Kwame Quee,1,1,2019-09-04,0,1,0,0
Mohammed Sangare,1,1,2019-09-04,1,0,0,1
Sam Johnson,1,1,2019-09-04,1,0,0,0
Telinho,1,1,2019-09-04,0,1,0,0
Luis Meseguer,1,1,2019-09-04,0,1,0,0
Niko Kata,1,1,2019-09-04,1,0,1,0
Joseph Mendes,4,3,2021-09-01,3,1,0,1
Lorenzo Pellegrini,5,5,2022-06-07,4,1,0,0
Aram Ayrapetyan,1,1,2019-09-05,0,1,1,0
Kamil Al Aswad,4,3,2021-06-03,3,1,0,0
Amer Gojak,4,3,2019-10-15,2,2,0,0
Andreas Malin,1,1,2019-09-05,1,0,1,0
Tan Chun Lok,1,1,2019-09-05,0,1,0,0
Keo Sokpheng,1,1,2019-09-05,1,0,0,0
Ramadan Agab,3,1,2019-09-05,0,3,0,0
Robert Skov,7,5,2023-10-14,5,2,0,0
Ibrahim Mahudhee,1,1,2019-09-05,0,1,0,0
Rabia Al-Alawi,5,4,2021-10-07,1,4,0,0
Beto Gonçalves,2,1,2019-09-05,2,0,0,0
Syafiq Ahmad,2,2,2019-09-10,1,1,0,0
Fahad Al Hajeri,1,1,2019-09-05,1,0,0,0
Abdullah Mawei,1,1,2019-09-05,1,0,0,0
Redha Abujabarah,1,1,2019-09-05,1,0,0,0
Hussain Al-Musawi,1,1,2019-09-05,1,0,0,0
Dölgöön Amaraa,1,1,2019-09-05,1,0,0,0
Sander Berge,1,1,2019-09-05,1,0,0,0
Oday Dabbagh,7,5,2024-01-29,4,3,0,0
Islam Batran,1,1,2019-09-05,1,0,0,0
Khaled Mobayed,1,1,2019-09-05,0,1,0,0
Mike Ott,1,1,2019-09-05,1,0,0,0
David McGoldrick,1,1,2019-09-05,1,0,0,0
Florin Andone,1,1,2019-09-05,1,0,0,0
Muhadjiri Hakizimana,2,2,2019-09-10,1,1,0,0
Yannick Mukunzi,2,2,2019-09-10,1,1,0,0
Ikhsan Fandi,3,3,2019-11-19,2,1,0,0
Mohsen Qarawi,2,2,2019-09-10,1,1,0,0
Anwar Shakunda,1,1,2019-09-05,1,0,0,0
Wahyt Orazsähedow,2,2,2019-11-14,1,1,0,0
Alisher Dzhalilov,2,2,2021-03-25,2,0,0,0
Pāvels Šteinbors,1,1,2019-09-06,1,0,1,0
Konrad Laimer,4,4,2023-11-16,2,2,0,0
Michael Gregoritsch,9,9,2024-07-02,5,4,0,0
Ibroihim Djoudja,1,1,2019-09-06,1,0,0,0
Aleksey Shchotkin,2,2,2019-11-16,0,2,0,0
Nikita Naumov,1,1,2019-09-06,0,1,0,0
Erik Sorga,4,4,2021-11-13,3,1,0,0
Maksim Skavysh,2,2,2020-11-18,0,2,0,0
Wilson Gaspar,1,1,2019-09-06,0,1,0,0
Frenkie de Jong,2,2,2022-11-29,0,2,0,0
Jonathan Tah,1,1,2019-09-06,0,1,1,0
Donyell Malen,8,7,2024-07-02,3,5,1,0
John McGinn,16,12,2023-11-19,13,3,0,0
Stephen O'Donnell,1,1,2019-09-06,0,1,1,0
Nikola Vlašić,7,7,2021-09-07,4,3,0,0
Bruno Petković,9,7,2023-09-08,6,3,0,0
Aljaž Struna,1,1,2019-09-06,1,0,0,0
Pavel Pashayev,1,1,2019-09-06,1,0,1,0
Kingsley Coman,6,4,2023-11-18,6,0,0,0
Jonathan Ikoné,1,1,2019-09-07,1,0,0,0
Mërgim Vojvoda,2,2,2019-09-10,2,0,1,0
Marlos,1,1,2019-09-07,0,1,0,0
Nikola Milenković,3,3,2021-09-07,3,0,1,0
Stjepan Lončar,1,1,2019-09-08,1,0,1,0
Giorgos Masouras,8,7,2023-10-13,6,2,0,0
Nkau Lerotholi,1,1,2019-09-08,0,1,1,0
Dominik Szoboszlai,10,8,2023-11-19,8,2,0,2
Róbert Boženík,5,5,2023-11-19,1,4,0,0
Marcel Halstenberg,1,1,2019-09-09,0,1,0,0
Kostakis Artymatas,1,1,2019-09-09,0,1,0,0
Thomas Vermaelen,1,1,2019-09-09,0,1,0,0
Farshad Noor,1,1,2019-09-10,1,0,0,0
Kastriot Dermaku,1,1,2019-09-10,1,0,0,0
Elseid Hysaj,2,2,2021-09-08,2,0,0,0
Geraldo,1,1,2019-09-10,1,0,0,0
Assan Ceesay,1,1,2019-09-10,0,1,0,0
Fábio Abreu,1,1,2019-09-10,1,0,0,0
Jadon Sancho,2,1,2019-09-10,2,0,0,0
Clément Lenglet,1,1,2019-09-10,1,0,0,0
Patrick Reichelt,1,1,2019-09-10,0,1,0,0
Marcus Lopez,2,2,2021-06-11,2,0,1,1
John-Patrick Strauß,2,2,2019-11-14,0,2,0,0
Iniesta,1,1,2019-09-10,0,1,0,0
Supachok Sarachat,3,2,2024-01-30,0,3,0,0
Vytautas Andriuškevičius,1,1,2019-09-10,1,0,0,0
Nemanja Radonjić,5,5,2022-06-05,3,2,0,0
Gerald Phiri Jr.,1,1,2019-09-10,1,0,0,1
Elkeson,4,3,2021-05-30,2,2,0,1
Deniz Türüç,1,1,2019-09-10,0,1,0,0
Yusuf Yazıcı,3,3,2023-11-21,1,2,0,1
Davron Ergashev,1,1,2019-09-10,0,1,0,0
Tomáš Souček,9,7,2024-06-26,4,5,0,1
Lukáš Masopust,1,1,2019-09-10,0,1,0,0
Clésio,2,2,2024-01-14,1,1,0,0
Geny Catamo,3,3,2024-01-22,2,1,0,2
Absalom Iimbondi,1,1,2019-09-10,1,0,0,0
Djihad Bizimana,1,1,2019-09-10,1,0,0,0
Shakir Hamzah,1,1,2019-09-10,1,0,0,0
Yaser Hamed,3,3,2021-06-15,2,1,0,0
Anjan Bista,3,2,2021-06-03,1,2,0,1
Kassim M'Dahoma,1,1,2019-09-10,1,0,1,0
Gilles Sunu,1,1,2019-09-10,1,0,0,0
Na Sang-ho,1,1,2019-09-10,0,1,0,0
Jung Woo-young,1,1,2019-09-10,0,1,0,0
Omar Al-Dahi,2,2,2019-11-14,2,0,0,0
Marshall Munetsi,1,1,2019-09-10,1,0,0,0
Omar Mohamed,1,1,2019-09-10,0,1,0,0
Admiral Muskwe,1,1,2019-09-10,1,0,0,0
Harry Souttar,7,5,2024-01-28,5,2,0,0
Yusuf Abdurisag,2,2,2023-06-25,0,2,0,0
Yari Verschaeren,1,1,2019-10-10,1,0,0,1
Ahmad Nourollahi,3,3,2021-11-11,1,2,0,0
Hossein Kanaanizadegan,1,1,2019-10-10,1,0,0,0
Soeuy Visal,2,2,2021-06-07,1,1,1,0
Mohammad Mohebi,3,2,2024-02-03,3,0,0,0
Mehrdad Mohammadi,1,1,2019-10-10,1,0,0,0
Yuto Nagatomo,1,1,2019-10-10,1,0,0,0
Kensuke Nagai,1,1,2019-10-10,1,0,0,0
Wataru Endō,2,2,2024-01-19,1,1,0,0
Daichi Kamada,3,3,2021-05-28,3,0,0,0
Temirlan Yerlanov,1,1,2019-10-10,1,0,0,0
Nicholas Ioannou,2,2,2019-11-19,0,2,0,0
Alimardon Shukurov,3,2,2021-06-11,2,1,0,0
Gulzhigit Alykulov,3,3,2021-06-11,1,2,0,0
Nader Matar,1,1,2019-10-10,1,0,0,0
Magomed Ozdoyev,3,3,2020-09-06,1,2,0,0
Abdulfattah Asiri,2,1,2019-10-10,2,0,0,0
Abdullah Al-Hamdan,1,1,2019-10-10,1,0,0,0
Kieffer Moore,9,9,2023-03-28,4,5,0,0
Khalil Ibrahim,1,1,2019-10-10,1,0,0,0
Tareq Ahmed,1,1,2019-10-10,1,0,0,0
Sanjar Kodirkulov,1,1,2019-10-10,1,0,0,0
Jamshid Iskanderov,1,1,2019-10-10,1,0,0,0
Islom Tukhtakhujaev,1,1,2019-10-10,1,0,0,0
Marc Vales,4,3,2021-11-12,4,0,0,0
Jakub Brabec,2,2,2021-11-16,2,0,0,0
Zdeněk Ondrášek,2,2,2020-11-18,2,0,0,0
Armin Hodžić,3,2,2019-11-18,1,2,0,0
Alexandru Mitriță,3,3,2021-10-11,2,1,0,0
Yanik Frick,3,3,2021-03-31,2,1,0,0
Marcus Danielson,3,2,2020-11-14,1,2,1,0
Mihály Korhut,1,1,2019-10-13,1,0,0,0
Przemysław Frankowski,2,2,2024-03-21,2,0,0,0
Lawrence Shankland,2,2,2023-11-16,1,1,0,0
Stuart Findlay,1,1,2019-10-13,1,0,0,0
Stefan Posch,1,1,2019-10-13,0,1,0,0
Arnór Sigurðsson,2,2,2022-06-02,1,1,0,0
Donatas Kazlauskas,2,2,2020-09-07,1,1,0,0
Keidi Bare,2,2,2020-09-04,0,2,0,0
Lorenc Trashi,1,1,2019-10-14,0,1,0,0
Rey Manaj,6,6,2021-09-08,4,2,0,1
Mohammed Al-Hardan,1,1,2019-10-15,1,0,0,1
Ibrahim Bayesh,1,1,2019-10-15,0,1,0,0
Amjad Attwan,1,1,2019-10-15,0,1,0,0
Giorgi Kharaishvili,1,1,2019-10-15,0,1,0,0
Giorgi Kvilitaia,1,1,2019-10-15,0,1,0,0
Vangelis Pavlidis,3,3,2022-06-09,3,0,0,0
Adnan Kovačević,1,1,2019-10-15,1,0,1,0
Saad Uddin,1,1,2019-10-15,0,1,0,0
Adil Khan,1,1,2019-10-15,1,0,0,0
Đỗ Duy Mạnh,1,1,2019-10-15,0,1,0,0
Nguyễn Tiến Linh,8,8,2022-02-01,3,5,0,0
Irfan Bachdim,1,1,2019-10-15,1,0,0,0
Feras Shelbaieh,1,1,2019-10-15,1,0,0,1
Ahmad Ersan,2,2,2019-11-19,2,0,0,0
Alessio Romagnoli,2,2,2019-11-18,1,1,0,0
Alexander Sørloth,13,11,2023-10-12,5,8,0,0
Edimilson Fernandes,1,1,2019-10-15,1,0,0,0
Adam Taggart,3,2,2019-11-14,0,3,0,0
Chen Yi-wei,1,1,2019-10-15,1,0,0,0
Ekanit Panya,1,1,2019-10-15,1,0,0,0
Zelfy Nazary,1,1,2019-11-14,1,0,0,0
Seiminlen Doungel,1,1,2019-11-14,0,1,0,0
Alex Král,1,1,2019-11-14,1,0,0,0
Ondřej Čelůstka,1,1,2019-11-14,1,0,0,0
Aleksandar Šofranac,1,1,2019-11-14,1,0,1,0
Tammy Abraham,3,3,2021-11-15,1,2,0,0
Vadim Rață,2,2,2023-09-10,0,2,0,0
Mobarak Al-Faneeni,1,1,2019-11-14,1,0,0,0
Shabib Al-Khaldi,1,1,2019-11-14,1,0,0,0
Chen Wei-chuan,1,1,2019-11-14,1,0,1,0
Faisal Ajab Al-Azemi,1,1,2019-11-14,1,0,0,0
Brendan Gan,1,1,2019-11-14,1,0,0,0
Naiz Hassan,1,1,2019-11-14,1,0,0,0
Farkhod Vosiyev,1,1,2019-11-14,0,1,0,0
Maung Maung Lwin,1,1,2019-11-14,1,0,0,0
Mohsin Al-Khaldi,2,2,2021-10-12,2,0,0,0
Arshad Al-Alawi,2,2,2022-03-29,2,0,0,0
Biplu Ahmed,1,1,2019-11-14,0,1,0,0
Amran Al-Hidi,1,1,2019-11-14,1,0,0,0
Pizzi,1,1,2019-11-14,1,0,0,0
Gonçalo Paciência,1,1,2019-11-14,1,0,0,0
Mihail Titow,1,1,2019-11-14,1,0,0,0
Han Kwang-song,1,1,2019-11-14,0,1,0,0
Dimitrios Limnios,3,3,2022-06-09,1,2,0,0
Francesco Acerbi,1,1,2019-11-15,0,1,0,0
Jasse Tuominen,1,1,2019-11-15,1,0,0,0
Tore Reginiussen,1,1,2019-11-15,1,0,0,0
Iver Fossum,1,1,2019-11-15,1,0,0,0
Pau Torres,1,1,2019-11-15,1,0,0,0
Pablo Sarabia,7,7,2022-06-12,4,3,0,1
Dani Olmo,9,9,2024-07-09,6,3,0,0
Gerard Moreno,5,4,2021-03-31,4,1,0,0
Cedric Itten,5,4,2023-09-12,3,2,0,0
Stefan Lainer,2,2,2021-06-13,2,0,0,0
Vlatko Stojanovski,2,2,2020-11-15,1,1,0,0
Ryan Christie,5,5,2022-09-24,2,3,0,3
Matthias Ginter,2,2,2020-10-10,1,1,0,0
Georgi Dzhikiya,2,2,2021-10-11,1,1,0,0
Filippo Berardi,2,2,2023-11-20,2,0,0,1
Corentin Tolisso,1,1,2019-11-17,0,1,0,0
Enes Ünal,2,1,2019-11-17,0,2,0,1
Harry Winks,1,1,2019-11-17,0,1,0,0
Mason Mount,5,5,2022-09-26,3,2,0,0
Bruno Fernandes,14,11,2024-06-22,9,5,0,1
Nicolae Milinceanu,2,2,2021-09-07,1,1,0,0
Ruben Vargas,6,6,2024-06-29,4,2,0,0
Christian Fassnacht,2,2,2021-10-09,1,1,0,0
Reece Styche,3,3,2021-09-07,1,2,0,1
Loris Benito,1,1,2019-11-18,0,1,0,0
Konstantinos Galanopoulos,1,1,2019-11-18,1,0,0,0
Nicolò Zaniolo,2,1,2019-11-18,2,0,0,0
Riccardo Orsolini,1,1,2019-11-18,1,0,0,0
Edgar Babayan,1,1,2019-11-18,0,1,0,0
Federico Chiesa,7,6,2023-11-17,6,1,0,0
Eldar Ćivić,1,1,2019-11-18,0,1,0,0
Paul Fenech,1,1,2019-11-18,1,0,0,0
Matt Doherty,2,2,2023-10-16,1,1,0,0
Fabián Ruiz,3,3,2024-06-30,3,0,0,0
Adrian Rus,1,1,2019-11-18,1,0,1,0
Sebastian Andersson,1,1,2019-11-18,1,0,0,0
Mattias Svanberg,1,1,2019-11-18,1,0,0,0
John Guidetti,1,1,2019-11-18,1,0,0,0
Kypros Christoforou,1,1,2019-11-19,1,0,1,0
Michael Smith,1,1,2019-11-19,0,1,0,0
James Ha,1,1,2019-11-19,1,0,0,0
Roberto Orlando Affonso Júnior,1,1,2019-11-19,1,0,0,0
Salem Al-Ajalin,1,1,2019-11-19,1,0,0,0
Jahongir Ergashev,1,1,2019-11-19,0,1,0,0
Tamirlan Kozubaev,1,1,2019-11-19,1,0,0,0
Mārcis Ošs,1,1,2019-11-19,1,0,0,0
Ali Samooh,1,1,2019-11-19,1,0,0,0
John Matkin,1,1,2019-11-19,0,1,0,0
Hlaing Bo Bo,2,2,2021-06-11,2,0,0,0
Nathan Aké,3,2,2023-03-27,3,0,0,0
Myron Boadu,1,1,2019-11-19,1,0,0,0
Sebastian Szymański,3,3,2024-03-21,2,1,0,0
Jacek Góralski,1,1,2019-11-19,1,0,0,0
Daler Kuzyayev,2,2,2020-11-15,0,2,0,0
Sergei Petrov,1,1,2019-11-19,0,1,0,0
Aleksei Miranchuk,2,2,2021-06-16,1,1,0,0
Nikolay Komlichenko,1,1,2019-11-19,0,1,0,0
Ward Al Salama,1,1,2019-11-19,1,0,0,0
Abdy Bäşimow,1,1,2019-11-19,1,0,0,0
Hafiz Nor,1,1,2019-11-19,0,1,0,0
Nasser Al-Gahwashi,1,1,2019-11-19,1,0,0,0
Jurgen Degabriele,3,3,2021-10-11,1,2,0,0
Andreas Olsen,1,1,2020-09-03,1,0,0,0
Brandur Hendriksson,1,1,2020-09-03,1,0,0,0
José Gayà,2,2,2021-09-05,1,1,0,0
Ion Nicolaescu,13,12,2023-10-15,8,5,0,4
Vyacheslav Karavayev,1,1,2020-09-03,1,0,0,0
Steven Bergwijn,5,5,2023-06-18,3,2,0,0
Erling Haaland,23,14,2023-10-12,14,9,0,5
Gavin Whyte,2,2,2022-09-24,1,1,0,0
Vladimír Coufal,1,1,2020-09-04,0,1,0,0
Ivan Schranz,6,6,2024-06-30,3,3,0,0
Anton Kryvotsyuk,2,2,2023-06-17,1,1,1,0
Jason Denayer,1,1,2020-09-05,0,1,0,0
Graeme Torrilla,2,2,2022-06-12,2,0,1,0
Diogo Jota,12,9,2023-09-11,6,6,0,0
João Félix,6,6,2023-10-16,3,3,0,0
Dimitris Siovas,1,1,2020-09-06,0,1,0,0
Bernard Berisha,1,1,2020-09-06,1,0,0,0
Matthew Guillaumier,3,3,2022-06-05,1,2,1,0
Damjan Bohar,1,1,2020-09-06,1,0,0,0
Ansu Fati,1,1,2020-09-06,1,0,0,0
Ferran Torres,18,13,2024-06-24,12,6,0,1
Silvan Widmer,3,3,2023-03-28,2,1,0,0
Neco Williams,4,4,2024-03-21,4,0,0,0
Denis Alibec,4,4,2023-11-21,2,2,0,0
Christoph Baumgartner,10,9,2024-06-21,6,4,0,0
Dragoș Grigore,1,1,2020-09-07,0,1,0,0
Karim Onisiwo,1,1,2020-09-07,1,0,0,0
Haris Hajradinović,1,1,2020-09-07,1,0,0,1
Jakub Pešek,3,3,2022-06-05,3,0,0,0
Lyndon Dykes,9,8,2023-06-17,5,4,0,1
Michal Ďuriš,2,2,2020-11-12,0,2,0,0
Ilay Elmkies,1,1,2020-09-07,1,0,0,0
Abat Aymbetov,8,7,2023-11-17,6,2,0,1
Vitaly Lisakovich,5,4,2021-09-05,3,2,0,3
Wbeimar Angulo Mosquera,1,1,2020-09-08,1,0,0,0
Hólmbert Friðjónsson,1,1,2020-09-08,0,1,0,0
Jérémy Doku,2,2,2021-03-30,2,0,0,0
Dominik Livaković,1,1,2020-09-08,1,0,1,0
Josip Brekalo,2,2,2021-03-30,1,1,0,0
Dayot Upamecano,2,2,2023-03-24,2,0,0,0
Zsolt Kalmár,2,2,2020-11-15,1,1,0,0
Georgi Yomov,1,1,2020-10-08,1,0,0,0
Florent Hadergjonaj,1,1,2020-10-08,0,1,0,0
Sergej Milinković-Savić,6,5,2022-11-28,1,5,0,0
Mathias Normann,1,1,2020-10-08,1,0,0,0
Maxi Gómez,1,1,2020-10-08,1,0,0,0
José María Carrasco,1,1,2020-10-09,1,0,1,0
Luis Muriel,3,2,2021-06-08,3,0,0,1
Odmar Færø,2,2,2023-06-20,2,0,0,0
Igor Ivanović,2,2,2020-10-13,2,0,0,0
Khoren Bayramyan,2,2,2021-03-28,2,0,0,0
Märten Kuusk,1,1,2020-10-11,0,1,1,0
Rauno Sappinen,9,8,2023-06-17,5,4,0,1
Frank Liivak,1,1,2020-10-11,1,0,0,1
Gjoko Zajkov,1,1,2020-10-11,0,1,0,0
Robert Taylor,2,2,2023-10-17,2,0,0,0
Tasos Bakasetas,11,11,2023-11-21,5,6,0,4
Rúnar Már Sigurjónsson,2,2,2021-03-31,0,2,1,1
Joel Abu Hanna,1,1,2020-10-11,0,1,1,0
Haris Vučkić,4,2,2020-10-14,0,4,0,2
Alyaksandr Sachywka,1,1,2020-10-11,0,1,0,0
Kenan Karaman,4,4,2021-09-04,2,2,0,0
Norbert Könyves,1,1,2020-10-11,0,1,0,0
Joaquín Correa,2,2,2021-09-02,0,2,0,0
Jefferson Lerma,3,3,2024-07-10,1,2,0,0
Moisés Caicedo,3,3,2022-11-29,2,1,0,0
Michael Estrada,6,5,2022-02-01,5,1,0,0
Gonzalo Plata,4,4,2021-06-20,3,1,0,0
Kai Havertz,12,10,2024-06-29,6,6,0,2
Edvin Muratović,1,1,2020-10-13,0,1,0,0
Gastón Giménez,1,1,2020-10-13,0,1,0,0
Yevgeniy Yablonskiy,2,2,2020-11-15,2,0,0,0
Roman Yuzepchuk,1,1,2020-10-14,1,0,0,0
Jonny Williams,2,2,2022-06-01,0,2,0,0
Donny van de Beek,2,2,2021-03-30,0,2,0,0
Sandi Lovrić,4,4,2023-09-10,2,2,0,1
Khvicha Kvaratskhelia,15,13,2024-06-26,9,6,0,2
Karol Linetty,4,4,2021-09-05,3,1,0,0
Nicolás González,3,3,2022-03-25,2,1,0,0
Beder Caicedo,1,1,2020-11-12,0,1,0,0
Carlos Gruezo,1,1,2020-11-12,0,1,0,1
Loïc Négo,2,2,2021-03-31,1,1,0,0
Milan Škriniar,5,5,2021-10-08,4,1,2,0
Darwin Núñez,3,3,2024-06-27,2,1,0,0
Gunnar Vatnhamar,1,1,2020-11-14,0,1,0,0
Emili García,1,1,2020-11-14,1,0,1,0
Shaun Dimech,1,1,2020-11-14,1,0,0,0
N'Golo Kanté,1,1,2020-11-14,0,1,0,0
Dejan Kulusevski,3,3,2023-09-09,1,2,0,0
Ardian Ismajli,1,1,2020-11-15,1,0,0,0
Aybol Abiken,1,1,2020-11-15,0,1,0,0
Adrian Grbić,2,2,2020-11-18,2,0,0,0
Max Ebong,5,5,2023-10-15,3,2,0,0
Dimitar Iliev,1,1,2020-11-15,1,0,0,1
Domenico Berardi,6,5,2023-10-14,5,1,0,1
Smail Prevljak,5,4,2022-06-07,1,4,0,0
Jasmin Kurtić,1,1,2020-11-15,1,0,0,0
Antonijs Černomordijs,1,1,2020-11-17,0,1,0,0
Vladislavs Gutkovskis,9,6,2022-09-25,2,7,0,2
Raimonds Krollis,3,3,2022-11-16,1,2,0,1
Mateo Kovačić,4,2,2023-03-28,2,2,0,0
Rúben Dias,3,2,2021-06-19,1,2,1,0
Robert Arboleda,1,1,2020-11-17,1,0,0,0
Xavier Arreaga,1,1,2020-11-17,1,0,0,0
Pervis Estupiñán,2,2,2021-11-16,1,1,0,0
Noah Frommelt,2,2,2021-03-25,1,1,2,0
Noah Frick,2,2,2021-09-08,0,2,0,0
Ári Jónsson,1,1,2020-11-17,0,1,0,0
Aleksandar Boljević,2,1,2020-11-17,2,0,0,0
Boris Céspedes,1,1,2020-11-17,0,1,0,0
Alejandro Romero Gamarra,3,3,2021-09-09,3,0,0,0
Rodri,2,2,2024-06-30,2,0,0,0
Arthur Melo,1,1,2020-11-17,0,1,0,0
Luis Mago,1,1,2020-11-17,1,0,0,0
Ghayas Zahid,1,1,2020-11-18,0,1,0,0
Jonas Wind,7,7,2023-10-14,4,3,0,0
Declan Rice,3,3,2023-03-23,1,2,0,0
Phil Foden,3,2,2022-11-29,2,1,0,0
Dávid Sigér,1,1,2020-11-18,1,0,0,0
Kevin Varga,1,1,2020-11-18,1,0,0,0
Manor Solomon,6,5,2023-06-19,3,3,0,0
Modestas Vorobjovas,1,1,2020-11-18,0,1,0,0
Lirim Kastrati,1,1,2020-11-18,1,0,0,0
Liam Boyce,1,1,2020-11-18,1,0,0,0
Eric Bicfalvi,1,1,2020-11-18,0,1,0,0
Kamil Jóźwiak,3,3,2021-11-12,1,2,0,0
Dušan Vlahović,10,8,2023-03-27,6,4,0,1
Filip Mladenović,1,1,2020-11-18,1,0,0,0
Eugene Kirwan,1,1,2021-03-24,1,0,0,0
D'Andre Bishop,1,1,2021-03-24,1,0,0,0
Fran Núñez,1,1,2021-03-24,1,0,0,0
Miroslav Stevanović,2,2,2023-10-13,0,2,0,0
Kristian Thorstvedt,3,3,2021-10-08,1,2,0,0
Jonas Svensson,1,1,2021-03-24,0,1,0,0
Luis Martínez,2,2,2021-06-04,2,0,0,0
Joseph Mbong,2,2,2021-09-01,2,0,0,0
Aleksandr Sobolev,1,1,2021-03-24,0,1,0,0
Vinceroy Nelson,1,1,2021-03-24,1,0,0,0
Alan Browne,2,2,2022-06-11,1,1,0,0
Shaquille Pinas,2,2,2021-06-04,2,0,0,0
Ryan Donk,1,1,2021-03-24,1,0,0,1
Gleofilo Vlijter,3,3,2021-07-20,3,0,0,0
Richie Laryea,1,1,2021-03-25,1,0,0,0
Kane Crichlow,3,2,2021-03-30,2,1,0,0
Theo Corbeanu,2,2,2021-07-11,2,0,0,0
Juninho Bacuna,2,1,2021-03-25,2,0,0,0
Anthony van den Hurk,1,1,2021-03-25,1,0,0,0
Jarchinio Antonia,1,1,2021-03-25,1,0,0,0
Elson Hooi,1,1,2021-03-25,1,0,0,0
David Rugamas,8,5,2021-06-12,2,6,0,0
James Ward-Prowse,2,2,2021-10-09,1,1,0,0
Dominic Calvert-Lewin,2,1,2021-03-25,2,0,0,0
Ollie Watkins,2,2,2024-07-10,1,1,0,0
Ricardo Adé,3,3,2023-06-29,1,2,1,0
Steven Séance,1,1,2021-03-25,1,0,0,0
Meinhard Olsen,1,1,2021-03-25,0,1,0,0
Jair Catuy,2,2,2021-06-05,2,0,0,0
Florin Tănase,2,2,2022-09-23,1,1,0,0
Valentin Mihăilă,4,3,2023-09-12,2,2,0,0
Ianis Hagi,4,4,2023-11-18,2,2,0,0
Saša Kalajdžić,4,3,2021-06-26,1,3,0,0
Shahrom Samiev,2,2,2021-06-15,2,0,0,0
Ryan Telfer,1,1,2021-03-25,1,0,0,0
Dorny Romero,2,1,2021-03-27,0,2,0,1
Nowend Lorenzo,2,1,2021-03-27,0,2,0,0
Luis Espinal,1,1,2021-03-27,0,1,0,0
Nigel Hasselbaink,7,3,2021-07-20,4,3,0,0
Francois Croes,1,1,2021-03-27,0,1,1,0
Florian Jozefzoon,1,1,2021-03-27,0,1,0,0
Roland Alberg,1,1,2021-03-27,0,1,0,0
Keithroy Freeman,4,2,2021-06-04,2,2,0,1
Rowan Liburd,1,1,2021-03-27,0,1,0,1
Omari Sterling-James,1,1,2021-03-27,0,1,0,0
Yury Kendysh,1,1,2021-03-27,1,0,0,0
Darwin Lom,3,3,2023-06-27,2,1,0,0
Moisés Hernández,2,2,2021-06-04,1,1,0,1
Robin Betancourth,2,2,2021-06-04,1,1,0,0
Mario Pašalić,8,8,2023-10-15,4,4,0,0
Lukáš Provod,2,2,2024-06-18,1,1,0,0
Steven Berghuis,2,2,2021-03-30,1,1,0,0
Çağlar Söyüncü,1,1,2021-03-27,0,1,0,0
Luke Gambin,1,1,2021-03-27,0,1,0,0
Alexander Satariano,1,1,2021-03-27,0,1,0,0
David Strelec,2,2,2021-11-11,2,0,0,0
Ariagner Smith,2,1,2021-03-27,0,2,0,0
Marvin Fletes,1,1,2021-03-27,0,1,0,0
Dshon Forbes,1,1,2021-03-27,0,1,0,0
Matias Belli Moldskred,1,1,2021-03-27,0,1,0,0
Aleksandar Dragović,1,1,2021-03-28,1,0,0,0
Manuel Locatelli,3,2,2021-06-16,2,1,0,0
Onel Hernández,2,2,2021-06-02,2,0,0,0
Charlison Benschop,3,2,2021-06-05,0,3,0,1
Mikkel Damsgaard,4,3,2021-07-07,3,1,0,0
Jens Stryger Larsen,2,2,2022-06-06,1,1,0,0
Mathias Jensen,1,1,2021-03-28,1,0,0,0
Marcus Ingvartsen,1,1,2021-03-28,1,0,0,0
Briel Thomas,2,2,2021-06-02,1,1,1,0
Audel Laville,1,1,2021-03-28,1,0,0,0
José Fajardo,5,5,2024-07-01,0,5,0,0
Ousmane Dembélé,2,2,2023-11-18,1,1,0,0
Karol Świderski,9,9,2023-10-15,6,3,0,0
Ricardo Rivera,4,3,2021-06-08,3,1,0,1
Júnior Moraes,1,1,2021-03-28,1,0,0,0
Frank Sturing,1,1,2021-03-29,0,1,0,0
David Wotherspoon,1,1,2021-03-29,0,1,0,0
Mark-Anthony Kaye,2,1,2021-03-29,0,2,0,0
Alistair Johnston,1,1,2021-03-29,0,1,0,0
Emin Mahmudov,7,6,2023-11-16,3,4,0,1
Emile Saimovici,2,2,2021-06-08,2,0,0,0
Hans Vanaken,3,2,2021-09-02,2,1,0,0
Leandro Trossard,6,4,2023-11-19,6,0,0,0
Dennis Praet,2,2,2021-09-08,1,1,0,0
Carlos Bernárdez,2,1,2021-03-30,2,0,0,0
Jesse August,1,1,2021-03-30,1,0,0,0
Deshawon Nembhard,1,1,2021-03-30,1,0,0,0
Jaylon Bather,1,1,2021-03-30,1,0,0,0
Knory Scott,1,1,2021-03-30,1,0,0,0
Ioannis Pittas,2,2,2023-06-17,2,0,0,1
Saydrel Lewis,2,2,2021-06-08,2,0,0,0
Kadell Daniel,1,1,2021-03-30,1,0,0,0
Omari Glasgow,1,1,2021-03-30,1,0,0,0
Hidemasa Morita,3,3,2024-02-03,2,1,0,0
Khash-Erdene Tuya,1,1,2021-03-30,1,0,1,0
Sho Inagaki,2,1,2021-03-30,2,0,0,0
Junya Ito,6,5,2022-02-01,4,2,0,0
Kyogo Furuhashi,3,2,2021-06-07,3,0,0,0
João Palhinha,2,2,2021-10-12,1,1,0,0
Zidane Sam,1,1,2021-03-30,1,0,0,0
Azinho Solomon,1,1,2021-03-30,1,0,0,0
Yasser Al-Shahrani,2,2,2021-09-02,2,0,0,0
Roberts Savaļnieks,1,1,2021-03-30,0,1,0,0
Roberts Uldriķis,5,4,2022-06-03,3,2,0,0
Attila Fiola,2,2,2021-06-19,1,1,0,0
Dániel Gazdag,4,4,2022-06-14,1,3,0,0
Eduard Spertsyan,3,3,2022-09-27,2,1,0,0
Alexandru Cicâldău,2,1,2021-03-31,0,2,0,0
Andreas Skov Olsen,7,6,2022-09-25,4,3,0,0
Joakim Mæhle,9,9,2023-11-17,6,3,0,0
Jakub Moder,1,1,2021-03-31,0,1,0,0
Otar Kakabadze,1,1,2021-03-31,1,0,1,0
Victor Pálsson,1,1,2021-03-31,0,1,0,0
Cătălin Carp,1,1,2021-03-31,1,0,0,0
Myrto Uzuni,3,3,2022-09-24,1,2,0,0
Ché Adams,4,4,2022-06-14,2,2,0,0
Besar Halimi,1,1,2021-03-31,0,1,0,0
Serikzhan Muzhikov,1,1,2021-03-31,0,1,0,0
Ko Itakura,1,1,2021-05-28,1,0,0,0
Jin Jingdao,1,1,2021-05-30,1,0,0,0
Alan Carvalho,3,2,2021-06-11,3,0,0,0
Jonah Ebanks,1,1,2021-06-02,1,0,0,1
Joshua John,2,1,2021-06-02,0,2,0,0
Terence Groothusen,1,1,2021-06-02,0,1,0,0
Luis Paradela,2,2,2023-07-04,1,1,0,1
Cavafe,1,1,2021-06-02,1,0,0,0
Dairon Reyes,1,1,2021-06-02,1,0,0,0
Chad Bertrand,1,1,2021-06-02,1,0,0,0
Julian Wade,2,2,2021-06-08,1,1,0,0
Nathan Pond,1,1,2021-06-02,1,0,0,0
Rohan Ince,1,1,2021-06-02,1,0,0,0
Adrian Clifton,2,1,2021-06-02,2,0,0,0
Gerald Díaz,1,1,2021-06-02,1,0,0,0
Isaac Angking,2,2,2021-06-08,1,1,0,1
Devin Vega,1,1,2021-06-02,1,0,0,0
Jaden Servania,1,1,2021-06-02,1,0,0,0
Lester Hayes III,1,1,2021-06-02,1,0,0,0
Ali Madan,3,2,2024-01-20,3,0,0,0
Jasim Al-Shaikh,1,1,2021-06-03,1,0,0,0
Amredin Sharifi,1,1,2021-06-03,0,1,0,0
Topu Barman,1,1,2021-06-03,1,0,0,0
Jhon Chancellor,2,2,2021-09-09,0,2,0,0
Ali Gholizadeh,3,3,2021-11-16,1,2,0,0
Vahid Amiri,1,1,2021-06-03,1,0,0,0
Cheng Siu Kwan,1,1,2021-06-03,0,1,0,0
Ajdin Hrustic,3,3,2022-06-07,0,3,0,0
Nawayug Shrestha,1,1,2021-06-03,1,0,0,0
Mateus Uribe,2,2,2022-03-24,1,1,0,0
Luis Díaz,9,8,2024-07-06,4,5,0,1
Narubadin Weerawatnodom,1,1,2021-06-03,1,0,0,0
I Kadek Agung Widnyana,1,1,2021-06-03,0,1,0,0
Evan Dimas,1,1,2021-06-03,0,1,0,0
Fábio Virginio de Lima,5,3,2021-06-11,5,0,0,0
Rhys Browne,1,1,2021-06-04,1,0,0,0
Niall Reid-Stephen,1,1,2021-06-04,0,1,0,0
Manny Rodríguez,1,1,2021-06-04,1,0,0,0
Rudy Barrientos,1,1,2021-06-04,1,0,0,0
Oscar Santis,1,1,2021-06-04,1,0,0,0
Gerardo Gordillo,2,2,2021-07-18,2,0,0,0
Marvin Ceballos,1,1,2021-06-04,1,0,0,1
Jorge Estuardo Vargas,1,1,2021-06-04,1,0,0,0
John Méndez,1,1,2021-06-04,1,0,0,0
Markas Beneta,1,1,2021-06-04,1,0,1,0
Paulius Golubickas,1,1,2021-06-04,0,1,0,0
Eduards Emsis,2,2,2023-06-16,2,0,0,0
Aias Aosman,2,2,2021-06-15,0,2,0,1
Richard Rodríguez,1,1,2021-06-04,1,0,0,0
Byron Bonilla,1,1,2021-06-04,1,0,0,0
Sheraldo Becker,2,1,2021-06-04,2,0,0,0
Zachary Brault-Guillard,1,1,2021-06-05,0,1,0,0
Brandley Kuwas,1,1,2021-06-05,0,1,0,0
Michaël Maria,2,1,2021-06-05,0,2,0,0
Kenji Gorré,2,1,2021-06-05,0,2,0,0
Ahmed Waseem Razeek,2,1,2021-06-05,0,2,0,1
Mohamad Kdouh,3,2,2021-10-12,1,2,0,0
Cecilio Waterman,7,6,2021-11-16,5,2,0,0
Jorman Aguilar,1,1,2021-06-05,1,0,0,0
Tafari Smith,1,1,2021-06-05,1,0,1,0
Francisco Palacios,1,1,2021-06-05,1,0,0,0
Carnejy Antoine,4,2,2021-07-18,0,4,0,0
Marvin Monterrosa,2,1,2021-06-05,0,2,0,0
Juan Carlos Portillo,1,1,2021-06-05,0,1,0,0
Joshua Pérez,3,3,2021-06-15,1,2,0,0
Mitchell Duke,6,5,2022-11-26,4,2,0,0
Gao Wei-jie,1,1,2021-06-07,0,1,0,0
Wu Xinghan,1,1,2021-06-07,1,0,0,0
Mardik Mardikian,3,2,2022-03-24,0,3,0,1
Safaa Hadi,1,1,2021-06-07,1,0,0,0
Ehson Panjshanbe,1,1,2021-06-07,0,1,0,0
Kento Hashimoto,1,1,2021-06-07,1,0,0,0
Hayao Kawabe,1,1,2021-06-07,1,0,0,0
Oyunbaataryn Mijiddorj,1,1,2021-06-07,0,1,0,0
Yazan Al-Arab,3,3,2024-01-29,0,3,1,0
Caio Canedo,4,4,2022-06-07,4,0,0,0
Suphanat Mueanta,1,1,2021-06-07,0,1,0,0
Mohammed Jumaa,1,1,2021-06-07,1,0,0,0
Irfan Fandi,1,1,2021-06-07,1,0,1,0
Vũ Văn Thanh,1,1,2021-06-07,1,0,0,0
Kole Hall,1,1,2021-06-08,1,0,0,0
Cristian Romero,1,1,2021-06-08,0,1,0,0
Leandro Paredes,1,1,2021-06-08,0,1,0,0
Miguel Borja,6,5,2024-07-06,6,0,0,3
Luis Advíncula,1,1,2021-06-08,0,1,0,0
Eriq Zavaleta,2,2,2022-03-24,1,1,0,0
Walmer Martinez,2,2,2021-07-14,1,1,0,0
Derrick Etienne,1,1,2021-06-08,1,0,0,0
Lucas Paquetá,7,7,2024-06-28,4,3,0,1
Duane Muckette,1,1,2021-06-08,1,0,0,0
Lee Dong-gyeong,1,1,2021-06-09,1,0,0,0
Jeong Sang-bin,1,1,2021-06-09,1,0,0,0
Zafar Babajanow,1,1,2021-06-09,1,0,0,0
Rabih Ataya,1,1,2021-06-09,0,1,0,0
Soony Saad,4,4,2021-11-11,1,3,0,0
Güýçmyrat Annagulyýew,1,1,2021-06-09,1,0,0,0
Abdullah Fawaz,5,3,2022-03-29,3,2,0,1
Omid Popalzay,1,1,2021-06-11,1,0,0,0
Shojae Khalilzadeh,2,2,2024-01-14,1,1,0,0
Sor Rotana,1,1,2021-06-11,0,1,1,0
Milad Mohammadi,1,1,2021-06-11,0,1,0,0
Kaveh Rezaei,2,1,2021-06-11,0,2,0,0
Mehdi Ghayedi,3,3,2024-01-19,1,2,0,0
Liu Binbin,1,1,2021-06-11,1,0,0,0
Zhang Yuning,3,3,2021-10-07,3,0,0,0
Tan Long,1,1,2021-06-11,1,0,0,0
Fung Hing Wa,1,1,2021-06-11,0,1,1,0
Merih Demiral,6,5,2024-07-02,4,2,2,0
Guilherme de Paula Lucrécio,1,1,2021-06-11,1,0,0,1
Farhat Musabekov,1,1,2021-06-11,0,1,0,0
Abay Bokoleyev,1,1,2021-06-11,0,1,0,0
Fran Karačić,1,1,2021-06-11,0,1,0,0
Martin Boyle,5,5,2024-01-28,4,1,0,1
Mark Hartmann,1,1,2021-06-11,1,0,0,0
Sebastián Tagliabúe,1,1,2021-06-11,1,0,0,0
Rangelo Janga,1,1,2021-06-12,0,1,0,0
Wout Weghorst,8,7,2024-06-16,5,3,0,0
Denzel Dumfries,6,6,2022-12-03,5,1,0,0
Maher Sabra,2,2,2022-02-01,2,0,1,0
Erwin Saavedra,2,2,2021-06-28,0,2,0,1
Wojciech Szczęsny,1,1,2021-06-14,0,1,1,0
Hashim Sayed Isa,2,1,2021-06-15,2,0,0,1
Mohammed Al-Ghafri,1,1,2021-06-15,0,1,0,0
Khalid Al-Hajri,3,2,2022-03-24,0,3,0,0
Josué Duverger,1,1,2021-06-15,1,0,1,0
Raphaël Guerreiro,3,3,2022-12-06,2,1,1,0
Ovays Azizi,1,1,2021-06-15,1,0,1,0
Hossein Zamani,1,1,2021-06-15,0,1,0,0
Ado Onaiwu,3,1,2021-06-15,3,0,0,1
Sho Sasaki,1,1,2021-06-15,1,0,0,0
Ali Fasir,1,1,2021-06-15,0,1,0,0
Ali Al-Hassan,1,1,2021-06-15,1,0,0,0
Komron Tursunov,1,1,2021-06-15,1,0,0,0
Sheriddin Boboev,1,1,2021-06-15,1,0,0,0
Ali Salmeen,1,1,2021-06-15,1,0,0,0
Trần Minh Vương,1,1,2021-06-15,0,1,0,0
Alex Sandro,1,1,2021-06-17,1,0,0,0
Éverton Ribeiro,3,3,2021-09-09,2,1,0,0
Guido Rodríguez,1,1,2021-06-18,1,0,0,0
Ben Brereton Díaz,4,4,2022-01-27,4,0,0,0
Robin Gosens,1,1,2021-06-19,1,0,0,0
Sergio Peña,3,3,2021-11-11,2,1,0,0
Matteo Pessina,3,3,2023-03-26,2,1,0,0
İrfan Kahveci,2,2,2023-06-16,0,2,0,0
Ayrton Preciado,2,2,2021-06-23,1,1,0,0
Edson Castillo,1,1,2021-06-20,1,0,0,0
Ronald Hernández,1,1,2021-06-20,1,0,0,0
Papu Gómez,2,2,2021-06-28,2,0,0,0
Lukáš Hrádecký,1,1,2021-06-21,0,1,1,0
Callum McGregor,3,3,2023-06-20,3,0,0,0
Gianluca Lapadula,6,6,2022-03-29,4,2,0,0
András Schäfer,2,2,2021-11-15,0,2,0,0
Martin Dúbravka,1,1,2021-06-23,1,0,1,0
Aymeric Laporte,1,1,2021-06-23,1,0,0,0
Jairo Quinteros,1,1,2021-06-24,0,1,1,0
Braian Samudio,1,1,2021-06-24,0,1,0,0
Miguel Almirón,2,2,2022-03-24,1,1,0,1
Éder Militão,1,1,2021-06-27,1,0,0,0
Tomáš Holeš,1,1,2021-06-27,0,1,0,0
Pedri,1,1,2021-06-28,1,0,1,0
César Azpilicueta,1,1,2021-06-28,0,1,0,0
Mislav Oršić,2,2,2022-12-17,2,0,0,0
Artem Dovbyk,8,7,2024-03-21,1,7,0,1
Gabriel Ávalos,1,1,2021-07-02,0,1,0,0
Rodrigo De Paul,2,2,2021-10-10,2,0,0,0
Emmanuel Rivière,2,2,2021-07-15,0,2,0,1
Jonathan Osorio,3,3,2023-07-04,2,1,0,0
Stephen Eustáquio,3,3,2021-07-25,1,2,0,0
Alex Roldan,2,2,2021-11-12,2,0,0,0
Joaquín Rivas,3,2,2021-07-24,1,2,0,0
Luke Shaw,2,2,2022-09-26,2,0,0,0
Sam Vines,1,1,2021-07-11,1,0,0,0
Ariel Lassiter,1,1,2021-07-12,1,0,0,0
Raphaël Mirval,1,1,2021-07-12,0,1,0,0
Bobby Decordova-Reid,1,1,2021-07-12,1,0,0,0
Edwin Solano,1,1,2021-07-13,1,0,0,0
Johnny Leverón,1,1,2021-07-13,1,0,0,0
Rogelio Funes Mori,4,3,2021-10-10,2,2,0,0
Jairo Henríquez,3,3,2021-11-16,0,3,0,0
Stéphane Lambese,1,1,2021-07-15,1,0,0,0
Daryl Dike,2,1,2021-07-15,2,0,0,0
Samuel Camille,1,1,2021-07-15,1,0,1,0
Miles Robinson,2,2,2021-08-01,2,0,0,0
Nicholas Gioacchini,1,1,2021-07-15,1,0,0,0
Dimitri Ramothe,1,1,2021-07-16,1,0,0,0
Cory Burke,2,2,2023-07-02,1,1,0,0
Junior Flemmings,1,1,2021-07-16,0,1,0,0
César Yanis,3,3,2024-07-01,1,2,0,0
Reon Moore,1,1,2021-07-18,0,1,0,0
Luis Alfonso Rodríguez,1,1,2021-07-18,1,0,0,0
Shaq Moore,1,1,2021-07-18,1,0,0,0
Homam Ahmed,1,1,2021-07-20,0,1,0,0
José Luis Rodríguez,2,1,2021-07-20,2,0,0,0
Romar Frank,1,1,2021-07-20,0,1,0,0
Matthias Phaëton,3,2,2023-07-01,0,3,0,0
Matthew Hoppe,1,1,2021-07-25,1,0,0,0
Tajon Buchanan,4,4,2022-03-27,3,1,0,0
Júlio Tavares,3,3,2022-01-09,1,2,0,0
Tresór Toropité,1,1,2021-09-01,1,0,0,0
Daniel Wass,1,1,2021-09-01,1,0,0,0
Mohamed Magdy,2,2,2021-11-16,2,0,0,2
Ruslan Valiullin,2,1,2021-09-01,2,0,0,0
Danylo Sikan,1,1,2021-09-01,0,1,0,0
Andrejs Cigaņiks,3,3,2024-06-11,3,0,0,0
André Biyogo Poko,1,1,2021-09-01,0,1,0,0
Ali Salama,1,1,2021-09-01,1,0,0,0
Sanad Al Warfali,2,2,2021-11-16,2,0,0,1
Mica Pinto,1,1,2021-09-01,1,0,0,0
Cain Attard,2,1,2021-09-01,2,0,0,0
John Egan,3,3,2022-09-27,1,2,0,0
Abdou Diallo,2,2,2022-02-02,1,1,0,0
Adam Marušić,3,3,2022-06-11,1,2,0,0
Risto Radunović,1,1,2021-09-01,0,1,0,0
Ramy Bensebaini,1,1,2021-09-02,1,0,0,0
Ramiz Zerrouki,1,1,2021-09-02,1,0,0,0
Fernando Saucedo,1,1,2021-09-02,1,0,0,0
Félix Torres,2,2,2022-01-27,2,0,0,0
Thomas Foket,1,1,2021-09-02,0,1,0,0
Atanas Iliev,2,2,2022-06-05,1,1,0,0
Issam Al Sabhi,2,2,2021-10-12,1,1,0,0
Daniel Ballard,2,2,2022-06-09,0,2,0,0
Shayne Lavery,3,3,2022-09-27,0,3,0,0
Steve Mounié,3,3,2021-11-11,1,2,0,0
Henry Martín,5,5,2023-07-12,1,4,0,0
Nayef Aguerd,3,3,2022-12-01,3,0,2,0
Abuaagla Abdalla,1,1,2021-09-02,1,0,1,0
Charles Hambira,2,1,2021-09-02,1,1,1,0
Lassina Traoré,1,1,2021-09-02,0,1,0,1
Mohamed Konaté,3,3,2024-01-20,0,3,0,0
Giorgian de Arrascaeta,7,5,2022-12-02,4,3,0,1
Adam Buksa,7,5,2024-06-16,3,4,0,0
Carlos Soler,4,4,2022-11-23,3,1,0,0
Ángel Correa,1,1,2021-09-02,0,1,0,0
Yeferson Soteldo,1,1,2021-09-02,1,0,0,1
Prince Mumba,1,1,2021-09-03,0,1,0,0
Mamadou Niass,1,1,2021-09-03,1,0,0,0
Ellyes Skhiri,2,2,2021-10-07,2,0,0,0
Aleksandr Yerokhin,3,2,2021-11-11,2,1,0,0
Rifat Zhemaletdinov,1,1,2021-09-04,0,1,0,0
Halil Dervişoğlu,5,4,2022-06-07,3,2,0,0
Shon Weissman,6,6,2023-11-15,5,1,0,1
Cody Gakpo,12,12,2024-07-02,5,7,0,1
Mykola Shaparenko,2,2,2024-06-21,1,1,0,0
Anthony Martial,1,1,2021-09-04,0,1,0,0
Armando Broja,4,4,2022-06-10,3,1,0,1
Pavel Sedko,1,1,2021-09-05,1,0,0,0
Alexis Saelemaekers,1,1,2021-09-05,1,0,0,0
Bukayo Saka,11,8,2024-07-06,9,2,0,0
Jim Allevinah,4,4,2022-01-18,3,1,0,0
Mostafa Mohamed,6,6,2024-01-28,3,3,0,1
Jonas Hofmann,4,4,2022-06-11,2,2,0,0
Karim Adeyemi,1,1,2021-09-05,1,0,0,0
Brynjar Ingi Bjarnason,1,1,2021-09-05,1,0,0,0
Andri Guðjohnsen,4,4,2023-11-16,2,2,0,0
Andrés Andrade,1,1,2021-09-05,0,1,0,0
Anastasios Douvikas,1,1,2021-09-05,0,1,0,0
Alin Toșca,1,1,2021-09-05,1,0,0,0
Cristian Manea,1,1,2021-09-05,1,0,0,0
Abdul Rwatubyaye,1,1,2021-09-05,1,0,0,0
Nicola Nanni,1,1,2021-09-05,1,0,0,0
Elmo Kambindu,1,1,2021-09-05,0,1,0,0
Brenden Aaronson,2,2,2021-09-08,1,1,0,0
Agustín Álvarez,1,1,2021-09-05,1,0,0,0
Jordan Adéoti,1,1,2021-09-06,1,0,0,0
Anas Farah Ali,1,1,2021-09-06,1,0,0,0
Victorien Adebayor,5,2,2021-11-15,3,2,0,0
Mohamed Wonkoye,2,2,2021-11-15,1,1,0,1
Amadou Sabo,1,1,2021-09-06,0,1,0,0
Warsama Hassan,1,1,2021-09-06,1,0,0,0
Sébastien Haller,5,4,2024-02-11,5,0,0,1
Moumi Ngamaleu,1,1,2021-09-06,0,1,0,1
Kpah Sherman,1,1,2021-09-06,1,0,0,0
Bongokuhle Hlongwane,1,1,2021-09-06,1,0,0,0
Omar Al Khouja,1,1,2021-09-07,0,1,0,0
Luka Menalo,3,3,2022-06-11,2,1,0,0
Abdoul Tapsoba,4,3,2021-10-11,2,2,0,0
Dylan Tavares,1,1,2021-09-07,1,0,0,0
Victor Osimhen,5,5,2024-01-14,2,3,0,1
Kenny Rocha Santos,1,1,2021-09-07,0,1,1,0
Boulaye Dia,3,3,2022-11-25,1,2,0,0
Silvère Ganvoula,1,1,2021-09-07,1,0,0,1
Marko Livaja,4,4,2022-11-27,2,2,0,0
Aschalew Tamene,1,1,2021-09-07,1,0,0,1
Heini Vatnsdal,1,1,2021-09-07,1,0,0,0
Richard Mbulu,1,1,2021-09-07,1,0,0,0
Guus Til,1,1,2021-09-07,1,0,0,0
Zelimkhan Bakayev,1,1,2021-09-07,1,0,0,1
Martin Koscelník,1,1,2021-09-07,1,0,0,0
Frédéric Mendy,1,1,2021-09-07,0,1,0,0
Mohamed Abdelrahman,2,1,2021-09-07,2,0,0,0
Mama Baldé,1,1,2021-09-07,0,1,0,0
Mahmoud Al Baher,1,1,2021-09-07,1,0,0,0
Novatus Dismas,1,1,2021-09-07,1,0,0,0
Thomas Fontaine,1,1,2021-09-07,0,1,0,0
Feisal Salum,1,1,2021-09-07,1,0,0,0
Rhyan Grant,1,1,2021-09-07,0,1,0,0
Anis Ben Slimane,1,1,2021-09-07,0,1,0,0
Qazim Laçi,2,2,2024-06-19,1,1,0,0
Jimmy Marín,1,1,2021-09-08,1,0,0,0
Brayan Moya,2,2,2021-11-12,2,0,0,0
Antonee Robinson,2,2,2022-01-27,1,1,0,0
Ricardo Pepi,3,2,2021-10-07,2,1,0,0
Endre Botka,1,1,2021-09-08,1,0,0,0
Max Llovera,1,1,2021-09-08,0,1,0,0
Edgaras Utkus,1,1,2021-09-08,1,0,1,0
Giacomo Raspadori,4,4,2023-11-17,3,1,0,0
Giovanni Di Lorenzo,2,2,2021-11-12,2,0,0,0
Pablo Fornals,1,1,2021-09-08,0,1,0,0
Damian Szymański,2,2,2023-03-24,1,1,0,0
Jean Meneses,1,1,2021-09-09,0,1,0,0
David Martínez,1,1,2021-09-09,1,0,0,0
Gastón Pereiro,1,1,2021-09-09,1,0,0,0
Imran Louza,2,2,2021-11-12,2,0,0,1
Ilias Chair,1,1,2021-10-06,1,0,0,0
Ayoub El Kaabi,5,4,2021-11-16,5,0,0,0
Munir El Haddadi,1,1,2021-10-06,1,0,0,0
Mohamed Bayo,5,5,2024-02-02,1,4,0,1
Seif Teiri,1,1,2021-10-06,1,0,0,0
Théo Hernandez,2,2,2022-12-14,1,1,0,0
Hồ Tấn Tài,2,2,2022-02-01,1,1,0,0
Chadrac Akolo,1,1,2021-10-07,1,0,0,0
Enrico Hernández,1,1,2021-10-07,1,0,0,0
Saúl Coco,2,2,2021-11-16,1,1,0,0
Van-Dave Harmon,1,1,2021-10-07,1,0,0,0
Jamiro Monteiro,2,2,2024-01-14,0,2,0,0
Ibrahima Koné,8,6,2022-01-20,4,4,0,4
Moussa Doumbia,1,1,2021-10-07,1,0,0,0
Jorge Sánchez,1,1,2021-10-07,1,0,0,0
Karl Namnganda,1,1,2021-10-07,0,1,0,0
Fahad Bayo,3,3,2021-11-11,2,1,0,0
Firas Al-Buraikan,3,3,2022-01-27,3,0,0,0
Hwang In-beom,2,2,2024-01-15,2,0,0,0
Seifeddine Jaziri,2,2,2022-01-16,2,0,0,0
Eric Ramírez,2,2,2024-06-30,1,1,0,0
Antony,2,2,2022-02-01,1,1,0,0
Youssouf Oumarou,2,2,2021-11-12,1,1,1,1
Daniel Sosah,2,2,2021-11-15,1,1,0,0
Zakariya Souleymane,1,1,2021-10-08,1,0,1,0
Zini,3,3,2024-01-23,2,1,0,0
Ary Papel,1,1,2021-10-08,1,0,0,0
Jonathan Buatu,1,1,2021-10-08,1,0,0,0
Karl Toko Ekambi,9,7,2024-01-23,7,2,0,0
Joško Gvardiol,2,2,2022-12-17,1,1,0,0
Danny Ward,1,1,2021-10-08,1,0,1,0
Issa Kaboré,1,1,2021-10-08,0,1,0,0
Omar Marmoush,2,2,2024-01-18,2,0,0,0
Ísak Bergmann Jóhannesson,2,2,2022-11-19,1,1,0,1
Darko Churlinov,3,3,2023-03-23,2,1,0,0
Ibrahim Sangaré,2,2,2022-01-20,1,1,0,0
Jérémie Boga,1,1,2021-10-08,0,1,0,0
Benjamin Šeško,9,8,2023-11-20,7,2,0,2
Kerem Aktürkoğlu,6,6,2024-06-18,4,2,0,0
Ben Chilwell,1,1,2021-10-09,0,1,0,0
Jack Grealish,2,2,2022-11-21,1,1,0,0
Callum Robinson,4,3,2023-10-16,0,4,0,0
Chiedozie Ogbene,2,2,2021-11-14,0,2,0,0
Mothobi Mvala,1,1,2021-10-09,0,1,0,0
Evidence Makgopa,2,2,2024-01-30,0,2,0,0
Dimitrios Pelkas,4,4,2024-03-21,3,1,0,0
Mohammed Kudus,5,3,2024-01-18,1,4,0,0
José Kanté,1,1,2021-10-09,1,0,0,0
Ahmed Al-Tash,1,1,2021-10-09,0,1,0,0
Amir Kamal,1,1,2021-10-09,0,1,0,0
Justas Lasickas,1,1,2021-10-09,1,0,0,0
Christian Nørgaard,1,1,2021-10-09,0,1,0,0
Aymen Barkok,1,1,2021-10-09,1,0,0,0
Tomasz Kędziora,1,1,2021-10-09,1,0,0,0
Scott McTominay,9,7,2024-06-19,7,2,0,0
Famara Diédhiou,6,4,2022-11-25,2,4,0,0
Alaixys Romao,1,1,2021-10-09,0,1,1,0
Euloge Placca Fessou,3,3,2021-11-15,1,2,0,0
Ramiro Vaca,1,1,2021-10-10,1,0,0,0
Ryan Mendes,3,3,2024-01-29,3,0,0,1
Leon Balogun,1,1,2021-10-10,0,1,0,0
Charles De Ketelaere,2,2,2023-09-12,1,1,0,0
Sebastián Córdova,1,1,2021-10-10,1,0,0,0
Eduard Bello,3,3,2024-06-30,1,2,0,0
Fashion Sakala,5,3,2021-11-16,4,1,0,1
Federico Bikoro,1,1,2021-10-10,0,1,0,0
Adam Hložek,1,1,2021-10-11,0,1,0,0
Lukáš Haraslín,4,3,2023-11-16,3,1,0,0
Zach Muscat,2,2,2022-06-12,1,1,0,0
Alex Moucketou-Moussounda,1,1,2021-10-11,1,0,0,0
Stefán Teitur Þórðarson,1,1,2021-10-11,1,0,0,0
Nicolas Pépé,3,3,2022-01-20,3,0,0,0
Khuda Muyaba,1,1,2021-10-11,0,1,0,0
Franck Kessié,4,4,2024-02-11,4,0,0,2
Serdar Dursun,6,5,2022-06-11,2,4,0,1
Ahmed Abou El Fotouh,1,1,2021-10-11,0,1,0,0
Ramadan Sobhi,1,1,2021-10-11,0,1,0,0
Arnaut Danjuma,1,1,2021-10-11,1,0,0,0
Jamal Musiala,4,4,2024-06-29,3,1,0,0
Igor Diveyev,1,1,2021-10-11,0,1,0,0
Guy Mbenza,2,2,2021-11-11,2,0,0,0
Kévin Denkey,1,1,2021-10-12,0,1,0,0
Ao Tanaka,2,2,2022-12-01,2,0,0,0
Zuriko Davitashvili,3,3,2023-06-17,0,3,0,0
Renato Steffen,4,2,2023-03-25,0,4,0,0
Mamadou Kané,1,1,2021-10-12,0,1,0,0
Selim Amallah,3,2,2022-01-14,3,0,0,0
Sofiane Boufal,4,4,2022-01-30,2,2,0,2
Ismaël Bennacer,1,1,2021-10-12,0,1,0,0
Salaah Al-Yahyaei,2,2,2024-01-16,1,1,0,2
Sergi Moreno,1,1,2021-10-12,0,1,0,0
Ricard Fernández,1,1,2021-10-12,0,1,0,0
Sami Al-Najei,2,1,2021-10-12,2,0,0,0
Aloísio,1,1,2021-10-12,0,1,0,0
Anel Ahmedhodžić,1,1,2021-10-12,0,1,0,0
Mohammed Al-Attas,1,1,2021-10-12,0,1,1,0
Kemar Roofe,1,1,2021-10-13,0,1,0,0
Oniel Fisher,1,1,2021-10-13,0,1,0,0
Keysher Fuller,2,2,2022-11-27,0,2,0,0
Sergiño Dest,1,1,2021-10-13,1,0,0,0
Leonel Moreira,1,1,2021-10-13,1,0,1,0
Moisés Villarroel Angulo,1,1,2021-10-14,1,0,0,0
Víctor Ábrego,1,1,2021-10-14,1,0,0,0
Roberto Fernández,1,1,2021-10-14,1,0,0,0
Raphinha,4,3,2024-07-02,4,0,0,0
Milan Ristovski,2,2,2022-06-02,0,2,0,0
Azər Salahlı,1,1,2021-11-11,1,0,0,0
Jodel Dossou,1,1,2021-11-11,1,0,0,0
Amjad Al-Harthi,1,1,2021-11-11,0,1,0,0
Piero Hincapié,2,2,2022-03-24,2,0,1,0
Daniel Kaufmann,1,1,2021-11-11,1,0,1,0
Ridle Baku,1,1,2021-11-11,1,0,0,0
Amir Al-Ammari,1,1,2021-11-11,1,0,0,1
Duje Ćaleta-Car,1,1,2021-11-11,0,1,0,0
Lovro Majer,5,4,2023-11-18,2,3,0,0
Andrei Mostovoy,1,1,2021-11-11,1,0,0,0
Aleksei Sutormin,1,1,2021-11-11,1,0,0,0
Anton Zabolotny,1,1,2021-11-11,1,0,0,0
Moussa Djenepo,1,1,2021-11-11,0,1,0,0
Kalifa Coulibaly,2,2,2021-11-14,1,1,0,0
Gaël Kakuta,1,1,2021-11-11,0,1,0,0
Nathan Fasika,1,1,2021-11-11,0,1,0,0
Ben Malango,3,3,2022-03-29,1,2,0,0
Pape Abou Cissé,1,1,2021-11-11,1,0,1,0
Habib Diallo,3,3,2024-01-29,1,2,0,0
Hélder Costa,1,1,2021-11-12,1,0,0,0
M'Bala Nzola,1,1,2021-11-12,1,0,0,1
Akram Tawfik,1,1,2021-11-12,0,1,0,0
Jacob Bruun Larsen,1,1,2021-11-12,1,0,0,0
Saïd Benrahma,1,1,2021-11-12,0,1,0,0
Michail Antonio,4,4,2024-06-26,1,3,0,1
Bálint Vécsei,2,2,2023-03-27,2,0,0,0
Nathan Patterson,1,1,2021-11-12,0,1,0,0
Ryan Mmaee,4,2,2021-11-16,4,0,0,1
Benas Šatkus,1,1,2021-11-12,1,0,1,0
Marcus Forss,1,1,2021-11-13,0,1,0,0
Daniel O'Shaughnessy,1,1,2021-11-13,0,1,0,0
Isaac Ngoma,2,2,2021-11-16,0,2,0,0
Stopira,2,2,2021-11-16,1,1,0,0
Pablo Ganet,3,3,2024-01-22,1,2,0,0
Adrien Rabiot,4,4,2023-11-18,3,1,0,0
Jean Michaël Seri,1,1,2021-11-13,1,0,0,0
Ilija Vukotić,1,1,2021-11-13,1,0,0,0
Nikola Vujnović,1,1,2021-11-13,1,0,0,0
Mert Müldür,3,3,2024-07-06,3,0,1,0
Ben Davies,1,1,2021-11-13,1,0,0,0
Artem Kontsevoy,1,1,2021-11-13,0,1,0,0
Nicușor Bancu,2,2,2022-06-11,1,1,0,0
Hakim Abdallah,1,1,2021-11-14,1,0,0,0
Vernon De Marco,1,1,2021-11-14,0,1,0,0
Jón Dagur Þorsteinsson,3,3,2022-06-13,2,1,0,0
Adam Gnezda Čerin,3,3,2023-10-17,2,1,0,0
Andronikos Kakoullis,3,2,2022-06-12,0,3,0,0
Abubeker Nassir,1,1,2021-11-14,0,1,0,0
Endri Çekiçi,1,1,2021-11-15,1,0,0,1
Christopher Trimmel,1,1,2021-11-15,1,0,0,0
Dejan Ljubičić,1,1,2021-11-15,1,0,0,0
Sølvi Vatnhamar,1,1,2021-11-15,0,1,0,0
Richard Odada,1,1,2021-11-15,1,0,0,1
Olivier Niyonzima,1,1,2021-11-15,0,1,0,0
Youssouf Abdi Ahmed,1,1,2021-11-15,0,1,0,0
Yabe Siad Isman,1,1,2021-11-15,0,1,0,0
Issa Djibrilla,2,1,2021-11-15,2,0,0,0
Filippo Fabbri,1,1,2021-11-15,0,1,1,0
Emile Smith Rowe,1,1,2021-11-15,0,1,0,0
Tyrone Mings,1,1,2021-11-15,0,1,0,0
John Souttar,1,1,2021-11-15,1,0,0,0
Noah Okafor,2,2,2022-06-02,1,1,0,0
Zakaria Sanogo,1,1,2021-11-16,0,1,0,0
Gerson Torres,1,1,2021-11-16,1,0,0,0
Jan Sýkora,1,1,2021-11-16,1,0,0,0
Johann Obiang,1,1,2021-11-16,1,0,1,0
Jeong Woo-yeong,2,2,2024-01-25,1,1,0,0
Timothy Weah,2,2,2022-11-21,1,1,0,0
Aboubakar Kamara,1,1,2021-11-16,1,0,0,0
Orkun Kökçü,2,2,2023-03-25,0,2,0,0
Limbikani Mzava,1,1,2021-11-16,1,0,1,0
Freddy Góndola,1,1,2021-11-16,1,0,0,0
Aïssa Laïdouni,1,1,2021-11-16,1,0,0,0
Mohamed Dräger,1,1,2021-11-16,1,0,0,0
Ali Maâloul,1,1,2021-11-16,1,0,0,0
Gustavo Sangaré,1,1,2022-01-09,0,1,0,0
Aaron Boupendza,1,1,2022-01-10,0,1,0,0
Issiaga Sylla,1,1,2022-01-10,1,0,0,0
Ablie Jallow,3,3,2024-01-23,2,1,0,0
Dawa Hotessa,1,1,2022-01-13,0,1,0,0
Hassane Bandé,1,1,2022-01-13,0,1,0,0
Ishmael Wadi,1,1,2022-01-14,0,1,0,0
Zakaria Aboukhlal,2,2,2022-11-27,1,1,0,0
Taiwo Awoniyi,1,1,2022-01-15,1,0,0,0
Walieldin Khedr,1,1,2022-01-15,0,1,0,1
Esteban Obiang,2,2,2024-01-18,0,2,1,0
Musa Barrow,2,2,2022-01-24,1,1,0,1
Musa Noah Kamara,1,1,2022-01-16,0,1,0,0
Hamza Mathlouthi,1,1,2022-01-16,1,0,0,0
Cyrille Bayala,1,1,2022-01-17,1,0,0,0
El Fardou Ben Nabouhane,1,1,2022-01-18,0,1,0,0
Ahmed Mogni,2,1,2022-01-18,0,2,0,0
Alexander Djiku,2,2,2024-01-14,2,0,0,0
Mohamed Abdelmonem,1,1,2022-01-19,1,0,0,0
Umar Sadiq,1,1,2022-01-19,0,1,0,0
Sofiane Bendebka,1,1,2022-01-20,0,1,0,0
Massadio Haïdara,1,1,2022-01-20,1,0,0,0
Adama Guira,1,1,2022-01-23,0,1,1,0
Youssouf M'Changama,1,1,2022-01-24,0,1,0,0
Bamba Dieng,2,2,2022-11-25,1,1,0,0
Craig Goodwin,4,4,2024-02-02,3,1,0,0
Riley McGree,1,1,2022-01-27,1,0,0,0
Denil Maldonado,1,1,2022-01-27,0,1,1,0
Daniel Johnson,2,2,2023-07-02,2,0,0,0
Cho Gue-sung,4,3,2024-01-30,2,2,0,0
Yahya Al-Ghassani,3,3,2024-01-23,2,1,0,1
Bruno Miranda,2,2,2024-07-01,1,1,0,0
Dango Ouattara,1,1,2022-01-29,1,0,0,0
Sam Adekugbe,1,1,2022-01-30,1,0,0,0
Javain Brown,1,1,2022-01-30,1,0,1,0
Azmahar Ariano,1,1,2022-01-30,1,0,0,0
Andre Gray,2,2,2022-03-24,1,1,0,0
Jannick Buyla,2,2,2024-01-22,0,2,0,0
Marc Enoumba,1,1,2022-02-01,1,0,0,0
Marcelino Núñez,1,1,2022-02-01,0,1,0,0
Rodrygo,1,1,2022-02-01,1,0,0,0
Rodrigo Bentancur,3,3,2024-07-13,2,1,0,0
Phan Văn Đức,1,1,2022-02-01,1,0,0,0
Xu Xin,1,1,2022-02-01,0,1,0,0
Blati Touré,1,1,2022-02-02,1,0,0,0
Walker Zimmerman,1,1,2022-02-02,1,0,0,0
Steeve Yago,1,1,2022-02-05,0,1,0,0
André Onana,1,1,2022-02-05,0,1,1,0
Djibril Ouattara,1,1,2022-02-05,0,1,0,0
Alwin Hou,3,2,2022-03-27,2,1,0,0
Sairusi Nalaubu,2,1,2022-03-18,0,2,0,0
Jordan Wetria,1,1,2022-03-18,1,0,0,0
Ben Waine,5,3,2024-06-27,4,1,0,0
Elijah Just,2,2,2024-06-21,1,1,0,0
Clayton Lewis,1,1,2022-03-21,1,0,0,1
Kaoru Mitoma,2,1,2022-03-24,0,2,0,0
Vinícius Júnior,4,3,2024-06-28,2,2,0,0
Zhu Chenjie,1,1,2022-03-24,1,0,0,1
Tevita Waranaivalu,1,1,2022-03-24,1,0,0,0
Ati Kepo,3,3,2024-06-22,0,3,0,0
Hussein Ali Al-Saedi,1,1,2022-03-24,1,0,0,0
Alaa Al Dali,2,2,2022-03-29,1,1,0,0
Mohammad Al Marmour,1,1,2022-03-24,0,1,0,0
Veaceslav Posmac,1,1,2022-03-24,0,1,1,0
Alex Greive,2,1,2022-03-24,2,0,0,0
Logan Rogerson,1,1,2022-03-24,1,0,0,1
Andre de Jong,1,1,2022-03-24,1,0,0,0
Bill Tuiloma,3,2,2022-03-30,1,2,0,0
Kevin López,1,1,2022-03-24,0,1,0,0
Robert Morales,1,1,2022-03-24,1,0,0,0
Jordy Caicedo,1,1,2022-03-24,0,1,0,1
Otávio,2,2,2023-03-26,1,1,0,0
Matheus Nunes,1,1,2022-03-24,1,0,0,0
Raphael Lea'i,4,2,2022-03-27,4,0,0,0
Yoane Wissa,3,3,2024-02-02,3,0,0,1
Tarik Tissoudali,2,2,2022-03-29,1,1,0,0
Saliou Ciss,1,1,2022-03-25,1,0,1,0
Moussa Sissako,1,1,2022-03-25,0,1,1,0
Anthony Contreras,3,3,2023-07-04,2,1,0,0
Cristian Gil,1,1,2022-03-27,1,0,0,0
Liberato Cacace,1,1,2022-03-27,1,0,0,0
Alwin Komolong,2,2,2024-06-16,1,1,1,0
Jesús Ferreira,8,4,2023-07-12,8,0,0,1
Ahmed Touba,1,1,2022-03-29,1,0,0,0
Bruno Guimarães,1,1,2022-03-29,0,1,0,0
Marinos Tzionis,2,2,2022-09-24,2,0,0,0
Julián Álvarez,7,6,2024-07-09,5,2,0,0
Nguyễn Thanh Bình,1,1,2022-03-29,0,1,0,0
Azzedine Ounahi,3,2,2024-01-17,3,0,0,0
Harib Al-Maazmi,1,1,2022-03-29,1,0,0,0
Juan Pablo Vargas,3,3,2023-07-04,3,0,0,0
Ángel Tejeda,1,1,2022-03-30,0,1,0,1
Leon Bailey,2,2,2023-06-28,2,0,0,1
Ravel Morrison,1,1,2022-03-30,1,0,0,0
Joe Bell,1,1,2022-03-30,0,1,0,0
Matthew Garbett,1,1,2022-03-30,0,1,0,0
Jakub Kamiński,1,1,2022-06-01,1,0,0,0
Edon Zhegrova,2,2,2023-03-28,1,1,0,0
Jan Kuchta,3,3,2023-03-24,3,0,0,0
Djibril Sow,1,1,2022-06-02,1,0,1,0
Robert Kirss,1,1,2022-06-02,1,0,0,0
Georges Mikautadze,7,7,2024-06-26,5,2,0,3
Liel Abada,1,1,2022-06-02,1,0,0,0
Þórir Jóhann Helgason,2,2,2022-06-13,1,1,0,0
Ricardo Horta,4,4,2023-11-19,2,2,0,0
Tomáš Suslov,2,2,2023-06-17,0,2,0,0
Vadim Bolohan,1,1,2022-06-03,0,1,0,0
Marko Vukčević,1,1,2022-06-04,1,0,0,0
Andrea Hristov,1,1,2022-06-05,0,1,1,0
Budu Zivzivadze,5,4,2024-03-21,2,3,0,0
Iliyan Stefanov,2,2,2022-09-23,2,0,0,0
Gavi,4,4,2023-10-15,2,2,0,0
Iñigo Martínez,1,1,2022-06-05,0,1,0,0
Jan Busuttil,1,1,2022-06-05,0,1,0,0
Anthony Elanga,2,2,2023-03-27,2,0,0,0
Taulant Seferi,3,2,2023-10-12,2,1,0,0
Aslan Darabayev,1,1,2022-06-06,0,1,0,0
Gianluca Mancini,1,1,2022-06-07,0,1,1,0
Doğukan Sinik,2,1,2022-06-07,0,2,0,0
Yunus Akgün,2,2,2023-10-15,1,1,0,0
Leander Dendoncker,1,1,2022-06-08,1,0,0,0
Loïs Openda,1,1,2022-06-08,1,0,0,0
Anthony Ralston,1,1,2022-06-08,1,0,0,0
Scott McKenna,1,1,2022-06-08,1,0,0,0
Teun Koopmeiners,2,2,2023-11-21,0,2,0,0
Rhys Norrington-Davies,1,1,2022-06-08,1,0,0,0
Georgi Minchev,1,1,2022-06-09,0,1,0,0
Zymer Bytyqi,1,1,2022-06-09,1,0,0,0
Karl Hein,1,1,2022-06-09,1,0,1,0
Otar Kiteishvili,2,2,2023-10-15,1,1,0,0
Jesús Rubio,1,1,2022-06-10,1,0,0,0
Livio Meier,1,1,2022-06-10,0,1,0,0
Andreas Weimann,1,1,2022-06-10,1,0,0,0
Vladislav Malkevich,1,1,2022-06-10,1,0,0,0
Nichita Moțpan,1,1,2022-06-10,1,0,0,0
Jákup Andreasen,2,2,2022-09-22,1,1,0,0
Zsolt Nagy,2,2,2022-06-14,1,1,0,0
Matty Cash,1,1,2022-06-11,0,1,0,0
Troy Parrott,1,1,2022-06-11,1,0,0,0
Michael Obafemi,2,2,2022-09-27,2,0,0,0
Oleksandr Karavayev,2,2,2023-10-14,2,0,0,0
Vitaliy Mykolenko,1,1,2022-06-11,1,0,0,0
Brennan Johnson,3,3,2024-03-21,2,1,0,0
Giorgos Giakoumakis,2,2,2023-10-13,1,1,0,0
Bojan Miovski,2,2,2022-09-23,2,0,1,0
Viktor Gyökeres,4,4,2023-10-16,1,3,0,0
Andrija Živković,1,1,2022-06-12,0,1,0,0
Daníel Leó Grétarsson,1,1,2022-06-13,0,1,1,0
Elkhan Astanov,1,1,2022-06-13,1,0,0,0
Matúš Bero,1,1,2022-06-13,0,1,0,0
Vahan Bichakhchyan,1,1,2022-06-14,1,0,0,0
Wilfried Gnonto,1,1,2022-06-14,0,1,0,0
Alessandro Bastoni,2,2,2024-06-15,1,1,0,0
Jóannes Bjartalíð,2,1,2022-06-14,0,2,0,0
Mihail Caimacov,1,1,2022-06-14,1,0,0,1
Márcio Vieira,2,2,2023-06-16,1,1,0,0
Noa Lang,2,2,2023-06-14,2,0,0,0
Nathan Collins,2,2,2023-06-16,0,2,0,0
Borna Sosa,1,1,2022-09-22,1,0,0,0
Mikhail Gabyshev,1,1,2022-09-22,1,0,0,0
Ioan-Călin Revenco,1,1,2022-09-22,0,1,0,0
Albert Rosas,4,4,2023-06-19,1,3,0,0
Joan Cervós,2,2,2023-11-21,0,2,1,0
Renat Dadashov,2,2,2023-11-16,1,1,0,0
Erik Jirka,1,1,2022-09-22,1,0,0,1
Hojjat Haghverdi,1,1,2022-09-22,0,1,0,0
Marvin da Graça,1,1,2022-09-22,0,1,0,0
İsmail Yüksek,1,1,2022-09-22,1,0,0,0
Ermedin Demirović,1,1,2022-09-23,1,0,0,0
Valentin Antov,1,1,2022-09-23,1,0,0,0
Radoslav Kirilov,1,1,2022-09-23,1,0,0,0
Marin Petkov,2,2,2023-06-17,1,1,0,0
Teddy Teuma,1,1,2022-09-23,0,1,0,1
Oleksandr Tymchyk,1,1,2022-09-24,0,1,0,0
Oleksandr Zubkov,1,1,2022-09-24,0,1,0,0
Danylo Ihnatenko,1,1,2022-09-24,0,1,0,0
Diogo Dalot,2,1,2022-09-24,0,2,0,0
Tai Baribo,1,1,2022-09-24,1,0,0,0
Jack Hendry,1,1,2022-09-24,1,0,0,0
Saša Lukić,1,1,2022-09-24,1,0,0,0
Manuel Akanji,3,3,2023-10-15,1,2,0,0
Aleksandr Marochkin,1,1,2022-09-25,1,0,1,0
Filip Ozobić,1,1,2022-09-25,1,0,0,0
Anatoliy Nuriyev,1,1,2022-09-25,1,0,0,0
Serdar Gürler,1,1,2022-09-25,0,1,0,0
Victor Stînă,2,1,2022-09-25,2,0,0,0
Ivan Bakhar,1,1,2022-09-25,0,1,0,0
Giorgi Tsitaishvili,1,1,2022-09-26,0,1,0,0
Louie Annesley,1,1,2022-09-26,1,0,0,0
Federico Dimarco,2,2,2023-06-18,0,2,0,0
Oliver Antman,4,4,2023-09-07,1,3,0,0
Andrei Rațiu,1,1,2022-09-26,1,0,0,0
Taijo Teniste,1,1,2022-09-26,0,1,0,0
Mikael Anderson,1,1,2022-09-27,0,1,0,0
Florent Muslija,1,1,2022-09-27,1,0,0,0
Donat Rrudhani,1,1,2022-09-27,1,0,0,0
Valentin Roberge,1,1,2022-09-27,0,1,0,0
Artak Dashyan,2,2,2023-09-08,0,2,0,0
Rasmus Peetson,1,1,2022-11-19,1,0,0,0
Jude Bellingham,3,3,2024-06-30,2,1,0,0
Rafael Leão,3,3,2023-03-26,2,1,0,0
Osman Bukari,1,1,2022-11-24,0,1,0,0
Rouzbeh Cheshmi,1,1,2022-11-25,0,1,0,0
Enzo Fernández,2,2,2022-12-03,1,1,1,0
Niclas Füllkrug,4,4,2024-06-23,2,2,0,0
Jean-Charles Castelletto,2,2,2024-01-19,1,1,0,0
Strahinja Pavlović,2,2,2023-10-14,0,2,0,0
Mohammed Salisu,1,1,2022-11-28,0,1,0,0
Kalidou Koulibaly,1,1,2022-11-29,0,1,0,0
Alexis Mac Allister,1,1,2022-11-30,0,1,0,0
Luis Chávez,3,3,2023-07-12,1,2,0,0
Yeltsin Tejeda,1,1,2022-12-01,1,0,0,0
Haji Wright,1,1,2022-12-03,0,1,0,0
Paik Seung-ho,1,1,2022-12-05,0,1,0,0
Daizen Maeda,1,1,2022-12-05,1,0,0,0
Gonçalo Ramos,6,3,2023-10-13,6,0,0,0
Nahuel Molina,1,1,2022-12-09,0,1,0,0
Aurélien Tchouaméni,2,2,2023-09-07,1,1,0,0
Randal Kolo Muani,3,3,2024-07-09,1,2,0,0
Achraf Dari,1,1,2022-12-17,0,1,0,0
Amar Dedić,1,1,2023-03-23,1,0,0,0
Rasmus Højlund,7,4,2023-10-17,3,4,0,0
Mateo Retegui,2,2,2023-03-26,1,1,0,0
Maksim Samorodov,2,2,2023-09-10,2,0,0,0
David Brekalo,1,1,2023-03-23,0,1,0,0
Žan Vipotnik,2,2,2023-09-10,0,2,0,0
Yannick Yankam,1,1,2023-03-23,0,1,0,0
Dion Charles,3,2,2023-11-20,1,2,0,0
Nikola Krstović,2,2,2023-09-07,0,2,0,0
Tomáš Čvančara,1,1,2023-03-24,1,0,0,0
Manolis Siopis,1,1,2023-03-24,0,1,0,0
Mads Boe Mikkelsen,1,1,2023-03-24,0,1,0,0
Ozan Kabak,1,1,2023-03-25,1,0,1,0
Zeki Amdouni,6,5,2023-10-15,4,2,0,0
Nathan Broadhead,1,1,2023-03-25,0,1,0,0
Eli Dasa,1,1,2023-03-25,0,1,1,0
Joselu,5,4,2023-11-16,4,1,0,0
Askhat Tagybergen,2,2,2023-06-16,1,1,0,1
Davíð Kristján Ólafsson,1,1,2023-03-26,0,1,0,0
Hákon Arnar Haraldsson,3,3,2023-10-16,1,2,0,0
Mikael Egill Ellertsson,1,1,2023-03-26,0,1,0,0
Roberto Di Maio,1,1,2023-03-26,1,0,1,0
Florian Kainz,1,1,2023-03-27,1,0,0,0
Martin Ádám,2,2,2023-11-16,1,1,0,0
Bəhlul Mustafazadə,1,1,2023-03-27,1,0,1,0
Jesper Karlsson,1,1,2023-03-27,1,0,0,0
Andrei Burcă,1,1,2023-03-28,1,0,0,0
Vladislav Morozov,2,2,2023-06-19,1,1,0,0
Yeremy Pino,1,1,2023-06-15,1,0,0,0
Oscar Gloukh,2,2,2023-09-09,0,2,0,0
Aymen Mouelhi,1,1,2023-06-16,0,1,1,0
Abdülkerim Bardakcı,1,1,2023-06-16,0,1,0,0
Kristers Tobers,1,1,2023-06-16,1,0,0,0
Ferdinando Apap,1,1,2023-06-16,0,1,1,0
Trent Alexander-Arnold,1,1,2023-06-16,0,1,0,0
Callum Wilson,1,1,2023-06-16,0,1,0,1
Illya Zabarnyi,1,1,2023-06-16,0,1,0,0
Yukhym Konoplya,1,1,2023-06-16,0,1,0,0
Lucas Zelarayán,3,2,2023-11-18,1,2,0,0
Grant-Leon Ranos,2,1,2023-06-16,0,2,0,0
Jasir Asani,3,3,2023-10-12,3,0,0,0
Nedim Bajrami,4,4,2024-06-15,1,3,0,0
Orel Mangala,1,1,2023-06-17,0,1,1,0
Václav Černý,3,2,2023-09-07,1,2,0,0
Edvinas Girdvainis,1,1,2023-06-17,1,0,0,0
Davide Frattesi,4,3,2023-10-14,3,1,0,0
Nair Tiknizyan,2,2,2023-11-18,1,1,1,0
Styopa Mkrtchyan,1,1,2023-06-19,0,1,1,0
Kalvin Phillips,1,1,2023-06-19,1,0,0,0
Daniel Håkans,4,2,2023-11-17,4,0,0,0
Raz Shlomo,1,1,2023-06-19,1,0,0,0
Mikey Johnston,2,2,2023-10-16,1,1,0,0
Evan Ferguson,2,2,2023-10-16,1,1,0,0
Adam Idah,2,2,2023-09-10,2,0,0,1
Umut Nayir,1,1,2023-06-19,1,0,0,0
Arda Güler,2,2,2024-06-18,2,0,0,0
Yvandro Borges Sanches,2,2,2023-09-08,1,1,0,0
Darko Lazović,1,1,2023-06-20,0,1,0,0
Johan Bakayoko,1,1,2023-06-20,0,1,0,0
Kristjan Asllani,1,1,2023-06-20,0,1,0,0
Ernest Muçi,1,1,2023-06-20,0,1,0,0
Barnabás Varga,5,5,2024-06-15,3,2,0,0
Denis Vavro,1,1,2023-06-20,0,1,0,0
Vladislav Baboglo,2,2,2023-11-17,2,0,0,0
Ola Solbakken,1,1,2023-06-20,1,0,0,0
Brandon Vázquez,3,3,2023-07-09,3,0,0,0
Luis Romo,2,1,2023-06-25,2,0,0,0
Ajani Fortune,1,1,2023-06-25,1,0,0,0
Jameel Ible,1,1,2023-06-25,1,0,1,0
Aarón Suárez,1,1,2023-06-26,1,0,0,0
Patrick Burner,3,2,2023-07-04,0,3,0,0
Bryan Tamacas,1,1,2023-06-26,1,0,0,1
Thierry Ambrose,1,1,2023-06-27,0,1,0,0
Méddy Lina,1,1,2023-06-27,1,0,1,0
Jacen Russell-Rowe,1,1,2023-06-27,0,1,1,0
Demarai Gray,2,1,2023-06-28,2,0,0,0
Andre Rampersad,1,1,2023-06-28,0,1,0,0
Dujuan Richards,1,1,2023-06-28,1,0,0,0
Djordje Mihailovic,2,1,2023-06-28,2,0,0,0
Bryan Reynolds,1,1,2023-06-28,1,0,0,0
Danley Jean Jacques,1,1,2023-06-29,1,0,0,0
Santiago Giménez,2,2,2023-07-16,1,1,0,0
Tameem Al-Abdullah,1,1,2023-06-29,1,0,0,0
Karl Fabien,1,1,2023-06-30,1,0,0,0
Ange-Freddy Plumain,2,2,2023-07-04,1,1,0,1
Anthony Baron,1,1,2023-07-01,0,1,0,0
Arichel Hernández,1,1,2023-07-01,1,0,0,1
José Pinto,1,1,2023-07-02,1,0,0,0
Julani Archibald,1,1,2023-07-02,1,0,1,0
Jon Russell,1,1,2023-07-02,1,0,0,0
Di'Shon Bernard,1,1,2023-07-02,1,0,0,0
Hazem Shehata,1,1,2023-07-02,0,1,0,0
Cade Cowell,1,1,2023-07-02,1,0,0,0
Gianluca Busio,1,1,2023-07-02,1,0,0,0
Jayden Nelson,1,1,2023-07-04,1,0,0,0
Liam Millar,1,1,2023-07-04,1,0,0,0
Brighton Labeau,1,1,2023-07-04,0,1,0,1
Diego Campos,1,1,2023-07-04,1,0,0,0
Jonathan Mexique,1,1,2023-07-04,0,1,0,0
Andreaw Gravillon,1,1,2023-07-04,1,0,0,0
Rubio Rubin,2,1,2023-07-04,0,2,0,0
Brayan Gil,1,1,2023-07-04,0,1,0,0
Mayer Gil,1,1,2023-07-04,0,1,0,0
Érick Sánchez,1,1,2023-07-08,1,0,0,0
Amari'i Bell,1,1,2023-07-09,0,1,0,0
Steven Vitória,1,1,2023-07-09,0,1,0,1
Jacob Shaffelburg,2,2,2024-07-05,0,2,0,0
Scott Kennedy,1,1,2023-07-09,1,0,1,0
Iván Anderson,1,1,2023-07-12,0,1,0,0
Marcus Thuram,2,2,2023-11-18,2,0,0,0
Gytis Paulauskas,2,2,2023-09-10,2,0,0,0
Marten de Roon,1,1,2023-09-07,1,0,0,0
Attila Szalai,1,1,2023-09-07,1,0,1,0
Isaac Price,2,2,2023-11-20,1,1,0,0
Simon Lüchinger,1,1,2023-09-08,1,0,1,0
Luka Ivanušec,1,1,2023-09-08,1,0,0,0
Ryan Porteous,1,1,2023-09-08,0,1,0,0
Solomon Kvirkvelia,1,1,2023-09-08,0,1,1,0
Nico Williams,3,3,2024-07-14,2,1,0,0
Lamine Yamal,3,3,2024-07-09,1,2,0,0
Bertuğ Yıldırım,1,1,2023-09-08,1,0,0,0
Mirlind Daku,1,1,2023-09-10,1,0,0,0
Konstantinos Mavropanos,2,1,2023-09-10,2,0,0,0
Preslav Borukov,1,1,2023-09-10,0,1,0,0
Jan Mlakar,1,1,2023-09-10,0,1,0,0
Žan Karničnik,2,2,2024-06-20,1,1,0,0
Gonçalo Inácio,2,1,2023-09-11,2,0,0,0
Gabi Kanichowsky,1,1,2023-09-12,1,0,0,0
Jovan Manev,1,1,2023-09-12,0,1,0,0
Mikel Merino,2,2,2024-07-05,1,1,0,0
Álex Baena,1,1,2023-09-12,1,0,0,0
Emil Holm,1,1,2023-09-12,1,0,0,0
Altin Zeqiri,1,1,2023-10-12,0,1,0,0
Barış Alper Yılmaz,1,1,2023-10-12,0,1,0,0
Fredrik Aursnes,1,1,2023-10-12,0,1,0,0
Daniels Balodis,1,1,2023-10-12,1,0,0,0
Oihan Sancet,1,1,2023-10-12,1,0,0,0
Dodi Lukebakio,2,1,2023-10-13,0,2,0,0
Toral Bayramov,1,1,2023-10-13,0,1,0,0
Orri Óskarsson,2,2,2023-11-16,1,1,0,0
Amar Rahmanović,1,1,2023-10-13,0,1,0,0
Quilindschy Hartman,1,1,2023-10-13,1,0,0,0
Pijus Širvys,3,2,2023-10-17,1,2,0,0
Giacomo Bonaventura,1,1,2023-10-14,1,0,0,0
Paul Smyth,1,1,2023-10-14,1,0,0,0
Conor McMenamin,1,1,2023-10-14,1,0,0,0
Erik Janža,3,3,2024-06-16,2,1,0,0
Heorhiy Sudakov,1,1,2023-10-14,1,0,0,0
Levan Shengelia,1,1,2023-10-15,1,0,0,0
Florinel Coman,1,1,2023-10-15,1,0,0,0
Denis Polyakov,1,1,2023-10-15,0,1,0,0
Dmitry Antilevsky,2,2,2023-11-21,0,2,0,0
Dávid Ďuriš,1,1,2023-10-16,0,1,0,0
Gianluca Scamacca,1,1,2023-10-17,0,1,0,0
Paul Mbong,1,1,2023-10-17,1,0,0,0
Ryan Camenzuli,1,1,2023-10-17,0,1,1,0
Mykhailo Mudryk,2,2,2024-03-26,1,1,0,0
Alessandro Golinucci,1,1,2023-10-17,1,0,0,0
Aleks Petkov,1,1,2023-11-16,0,1,1,0
Kostas Pileas,1,1,2023-11-16,1,0,0,0
Philipp Lienhart,1,1,2023-11-16,0,1,0,0
Mathias Olesen,1,1,2023-11-16,1,0,0,0
Nihad Mujakić,1,1,2023-11-16,1,0,1,0
Renato Gojković,1,1,2023-11-16,0,1,0,0
Edvin Kuč,1,1,2023-11-16,1,0,0,0
Enrico Pepe,1,1,2023-11-17,1,0,1,0
Jani Atanasov,3,2,2023-11-20,0,3,1,0
Islam Chesnokov,2,1,2023-11-17,2,0,0,0
Simone Franciosi,1,1,2023-11-17,0,1,0,0
Jakub Piotrowski,2,2,2024-03-21,2,0,0,0
Denis Laptev,1,1,2023-11-18,1,0,0,0
Ethan Santos,1,1,2023-11-18,1,0,1,0
Warren Zaïre-Emery,1,1,2023-11-18,1,0,0,0
Jonathan Clauss,1,1,2023-11-18,1,0,0,0
Youssouf Fofana,2,2,2023-11-21,1,1,0,0
Muhamet Hyseni,1,1,2023-11-18,0,1,0,0
Patrik Hrošovský,1,1,2023-11-19,1,0,1,0
Ľubomír Šatka,1,1,2023-11-19,0,1,0,0
Slobodan Rubežić,1,1,2023-11-19,0,1,0,0
Aron Dønnum,1,1,2023-11-19,0,1,0,0
Jørgen Strand Larsen,1,1,2023-11-19,0,1,0,0
Leo Skiri Østigård,1,1,2023-11-19,1,0,1,0
Miloš Veljković,1,1,2023-11-19,1,0,0,0
Georgi Rusev,1,1,2023-11-19,0,1,0,0
Srđan Babić,1,1,2023-11-19,1,0,0,0
Robin Le Normand,2,2,2024-06-30,1,1,1,0
Luka Lochoshvili,1,1,2023-11-19,1,0,1,0
David Douděra,1,1,2023-11-20,1,0,0,0
Tomáš Chorý,1,1,2023-11-20,1,0,0,0
Ramazan Orazov,1,1,2023-11-20,0,1,0,0
Gadi Kinda,1,1,2023-11-21,0,1,0,0
Ante Budimir,1,1,2023-11-21,1,0,0,0
Calvin Stengs,3,1,2023-11-21,0,3,0,0
Mats Wieffer,1,1,2023-11-21,0,1,0,0
Fotis Ioannidis,2,2,2024-03-21,2,0,0,0
Jordan Bos,1,1,2024-01-13,1,0,0,0
Seko Fofana,1,1,2024-01-13,1,0,0,0
Jean-Philippe Krasso,1,1,2024-01-13,1,0,0,0
Witi,1,1,2024-01-14,0,1,0,0
Nguyễn Đình Bắc,1,1,2024-01-14,0,1,0,0
Phạm Tuấn Hải,1,1,2024-01-14,0,1,0,0
Keito Nakamura,1,1,2024-01-14,1,0,0,0
Ayase Ueda,5,3,2024-01-31,4,1,1,1
Sultan Adil,2,2,2024-01-18,1,1,0,1
Chan Siu Kwan,1,1,2024-01-14,0,1,0,0
Zayed Sultan,1,1,2024-01-14,1,0,0,0
Frank Magri,1,1,2024-01-15,1,0,0,0
Marselino Ferdinan,1,1,2024-01-15,1,0,0,0
Osama Rashid,1,1,2024-01-15,0,1,0,0
Mahmoud Al-Mardi,2,1,2024-01-15,0,2,0,0
Pape Gueye,1,1,2024-01-15,1,0,0,0
Lamine Camara,2,1,2024-01-15,2,0,0,0
Abdullah Al-Hashash,1,1,2024-01-15,0,1,0,0
Lee Kang-in,3,2,2024-01-25,3,0,0,0
Hamari Traoré,1,1,2024-01-16,1,0,0,0
Lassine Sinayoko,3,3,2024-01-30,2,1,0,0
Abdulrahman Ghareeb,1,1,2024-01-16,1,0,0,0
Ali Al-Bulaihi,1,1,2024-01-16,1,0,0,0
Supachai Chaided,2,1,2024-01-16,2,0,0,0
Deon Hotto,1,1,2024-01-16,0,1,0,0
Kings Kangwa,1,1,2024-01-17,0,1,0,0
Josete Miranda,1,1,2024-01-18,1,0,0,0
Zé Turbo,1,1,2024-01-18,0,1,0,0
Abbosbek Fayzullaev,2,2,2024-01-30,1,1,0,0
Sherzod Nasrullaev,1,1,2024-01-18,0,1,0,0
Bader Nasser,1,1,2024-01-18,1,0,1,0
Bebé,1,1,2024-01-19,1,0,0,0
Kevin Pina,1,1,2024-01-19,1,0,0,0
Aguibou Camara,1,1,2024-01-19,1,0,0,0
Asnawi Mangkualam,1,1,2024-01-19,0,1,0,1
Park Yong-woo,1,1,2024-01-20,1,0,1,0
Yazan Al-Naimat,4,4,2024-02-10,2,2,0,0
Gelson Dala,4,2,2024-01-27,2,2,0,0
Sidi Bouna Amar,1,1,2024-01-20,1,0,0,0
Aboubakary Koita,1,1,2024-01-20,1,0,0,0
Hamza Rafia,1,1,2024-01-20,1,0,0,0
Mohamed Kanno,1,1,2024-01-21,0,1,0,0
Faisal Al-Ghamdi,1,1,2024-01-21,0,1,0,0
Silas Katompa Mvumpa,1,1,2024-01-21,0,1,0,0
Thapelo Maseko,1,1,2024-01-21,1,0,0,0
Gilson Tavares,1,1,2024-01-22,1,0,0,0
Bryan Teixeira,1,1,2024-01-22,1,0,0,0
Opa Sanganté,1,1,2024-01-22,0,1,1,0
Reinildo Mandava,1,1,2024-01-22,1,0,0,0
Bassel Jradi,1,1,2024-01-22,0,1,0,0
Parvizdzhon Umarbayev,1,1,2024-01-22,1,0,0,0
Nuriddin Khamrokulov,1,1,2024-01-22,1,0,0,0
Azizbek Turgunboev,2,2,2024-01-30,1,1,0,0
Ebrima Colley,1,1,2024-01-23,1,0,0,0
James Gomez,1,1,2024-01-23,0,1,1,0
Christopher Wooh,1,1,2024-01-23,0,1,0,0
Abdoulaye Seck,1,1,2024-01-23,0,1,0,0
Iliman Ndiaye,1,1,2024-01-23,0,1,0,0
Zaid Qunbar,1,1,2024-01-23,0,1,0,0
Mohamed Dellahi Yali,1,1,2024-01-23,1,0,0,0
Bùi Hoàng Việt Anh,1,1,2024-01-24,0,1,0,0
Rebin Sulaka,1,1,2024-01-24,1,0,0,0
Justin Hubner,1,1,2024-01-24,1,0,1,0
Sandy Walsh,1,1,2024-01-24,0,1,0,0
Abdulla Yusuf Helal,1,1,2024-01-25,0,1,0,0
Joel Kojo,1,1,2024-01-25,1,0,0,0
Faisal Halim,1,1,2024-01-25,0,1,0,0
Arif Aiman Hanapi,1,1,2024-01-25,0,1,0,1
Romel Morales,1,1,2024-01-25,0,1,0,0
Ademola Lookman,3,2,2024-02-02,3,0,0,0
Elkan Baggott,1,1,2024-01-28,1,0,1,0
Meschak Elia,1,1,2024-01-28,0,1,0,0
Vahdat Hanonov,2,2,2024-02-02,1,1,1,0
Khalifa Al Hammadi,1,1,2024-01-28,0,1,0,0
Saad Natiq,1,1,2024-01-29,1,0,0,0
Nizar Al-Rashdan,1,1,2024-01-29,0,1,0,0
Edmond Tapsoba,1,1,2024-01-30,1,0,1,0
Abdullah Radif,1,1,2024-01-30,1,0,0,0
Takefusa Kubo,1,1,2024-01-31,0,1,0,0
Arthur Masuaku,1,1,2024-02-02,1,0,0,0
Nene Dorgeles,1,1,2024-02-03,0,1,0,0
Simon Adingra,1,1,2024-02-03,1,0,0,0
Oumar Diakité,1,1,2024-02-03,1,0,0,0
Odiljon Hamrobekov,1,1,2024-02-03,0,1,0,0
Jassem Gaber,1,1,2024-02-07,1,0,0,0
Mykola Matviyenko,1,1,2024-03-21,1,0,1,0
Anastasios Bakasetas,1,1,2024-03-21,1,0,0,1
Dimitrios Kourbelis,1,1,2024-03-21,1,0,0,0
Yerkin Tapalov,1,1,2024-03-21,1,0,1,0
Karol Mets,1,1,2024-03-21,1,0,1,0
Martin Vetkal,1,1,2024-03-21,0,1,0,0
Petur Knudsen,1,1,2024-06-08,0,1,0,0
Alex Matthias Tamm,1,1,2024-06-08,1,0,0,0
Edgar Tur,1,1,2024-06-08,1,0,0,0
Danil Kuraksin,1,1,2024-06-08,1,0,0,0
Armandas Kučys,2,1,2024-06-08,0,2,0,0
Mark Anders Lepik,1,1,2024-06-11,0,1,0,0
Giedrius Matulevicius,1,1,2024-06-11,1,0,0,0
Florian Wirtz,2,2,2024-07-05,2,0,0,0
Kwadwo Duah,1,1,2024-06-15,0,1,0,0
Michel Aebischer,1,1,2024-06-15,0,1,0,0
Dani Carvajal,1,1,2024-06-15,1,0,0,0
Kensi Tangis,1,1,2024-06-15,1,0,0,0
Nabil Begg,2,2,2024-06-19,2,0,0,0
Thomas Dunn,3,2,2024-06-19,3,0,0,0
Matéo Degrumelle,2,2,2024-06-19,1,1,0,0
Maximilian Wöber,1,1,2024-06-17,0,1,1,0
Denis Drăguș,1,1,2024-06-17,1,0,0,0
Robin Hranáč,1,1,2024-06-18,1,0,1,0
Francisco Conceição,1,1,2024-06-18,1,0,0,0
Klaus Gjasula,2,1,2024-06-19,1,1,1,0
Setareki Hughes,2,1,2024-06-19,2,0,0,0
Luke Salisbury,1,1,2024-06-19,0,1,0,0
Filipe Baravilala,1,1,2024-06-19,1,0,0,0
Etonia Dogalau,2,1,2024-06-19,2,0,0,0
Pala Paul,1,1,2024-06-19,1,0,0,0
Morten Hjulmand,1,1,2024-06-20,1,0,0,0
Riccardo Calafiori,1,1,2024-06-20,1,0,1,0
Gernot Trauner,1,1,2024-06-21,0,1,0,0
Max Mata,2,2,2024-06-30,0,2,0,0
Ben Old,1,1,2024-06-21,0,1,0,0
Jeremy Sarmiento,1,1,2024-06-22,1,0,0,0
Jhonder Cádiz,1,1,2024-06-22,0,1,0,0
Gerardo Arteaga,1,1,2024-06-22,1,0,0,0
Pharrell Trainor,1,1,2024-06-22,1,0,0,0
Samet Akaydin,2,2,2024-07-06,0,2,1,0
Dan Ndoye,1,1,2024-06-23,0,1,0,0
Kevin Csoboth,1,1,2024-06-23,0,1,0,0
Folarin Balogun,2,2,2024-06-27,2,0,0,0
Maximiliano Araújo,2,2,2024-06-27,2,0,0,0
Matías Viña,1,1,2024-06-23,1,0,0,0
Daniel Muñoz,2,2,2024-07-02,1,1,0,0
Julio Enciso,1,1,2024-06-24,0,1,0,0
Mattia Zaccagni,1,1,2024-06-24,0,1,0,0
Romano Schmid,1,1,2024-06-25,0,1,0,0
Kasey Palmer,1,1,2024-06-26,1,0,1,0
Kendry Páez,1,1,2024-06-26,1,0,0,1
Alan Minda,1,1,2024-06-26,1,0,0,0
Finn Surman,1,1,2024-06-27,1,0,0,0
César Blackman,1,1,2024-06-27,0,1,0,0
Facundo Pellistri,1,1,2024-06-27,1,0,0,0
Johnathan Spokeyjack,1,1,2024-06-27,1,0,0,0
Sitiveni Cavuilagi,1,1,2024-06-27,0,1,0,0
Jason Thomas,1,1,2024-06-27,1,0,0,0
Davinson Sánchez,1,1,2024-06-28,1,0,0,0
Jhon Córdoba,2,2,2024-07-06,2,0,0,0
Sávio,1,1,2024-06-28,0,1,0,0
Omar Alderete,1,1,2024-06-28,1,0,0,0
Cameron Howieson,1,1,2024-06-30,0,1,0,0
Jesse Randall,1,1,2024-06-30,0,1,0,0
Eduardo Guerrero,1,1,2024-07-01,0,1,0,0
Mathías Olivera,1,1,2024-07-01,0,1,0,0
Josimar Alcócer,1,1,2024-07-02,1,0,0,0
Ramón Sosa,1,1,2024-07-02,0,1,0,0
Lisandro Martínez,1,1,2024-07-04,1,0,0,0
Kevin Rodríguez,1,1,2024-07-04,0,1,0,0
Richard Ríos,1,1,2024-07-06,1,0,0,0
Xavi Simons,1,1,2024-07-10,1,0,0,0
Ismaël Koné,1,1,2024-07-13,1,0,0,0
Cole Palmer,1,1,2024-07-14,0,1,0,0
